,y_proba,y_test,Neg,Pos,TN,FP,FN,TP,FP/P,Prec
0,0.0029,0,1,0,1,676443,0,126256,5.357709732606767,0.15728934507206313
1,0.0039,0,1,0,2,676442,0,126256,5.357701812191104,0.15728954102290027
2,0.0042,0,2,0,4,676440,0,126256,5.357685971359777,0.15728993292603924
3,0.0043,0,2,0,6,676438,0,126256,5.35767013052845,0.15729032483113117
4,0.0044,0,2,0,8,676436,0,126256,5.357654289697123,0.15729071673817605
5,0.0045,0,1,0,9,676435,0,126256,5.3576463692814595,0.15729091269243084
6,0.0047,1,2,1,11,676433,1,126255,5.357630528450133,0.15729025474405997
7,0.0048,0,4,0,15,676429,1,126255,5.3575988467874796,0.15729103856561236
8,0.0049,0,1,0,16,676428,1,126255,5.357590926371816,0.1572912345222211
9,0.005,0,1,0,17,676427,1,126255,5.357583005956153,0.1572914304793181
10,0.0051,1,2,1,19,676425,2,126254,5.357567165124825,0.15729077252550522
11,0.0052,1,0,1,19,676425,3,126253,5.357567165124825,0.15728972265341767
12,0.0053,0,4,0,23,676421,3,126253,5.357535483462172,0.15729050648208365
13,0.0054,0,1,0,24,676420,3,126253,5.357527563046509,0.15729070244047078
14,0.0055,0,2,0,26,676418,3,126253,5.357511722215182,0.15729109435870986
15,0.0056,0,3,0,29,676415,3,126253,5.357487960968192,0.1572916822397305
16,0.0057,0,6,0,35,676409,3,126253,5.357440438474211,0.15729285801495524
17,0.0058,0,3,0,38,676406,3,126253,5.357416677227221,0.15729344590915942
18,0.0059,0,4,0,42,676402,3,126253,5.357384995564567,0.15729422977493443
19,0.006,0,6,0,48,676396,3,126253,5.3573374730705865,0.15729540558824592
20,0.0061,0,4,0,52,676392,3,126253,5.357305791407933,0.15729618947355306
21,0.0062,0,8,0,60,676384,3,126253,5.357242428082626,0.15729775726760664
22,0.0063,0,6,0,66,676378,3,126253,5.357194905588646,0.1572989331336567
23,0.0064,0,5,0,71,676373,3,126253,5.3571553035103285,0.1572999130354611
24,0.0065,0,3,0,74,676370,3,126253,5.357131542263338,0.15730050098240395
25,0.0066,0,7,0,81,676363,3,126253,5.357076099353694,0.15730187287569647
26,0.0067,0,4,0,85,676359,3,126253,5.35704441769104,0.15730265682546485
27,0.0068,0,11,0,96,676348,3,126253,5.356957293118743,0.15730481272761931
28,0.0069,0,7,0,103,676341,3,126253,5.356901850209099,0.1573061846961228
29,0.007,0,7,0,110,676334,3,126253,5.3568464072994555,0.15730755668855836
30,0.0071,0,7,0,117,676327,3,126253,5.356790964389811,0.1573089287049266
31,0.0072,0,9,0,126,676318,3,126253,5.35671968064884,0.15731069276113888
32,0.0073,0,6,0,132,676312,3,126253,5.3566721581548595,0.15731186882059398
33,0.0074,0,11,0,143,676301,3,126253,5.356585033582562,0.15731402497526648
34,0.0075,0,13,0,156,676288,3,126253,5.356482068178938,0.15731657323426468
35,0.0076,2,12,2,168,676276,5,126251,5.356387023190977,0.15731682547752288
36,0.0077,0,9,0,177,676267,5,126251,5.3563157394500065,0.15731858973879714
37,0.0078,0,18,0,195,676249,5,126251,5.356173171968065,0.1573221183800623
38,0.0079,0,21,0,216,676228,5,126251,5.3560068432391335,0.1573262353282765
39,0.008,0,8,0,224,676220,5,126251,5.355943479913826,0.157327803746179
40,0.0081,2,26,2,250,676194,7,126249,5.3557375491065775,0.15733080106624395
41,0.0082,0,14,0,264,676180,7,126249,5.355626663287289,0.15733354602089406
42,0.0083,1,19,1,283,676161,8,126248,5.3554761753896845,0.15733622130359953
43,0.0084,0,18,0,301,676143,8,126248,5.355333607907743,0.1573397508197375
44,0.0085,0,26,0,327,676117,8,126248,5.355127677100494,0.15734484928928855
45,0.0086,0,22,0,349,676095,8,126248,5.354953427955899,0.15734916363699814
46,0.0087,0,18,0,367,676077,8,126248,5.3548108604739575,0.15735269373383604
47,0.0088,0,19,0,386,676058,8,126248,5.354660372576353,0.15735642011900697
48,0.0089,0,20,0,406,676038,8,126248,5.3545019642630844,0.15736034282039074
49,0.009,0,13,0,419,676025,8,126248,5.35439899885946,0.15736289268116962
50,0.0091,0,24,0,443,676001,8,126248,5.354208908883538,0.15736760033356229
51,0.0092,0,25,0,468,675976,8,126248,5.3540108984919526,0.1573725044376633
52,0.0093,0,20,0,488,675956,8,126248,5.353852490178684,0.1573764279410225
53,0.0094,1,19,1,507,675937,9,126247,5.3537020022810795,0.15737910504323196
54,0.0095,1,28,1,535,675909,10,126246,5.3534802306425044,0.15738354806739346
55,0.0096,0,19,0,554,675890,10,126246,5.353329742744899,0.1573872759731517
56,0.0097,0,22,0,576,675868,10,126246,5.353155493600304,0.1573915927162473
57,0.0098,0,25,0,601,675843,10,126246,5.352957483208719,0.15739649839356978
58,0.0099,1,30,1,631,675813,11,126245,5.352719870738817,0.15740133506554388
59,0.01,0,19,0,650,675794,11,126245,5.352569382841211,0.15740506384352881
60,0.0101,0,32,0,682,675762,11,126245,5.352315929539983,0.15741134429001244
61,0.0102,1,30,1,712,675732,12,126244,5.35207831707008,0.15741618203038496
62,0.0103,0,38,0,750,675694,12,126244,5.35177734127487,0.15742364122912245
63,0.0104,0,29,0,779,675665,12,126244,5.351547649220631,0.15742933425114322
64,0.0105,2,29,2,808,675636,14,126242,5.351317957166392,0.15743292620573204
65,0.0106,1,32,1,840,675604,15,126241,5.351064503865163,0.15743815824754162
66,0.0107,0,31,0,871,675573,15,126241,5.350818970979597,0.1574442451740678
67,0.0108,1,37,1,908,675536,16,126240,5.350525915600051,0.15745045997884696
68,0.0109,0,43,0,951,675493,16,126240,5.350185337726524,0.15745890464780668
69,0.011,2,37,2,988,675456,18,126238,5.3498922823469774,0.15746406983213046
70,0.0111,0,39,0,1027,675417,18,126238,5.349583386136104,0.15747173035782225
71,0.0112,0,38,0,1065,675379,18,126238,5.349282410340895,0.157479195176749
72,0.0113,1,32,1,1097,675347,19,126237,5.349028957039666,0.15748443082696262
73,0.0114,1,32,1,1129,675315,20,126236,5.348775503738437,0.15748966690828156
74,0.0115,1,46,1,1175,675269,21,126235,5.348411164617919,0.15749765440970975
75,0.0116,0,37,0,1212,675232,21,126235,5.3481181092383725,0.157504925343152
76,0.0117,1,38,1,1250,675194,22,126234,5.347817133443163,0.15751134225407648
77,0.0118,0,33,0,1283,675161,22,126234,5.34755575972627,0.15751782828692468
78,0.0119,1,35,1,1318,675126,23,126233,5.347278545178051,0.15752365668820092
79,0.012,0,48,0,1366,675078,23,126233,5.346898365226207,0.15753309264442894
80,0.0121,1,45,1,1411,675033,24,126232,5.346541946521353,0.15754088847010664
81,0.0122,0,44,0,1455,674989,24,126232,5.346193448232163,0.1575495400145528
82,0.0123,1,38,1,1493,674951,25,126231,5.345892472436954,0.15755596106752273
83,0.0124,1,53,1,1546,674898,26,126230,5.345472690406792,0.1575653328806383
84,0.0125,2,53,2,1599,674845,28,126228,5.345052908376632,0.15757365433612167
85,0.0126,0,53,0,1652,674792,28,126228,5.344633126346471,0.15758408029762053
86,0.0127,2,47,2,1699,674745,30,126226,5.3442608668102904,0.15759122365229203
87,0.0128,0,48,0,1747,674697,30,126226,5.343880686858446,0.15760066822903077
88,0.0129,0,46,0,1793,674651,30,126226,5.343516347737929,0.1576097203440728
89,0.013,0,44,0,1837,674607,30,126226,5.343167849448739,0.15761837986196872
90,0.0131,1,64,1,1901,674543,31,126225,5.342660942846281,0.15762992527173914
91,0.0132,0,55,0,1956,674488,31,126225,5.342225319984792,0.15764075267917468
92,0.0133,2,79,2,2035,674409,33,126223,5.3415996071473835,0.1576542031794882
93,0.0134,2,57,2,2092,674352,35,126221,5.341148143454569,0.15766332364443966
94,0.0135,3,66,3,2158,674286,38,126218,5.3406253960207835,0.15767316590547956
95,0.0136,1,60,1,2218,674226,39,126217,5.340150171080978,0.15768393252236573
96,0.0137,3,59,3,2277,674167,42,126214,5.339682866556837,0.15769239899497864
97,0.0138,1,67,1,2344,674100,43,126213,5.339152198707388,0.15770454809555762
98,0.0139,0,65,0,2409,674035,43,126213,5.338637371689266,0.15771735761913808
99,0.014,1,74,1,2483,673961,44,126212,5.338051260930174,0.15773089069488724
100,0.0141,3,85,3,2568,673876,47,126209,5.337378025598784,0.1577444896479749
101,0.0142,1,63,1,2631,673813,48,126208,5.336879039411988,0.15775585890870364
102,0.0143,1,75,1,2706,673738,49,126207,5.336285008237232,0.15776959665977036
103,0.0144,1,71,1,2777,673667,50,126206,5.33572265872513,0.15778254797949173
104,0.0145,2,69,2,2846,673598,52,126204,5.335176150044354,0.15779405402837202
105,0.0146,4,56,4,2902,673542,56,126200,5.334732606767203,0.1578008907872789
106,0.0147,2,71,2,2973,673471,58,126198,5.334170257255101,0.15781279504394943
107,0.0148,3,75,3,3048,673396,61,126195,5.3335762260803445,0.1578244377437965
108,0.0149,1,76,1,3124,673320,62,126194,5.332974274489925,0.15783838681999315
109,0.015,1,61,1,3185,673259,63,126193,5.332491129134457,0.15784937682312383
110,0.0151,3,77,3,3262,673182,66,126190,5.331881257128374,0.1578614212156543
111,0.0152,3,75,3,3337,673107,69,126187,5.331287225953618,0.15787307298691095
112,0.0153,2,60,2,3397,673047,71,126185,5.330812001013813,0.15788281750480462
113,0.0154,2,74,2,3471,672973,73,126183,5.33022589025472,0.1578953295726992
114,0.0155,1,92,1,3563,672881,74,126182,5.3294972120136865,0.15791245496287526
115,0.0156,0,80,0,3643,672801,74,126182,5.328863578760614,0.15792826630854473
116,0.0157,1,73,1,3716,672728,75,126181,5.328285388417184,0.15794164291552604
117,0.0158,0,100,0,3816,672628,75,126181,5.327493346850843,0.1579614150566656
118,0.0159,5,82,5,3898,672546,80,126176,5.3268438727664424,0.15797236084645222
119,0.016,1,87,1,3985,672459,81,126175,5.326154796603726,0.15798851539002848
120,0.0161,2,82,2,4067,672377,83,126173,5.325505322519326,0.15800262976645169
121,0.0162,1,76,1,4143,672301,84,126172,5.324903370928906,0.15801661421237786
122,0.0163,1,89,1,4232,672212,85,126171,5.324198453934862,0.1580331745540674
123,0.0164,2,86,2,4318,672126,87,126169,5.3235172981878085,0.158048089991795
124,0.0165,1,97,1,4415,672029,88,126168,5.322749017868458,0.15806624179243972
125,0.0166,2,117,2,4532,671912,90,126166,5.321822329235839,0.15808730474966107
126,0.0167,5,92,5,4624,671820,95,126161,5.321093650994804,0.15810025551986825
127,0.0168,3,106,3,4730,671714,98,126158,5.320254086934482,0.15811809413038683
128,0.0169,1,99,1,4829,671615,99,126157,5.319469965783805,0.15813666059977036
129,0.017,2,100,2,4929,671515,101,126155,5.318677924217463,0.1581543746160693
130,0.0171,1,96,1,5025,671419,102,126154,5.317917564313775,0.15817235538314361
131,0.0172,2,100,2,5125,671319,104,126152,5.317125522747434,0.1581900783852955
132,0.0173,0,89,0,5214,671230,104,126152,5.31642060575339,0.15820773481217285
133,0.0174,2,91,2,5305,671139,106,126150,5.315699847928019,0.15822368049728516
134,0.0175,5,100,5,5405,671039,111,126145,5.314907806361678,0.1582382486351959
135,0.0176,2,87,2,5492,670952,113,126143,5.314218730198961,0.15825340768666218
136,0.0177,2,112,2,5604,670840,115,126141,5.313331643644658,0.1582735347517695
137,0.0178,1,87,1,5691,670753,116,126140,5.312642567481942,0.15828975784703844
138,0.0179,2,111,2,5802,670642,118,126138,5.311763401343303,0.15830969652852733
139,0.018,1,82,1,5884,670560,119,126137,5.311113927258902,0.1583249340715479
140,0.0181,5,108,5,5992,670452,124,126132,5.310258522367254,0.15834111656774427
141,0.0182,6,117,6,6109,670335,130,126126,5.3093318337346345,0.15835803636336243
142,0.0183,2,97,2,6206,670238,132,126124,5.308563553415283,0.15837521127326518
143,0.0184,3,111,3,6317,670127,135,126121,5.307684387276645,0.15839411841536807
144,0.0185,1,113,1,6430,670014,136,126120,5.306789380306679,0.15841554311208916
145,0.0186,2,101,2,6531,669913,138,126118,5.305989418324674,0.15843352834248917
146,0.0187,2,109,2,6640,669804,140,126116,5.305126093017361,0.1584531108654136
147,0.0188,1,88,1,6728,669716,141,126115,5.304429096438981,0.15846957457048041
148,0.0189,2,130,2,6858,669586,143,126113,5.303399442402737,0.1584933498722507
149,0.019,3,129,3,6987,669457,146,126110,5.302377708782157,0.15851587609843043
150,0.0191,7,120,7,7107,669337,153,126103,5.301427258902547,0.1585323845921754
151,0.0192,5,124,5,7231,669213,158,126098,5.300445127360284,0.15855181180695352
152,0.0193,3,111,3,7342,669102,161,126095,5.299565961221645,0.15857076925592023
153,0.0194,1,117,1,7459,668985,162,126094,5.298639272589026,0.1585930454709532
154,0.0195,2,139,2,7598,668846,164,126092,5.297538334811811,0.15861865956841917
155,0.0196,3,121,3,7719,668725,167,126089,5.296579964516538,0.15863963141061935
156,0.0197,4,115,4,7834,668610,171,126085,5.295669116715246,0.1586583532046886
157,0.0198,4,127,4,7961,668483,175,126081,5.294663223925991,0.15867947704653118
158,0.0199,3,130,3,8091,668353,178,126078,5.293633569889748,0.15870226615023836
159,0.02,1,118,1,8209,668235,179,126077,5.292698960841465,0.15872478320861325
160,0.0201,3,126,3,8335,668109,182,126074,5.291700988467875,0.15874678757918514
161,0.0202,6,96,6,8431,668013,188,126068,5.290940628564187,0.15875962275888733
162,0.0203,2,122,2,8553,667891,190,126066,5.28997433785325,0.1587818987678174
163,0.0204,2,139,2,8692,667752,192,126064,5.288873400076036,0.15880758261360314
164,0.0205,4,135,4,8827,667617,196,126060,5.287804143961475,0.158830355421664
165,0.0206,1,124,1,8951,667493,197,126059,5.286822012419211,0.15885411416013065
166,0.0207,2,119,2,9070,667374,199,126057,5.2858794829552656,0.15887581906933307
167,0.0208,1,133,1,9203,667241,200,126056,5.284826067672031,0.1589013950638916
168,0.0209,5,144,5,9347,667097,205,126051,5.2836855278165,0.15892494212933778
169,0.021,5,133,5,9480,666964,210,126046,5.282632112533266,0.15894629323715967
170,0.0211,4,149,4,9629,666815,214,126042,5.281451970599417,0.15897192053548118
171,0.0212,2,117,2,9746,666698,216,126040,5.280525281966797,0.15899326132972053
172,0.0213,1,123,1,9869,666575,217,126039,5.279551070840197,0.15901687328258143
173,0.0214,8,133,8,10002,666442,225,126031,5.278497655556964,0.1590350712264014
174,0.0215,6,135,6,10137,666307,231,126025,5.277428399442403,0.1590557998414806
175,0.0216,4,144,4,10281,666163,235,126021,5.276287859586871,0.15908046615432778
176,0.0217,5,114,5,10395,666049,240,126016,5.275384932201242,0.15909805382134043
177,0.0218,5,167,5,10562,665882,245,126011,5.274062222785452,0.15912629610313514
178,0.0219,2,146,2,10708,665736,247,126009,5.272905842098593,0.15915351533637725
179,0.022,1,139,1,10847,665597,248,126008,5.271804904321379,0.15918039931531508
180,0.0221,1,146,1,10993,665451,249,126007,5.27064852363452,0.1592087009039014
181,0.0222,3,122,3,11115,665329,252,126004,5.269682232923584,0.15923005864787643
182,0.0223,4,129,4,11244,665200,256,126000,5.268660499303003,0.15925176946410516
183,0.0224,2,133,2,11377,665067,258,125998,5.26760708401977,0.15927641849911195
184,0.0225,2,168,2,11545,664899,260,125996,5.266276454188316,0.15930812560453664
185,0.0226,3,142,3,11687,664757,263,125993,5.265151755164111,0.15933354410369902
186,0.0227,6,136,6,11823,664621,269,125987,5.2640745786338865,0.15935457268330197
187,0.0228,5,156,5,11979,664465,274,125982,5.262838993790394,0.15938070484169084
188,0.0229,4,145,4,12124,664320,278,125978,5.261690533519199,0.15940569253623316
189,0.023,3,148,3,12272,664172,281,125975,5.260518312001014,0.15943235878893422
190,0.0231,6,143,6,12415,664029,287,125969,5.259385692561145,0.15945483406287103
191,0.0232,4,152,4,12567,663877,291,125965,5.2581817893803064,0.15948126334127585
192,0.0233,3,150,3,12717,663727,294,125962,5.256993727030794,0.15950836341901686
193,0.0234,5,169,5,12886,663558,299,125957,5.255655176783677,0.15953718422069246
194,0.0235,1,139,1,13025,663419,300,125956,5.254554239006463,0.1595642121931908
195,0.0236,6,168,6,13193,663251,306,125950,5.253223609175009,0.15959178967081897
196,0.0237,4,158,4,13351,663093,310,125946,5.2519721835001905,0.159619486489261
197,0.0238,7,163,7,13514,662930,317,125939,5.250681155747054,0.15964501076858134
198,0.0239,6,141,6,13655,662789,323,125933,5.249564377138512,0.15966715775647186
199,0.024,4,150,4,13805,662639,327,125929,5.248376314789,0.15969326678231935
200,0.0241,3,170,3,13975,662469,330,125926,5.24702984412622,0.1597245035800582
201,0.0242,6,140,6,14115,662329,336,125920,5.245920985933342,0.15974647605008063
202,0.0243,6,160,6,14275,662169,342,125914,5.244653719427196,0.15977251127102093
203,0.0244,7,161,7,14436,662008,349,125907,5.243378532505386,0.1597976939136836
204,0.0245,4,147,4,14583,661861,353,125903,5.242214231402864,0.15982324655607516
205,0.0246,2,143,2,14726,661718,355,125901,5.241081611962996,0.159850130583442
206,0.0247,7,156,7,14882,661562,362,125894,5.239846027119503,0.15987432948634592
207,0.0248,2,153,2,15035,661409,364,125892,5.2386342035230005,0.15990326444396744
208,0.0249,7,182,7,15217,661227,371,125885,5.23719268787226,0.1599327668743457
209,0.025,6,164,6,15381,661063,377,125879,5.235893739703459,0.15995969207387584
210,0.0251,6,159,6,15540,660904,383,125873,5.234634393612977,0.1599856121874432
211,0.0252,5,171,5,15711,660733,388,125868,5.233280002534533,0.16001505210392564
212,0.0253,7,159,7,15870,660574,395,125861,5.232020656444051,0.16003992701240408
213,0.0254,9,177,9,16047,660397,404,125852,5.230618742871626,0.1600663403069511
214,0.0255,5,154,5,16201,660243,409,125847,5.22939899885946,0.1600923558371179
215,0.0256,8,156,8,16357,660087,417,125839,5.228163414015968,0.16011558340098178
216,0.0257,3,179,3,16536,659908,420,125836,5.226745659612217,0.1601488525524853
217,0.0258,7,168,7,16704,659740,427,125829,5.225415029780763,0.16017561792789686
218,0.0259,10,175,10,16879,659565,437,125819,5.224028957039666,0.16020061524044288
219,0.026,8,168,8,17047,659397,445,125811,5.222698327208212,0.1602263349329095
220,0.0261,4,159,4,17206,659238,449,125807,5.221438981117729,0.16025450770338007
221,0.0262,6,161,6,17367,659077,455,125801,5.220163794195919,0.16028096086270732
222,0.0263,6,196,6,17563,658881,461,125795,5.21861139272589,0.16031457569748533
223,0.0264,7,192,7,17755,658689,468,125788,5.2170906729185145,0.16034631990485382
224,0.0265,1,198,1,17953,658491,469,125787,5.215522430617159,0.16038573057002747
225,0.0266,6,188,6,18141,658303,475,125781,5.214033392472437,0.160417761362303
226,0.0267,8,186,8,18327,658117,483,125773,5.212560195159042,0.16044725663039458
227,0.0268,5,200,5,18527,657917,488,125768,5.210976112026359,0.1604828470622763
228,0.0269,7,178,7,18705,657739,495,125761,5.209566278038271,0.16051180599872367
229,0.027,8,164,8,18869,657575,503,125753,5.2082673298694715,0.16053683769761837
230,0.0271,4,156,4,19025,657419,507,125749,5.207031745025979,0.16056452766200865
231,0.0272,11,189,11,19214,657230,518,125738,5.205534786465594,0.16059149288348948
232,0.0273,2,194,2,19408,657036,520,125736,5.203998225826892,0.16062914871763426
233,0.0274,8,214,8,19622,656822,528,125728,5.202303256874921,0.16066449428151555
234,0.0275,11,166,11,19788,656656,539,125717,5.200988467874794,0.16068678239151912
235,0.0276,9,196,9,19984,656460,548,125708,5.199436066404765,0.16071739063730553
236,0.0277,5,195,5,20179,656265,553,125703,5.1978915853503995,0.1607521023878215
237,0.0278,4,200,4,20379,656065,557,125699,5.196307502217716,0.16078893374471068
238,0.0279,6,183,6,20562,655882,563,125693,5.194858066151312,0.16082013882224994
239,0.028,9,195,9,20757,655687,572,125684,5.193313585096946,0.1608506074579169
240,0.0281,6,195,6,20952,655492,578,125678,5.19176910404258,0.1608843145538103
241,0.0282,2,197,2,21149,655295,580,125676,5.190208782156888,0.1609227487320272
242,0.0283,9,191,9,21340,655104,589,125667,5.188695982765175,0.16095244316195145
243,0.0284,5,207,5,21547,654897,594,125662,5.187056456722849,0.16098975221604003
244,0.0285,4,186,4,21733,654711,598,125658,5.185583259409454,0.1610238233451098
245,0.0286,9,202,9,21935,654509,607,125649,5.183983335445444,0.16105583740729443
246,0.0287,10,201,10,22136,654308,617,125639,5.182391331897098,0.1610865866526828
247,0.0288,5,217,5,22353,654091,622,125634,5.180672601698137,0.1611260380262272
248,0.0289,10,193,10,22546,653898,632,125624,5.1791439614750985,0.16115516944999628
249,0.029,11,212,11,22758,653686,643,125613,5.177464833354454,0.16118716949463557
250,0.0291,11,220,11,22978,653466,654,125602,5.175722341908504,0.16122084336668943
251,0.0292,11,222,11,23200,653244,665,125591,5.173964009631225,0.16125495130547549
252,0.0293,3,196,3,23396,653048,668,125588,5.172411608161196,0.16129231116978923
253,0.0294,5,181,5,23577,652867,673,125583,5.170978012926119,0.16132442674545572
254,0.0295,6,213,6,23790,652654,679,125577,5.169290964389811,0.16136211484764806
255,0.0296,8,203,8,23993,652451,687,125569,5.167683120010138,0.16139559394360042
256,0.0297,6,172,6,24165,652279,693,125563,5.166320808516031,0.1614248137796622
257,0.0298,6,206,6,24371,652073,699,125557,5.164689202889368,0.1614611061816031
258,0.0299,9,192,9,24563,651881,708,125548,5.163168483081992,0.1614912744443544
259,0.03,4,202,4,24765,651679,712,125544,5.161568559117982,0.16152893056432968
260,0.0301,3,206,3,24971,651473,715,125541,5.159936953491319,0.16156851742697043
261,0.0302,9,237,9,25208,651236,724,125532,5.15805981497909,0.16160809920079097
262,0.0303,7,213,7,25421,651023,731,125525,5.156372766442783,0.1616448693448441
263,0.0304,9,200,9,25621,650823,740,125516,5.1547886833101,0.16167679325655415
264,0.0305,9,187,9,25808,650636,749,125507,5.153307565581041,0.16170602582256105
265,0.0306,8,208,8,26016,650428,757,125499,5.1516601191230516,0.1617407307646209
266,0.0307,7,200,7,26216,650228,764,125492,5.150076035990368,0.16177486722013099
267,0.0308,7,220,7,26436,650008,771,125485,5.148333544544418,0.16181319496114085
268,0.0309,7,208,7,26644,649800,778,125478,5.146686098086428,0.16184903995727984
269,0.031,6,228,6,26872,649572,784,125472,5.1448802433151695,0.16189016365522474
270,0.0311,7,234,7,27106,649338,791,125465,5.14302686604993,0.1619314845192907
271,0.0312,13,219,13,27325,649119,804,125452,5.1412922950196425,0.16196320285680718
272,0.0313,7,189,7,27514,648930,811,125445,5.139795336459257,0.1619951573849879
273,0.0314,7,252,7,27766,648678,818,125438,5.137799391712077,0.16204031437148955
274,0.0315,10,224,10,27990,648454,828,125428,5.136025218603472,0.16207638890683593
275,0.0316,16,200,16,28190,648254,844,125412,5.134441135470789,0.16210095829466462
276,0.0317,8,215,8,28405,648039,852,125404,5.132738246103155,0.1621373520737792
277,0.0318,11,225,11,28630,647814,863,125393,5.130956152578888,0.16217261354333315
278,0.0319,11,233,11,28863,647581,874,125382,5.129110695729312,0.16220957536130448
279,0.032,5,224,5,29087,647357,879,125377,5.127336522620707,0.1622511756956469
280,0.0321,7,246,7,29333,647111,886,125370,5.125388100367507,0.16229525386384908
281,0.0322,6,266,6,29599,646845,892,125364,5.123281269801039,0.16234465021775193
282,0.0323,7,209,7,29808,646636,899,125357,5.121625902927386,0.1623810060453916
283,0.0324,7,237,7,30045,646399,906,125350,5.1197487644151565,0.16242327492487843
284,0.0325,6,227,6,30272,646172,912,125344,5.117950830059561,0.1624645503139274
285,0.0326,11,210,11,30482,645962,923,125333,5.116287542770245,0.162496839730583
286,0.0327,7,243,7,30725,645719,930,125326,5.114362881764035,0.16254044835256048
287,0.0328,9,225,9,30950,645494,939,125317,5.112580788239767,0.1625781157767598
288,0.0329,10,224,10,31174,645270,949,125307,5.110806615131162,0.16261450834893854
289,0.033,7,233,7,31407,645037,956,125300,5.108961158281587,0.16265608428518946
290,0.0331,9,248,9,31655,644789,965,125291,5.10699689519706,0.16269868065655516
291,0.0332,9,238,9,31893,644551,974,125282,5.105111836269168,0.16273919148698485
292,0.0333,11,221,11,32114,644330,985,125271,5.103361424407553,0.16277395689454666
293,0.0334,5,224,5,32338,644106,990,125266,5.101587251298948,0.1628159069994749
294,0.0335,5,217,5,32555,643889,995,125261,5.099868521099987,0.1628563999219918
295,0.0336,10,211,10,32766,643678,1005,125251,5.098197313395007,0.16289020182617642
296,0.0337,9,253,9,33019,643425,1014,125242,5.096193448232163,0.16293401433910915
297,0.0338,10,249,10,33268,643176,1024,125232,5.094221264731973,0.1629759190430084
298,0.0339,6,269,6,33537,642907,1030,125226,5.0920906729185145,0.16302645505400756
299,0.034,8,238,8,33775,642669,1038,125218,5.090205613990622,0.16306826395029478
300,0.0341,12,224,12,33999,642445,1050,125206,5.088431440882018,0.16310276414672814
301,0.0342,8,256,8,34255,642189,1058,125198,5.086403814472184,0.16314845052105392
302,0.0343,14,284,14,34539,641905,1072,125184,5.0841544164237735,0.16319357988447233
303,0.0344,6,260,6,34799,641645,1078,125178,5.082095108351286,0.1632423649264563
304,0.0345,14,265,14,35064,641380,1092,125164,5.079996198200481,0.16328351666701454
305,0.0346,6,230,6,35294,641150,1098,125158,5.078174502597896,0.16332597336841062
306,0.0347,13,226,13,35520,640924,1111,125145,5.076384488657965,0.16335995843716428
307,0.0348,9,270,9,35790,640654,1120,125136,5.074245976428843,0.16340772274383317
308,0.0349,8,264,8,36054,640390,1128,125128,5.072154986693702,0.16345533351273256
309,0.035,12,245,12,36299,640145,1140,125116,5.070214484856165,0.1634945463051168
310,0.0351,16,241,16,36540,639904,1156,125100,5.068305664681282,0.16352855671342895
311,0.0352,9,251,9,36791,639653,1165,125091,5.066317640349766,0.1635723850072704
312,0.0353,11,244,11,37035,639409,1176,125080,5.0643850589278925,0.16361255688440252
313,0.0354,12,260,12,37295,639149,1188,125068,5.062325750855405,0.16365508749478225
314,0.0355,9,271,9,37566,638878,1197,125059,5.060179318210619,0.1637032896691743
315,0.0356,9,237,9,37803,638641,1206,125050,5.058302179698391,0.16374423687067152
316,0.0357,13,257,13,38060,638384,1219,125037,5.056266632872894,0.163785119874879
317,0.0358,11,252,11,38312,638132,1230,125026,5.054270688125713,0.16382714981694485
318,0.0359,4,284,4,38596,637848,1234,125022,5.052021290077303,0.16388375476817807
319,0.036,12,258,12,38854,637590,1246,125010,5.0499778228361425,0.16392604248623133
320,0.0361,17,267,17,39121,637323,1263,124993,5.047863071854011,0.1639648124924572
321,0.0362,11,256,11,39377,637067,1274,124982,5.045835445444177,0.16400782626838956
322,0.0363,7,290,7,39667,636777,1281,124975,5.043538524901787,0.16406258204770055
323,0.0364,8,225,8,39892,636552,1289,124967,5.041756431377519,0.16410227453287443
324,0.0365,9,273,9,40165,636279,1298,124958,5.039594157901407,0.1641512433053044
325,0.0366,13,257,13,40422,636022,1311,124945,5.03755861107591,0.16419240256147768
326,0.0367,9,238,9,40660,635784,1320,124936,5.035673552148017,0.1642338836891366
327,0.0368,8,266,8,40926,635518,1328,124928,5.033566721581549,0.16428253945710808
328,0.0369,10,279,10,41205,635239,1338,124918,5.0313569256114565,0.16433184197474995
329,0.037,6,252,6,41457,634987,1344,124912,5.029360980864276,0.1643797399391235
330,0.0371,6,268,6,41725,634719,1350,124906,5.0272383094664805,0.16443113378311666
331,0.0372,10,275,10,42000,634444,1360,124896,5.025060195159042,0.16447967972186373
332,0.0373,18,257,18,42257,634187,1378,124878,5.023024648333545,0.1645155553213493
333,0.0374,14,246,14,42503,633941,1392,124864,5.0210762260803445,0.16455347553060404
334,0.0375,11,258,11,42761,633683,1403,124853,5.019032758839184,0.16459732959279455
335,0.0376,9,228,9,42989,633455,1412,124844,5.017226904067925,0.16463690444006915
336,0.0377,15,243,15,43232,633212,1427,124829,5.015302243061716,0.1646731509245542
337,0.0378,11,278,11,43510,632934,1438,124818,5.0131003675072865,0.16472143920438348
338,0.0379,9,292,9,43802,632642,1447,124809,5.01078760613357,0.16477501514949483
339,0.038,12,246,12,44048,632396,1459,124797,5.00883918388037,0.16481531128787508
340,0.0381,17,257,17,44305,632139,1476,124780,5.0068036370548725,0.16485251394138606
341,0.0382,10,283,10,44588,631856,1486,124770,5.004562159422126,0.16490313576324367
342,0.0383,15,279,15,44867,631577,1501,124755,5.002352363452034,0.16494740405007324
343,0.0384,8,260,8,45127,631317,1509,124747,5.000293055379546,0.16499529140390232
344,0.0385,12,250,12,45377,631067,1521,124735,4.998312951463693,0.16503661011746462
345,0.0386,7,271,7,45648,630796,1528,124728,4.9961665188189075,0.16508807132533182
346,0.0387,13,264,13,45912,630532,1541,124715,4.994075529083767,0.16513140734090967
347,0.0388,21,287,21,46199,630245,1562,124694,4.991802369788367,0.16517096083259708
348,0.0389,13,272,13,46471,629973,1575,124681,4.989648016727918,0.16521611228457014
349,0.039,8,296,8,46767,629677,1583,124673,4.987303573691547,0.16527208855305892
350,0.0391,16,290,16,47057,629387,1599,124657,4.985006653149157,0.16531793900621183
351,0.0392,11,271,11,47328,629116,1610,124646,4.982860220504372,0.16536519484930257
352,0.0393,11,298,11,47626,628818,1621,124635,4.980499936636675,0.1654184136236766
353,0.0394,10,274,10,47900,628544,1631,124625,4.978329742744899,0.1654675112756898
354,0.0395,8,307,8,48207,628237,1639,124617,4.975898175136231,0.1655261179458434
355,0.0396,15,265,15,48472,627972,1654,124602,4.973799264985426,0.16556777140852594
356,0.0397,18,278,18,48750,627694,1672,124584,4.971597389430998,0.16560899029348194
357,0.0398,13,284,13,49034,627410,1685,124571,4.9693479913825875,0.16565711101743263
358,0.0399,17,270,17,49304,627140,1702,124554,4.967209479153466,0.16569774402882023
359,0.04,13,288,13,49592,626852,1715,124541,4.964928399442403,0.1657468195737783
360,0.0401,24,289,24,49881,626563,1739,124517,4.962639399315676,0.1657839377962401
361,0.0402,15,272,15,50153,626291,1754,124502,4.9604850462552275,0.16582733190106994
362,0.0403,11,283,11,50436,626008,1765,124491,4.958243568622481,0.1658776360794618
363,0.0404,18,302,18,50738,625706,1783,124473,4.95585160309213,0.1659243993766821
364,0.0405,4,269,4,51007,625437,1787,124469,4.953721011278672,0.16597946942683484
365,0.0406,8,326,8,51333,625111,1795,124461,4.951138955772399,0.1660427550655574
366,0.0407,10,305,10,51638,624806,1805,124451,4.948723228995058,0.1660992156229438
367,0.0408,13,283,13,51921,624523,1818,124438,4.946481751362311,0.16614750300749973
368,0.0409,5,291,5,52212,624232,1823,124433,4.944176910404258,0.16620651426205313
369,0.041,19,267,19,52479,623965,1842,124414,4.942062159422126,0.16624464342265083
370,0.0411,15,308,15,52787,623657,1857,124399,4.939622671397795,0.16629637353353224
371,0.0412,8,307,8,53094,623350,1865,124391,4.937191103789127,0.1663557301258056
372,0.0413,15,308,15,53402,623042,1880,124376,4.934751615764795,0.1664075524003971
373,0.0414,17,286,17,53688,622756,1897,124359,4.932486376885059,0.16645228646192353
374,0.0415,16,272,16,53960,622484,1913,124343,4.930332023824611,0.166495051732195
375,0.0416,21,271,21,54231,622213,1934,124322,4.928185591179825,0.16653204471324184
376,0.0417,13,315,13,54546,621898,1947,124309,4.9256906602458495,0.16658782348597642
377,0.0418,15,272,15,54818,621626,1962,124294,4.923536307185401,0.16663181038181038
378,0.0419,15,272,15,55090,621354,1977,124279,4.921381954124953,0.16667583113944795
379,0.042,15,293,15,55383,621061,1992,124264,4.919061272335572,0.1667245832355013
380,0.0421,18,340,18,55723,620721,2010,124246,4.916368331010012,0.16678054195689204
381,0.0422,18,293,18,56016,620428,2028,124228,4.914047649220631,0.1668260243656131
382,0.0423,12,252,12,56268,620176,2040,124216,4.912051704473451,0.16686906898515835
383,0.0424,21,290,21,56558,619886,2061,124195,4.909754783931061,0.16691059172321293
384,0.0425,11,294,11,56852,619592,2072,124184,4.907426181726017,0.16696424730026244
385,0.0426,12,294,12,57146,619298,2084,124172,4.905097579520973,0.16701682650275063
386,0.0427,14,323,14,57469,618975,2098,124158,4.902539285261691,0.1670737270448224
387,0.0428,16,291,16,57760,618684,2114,124142,4.900234444303637,0.16712123700570525
388,0.0429,20,298,20,58058,618386,2134,124122,4.89787416043594,0.167165875653865
389,0.043,17,305,17,58363,618081,2151,124105,4.8954584336585985,0.16721549584605477
390,0.0431,7,287,7,58650,617794,2158,124098,4.893185274363199,0.167272325351938
391,0.0432,17,281,17,58931,617513,2175,124081,4.890959637561779,0.16731661798773992
392,0.0433,18,316,18,59247,617197,2193,124063,4.88845678621214,0.16736772522461754
393,0.0434,17,300,17,59547,616897,2210,124046,4.886080661513116,0.16741638695554178
394,0.0435,11,296,11,59843,616601,2221,124035,4.883736218476746,0.16747093038955707
395,0.0436,17,313,17,60156,616288,2238,124018,4.881257128374097,0.16752261902510585
396,0.0437,19,303,19,60459,615985,2257,123999,4.878857242428083,0.16756983934787778
397,0.0438,10,330,10,60789,615655,2267,123989,4.876243505259156,0.1676333479349525
398,0.0439,13,325,13,61114,615330,2280,123976,4.873669370168546,0.1676924034161768
399,0.044,10,323,10,61437,615007,2290,123966,4.871111075909264,0.16775443757755695
400,0.0441,14,323,14,61760,614684,2304,123952,4.868552781649981,0.1678120210766873
401,0.0442,15,332,15,62092,614352,2319,123937,4.865923203649728,0.1678705764273882
402,0.0443,13,303,13,62395,614049,2332,123924,4.863523317703713,0.16792484277880085
403,0.0444,23,284,23,62679,613765,2355,123901,4.861273919655304,0.16796354989927692
404,0.0445,12,343,12,63022,613422,2367,123889,4.858557217082753,0.16802814551797002
405,0.0446,19,293,19,63315,613129,2386,123870,4.856236535293372,0.16807349806444785
406,0.0447,19,300,19,63615,612829,2405,123851,4.853860410594348,0.16812048650703154
407,0.0448,15,292,15,63907,612537,2420,123836,4.851547649220631,0.16817020721835266
408,0.0449,9,317,9,64224,612220,2429,123827,4.849036877455329,0.16823246341605902
409,0.045,18,297,18,64521,611923,2447,123809,4.846684514003295,0.16828002587898855
410,0.0451,9,300,9,64821,611623,2456,123800,4.84430838930427,0.16833849362883674
411,0.0452,20,315,20,65136,611308,2476,123780,4.841813458370296,0.16838800252486777
412,0.0453,15,290,15,65426,611018,2491,123765,4.8395165378279055,0.16843748426406163
413,0.0454,14,297,14,65723,610721,2505,123751,4.8371641743758715,0.16848974501410538
414,0.0455,14,299,14,66022,610422,2519,123737,4.83479597009251,0.16854250918397787
415,0.0456,14,309,14,66331,610113,2533,123723,4.832348561652515,0.1685976158160679
416,0.0457,19,321,19,66652,609792,2552,123704,4.82980610822456,0.16864986312127128
417,0.0458,19,320,19,66972,609472,2571,123685,4.827271575212267,0.16870192878196621
418,0.0459,19,347,19,67319,609125,2590,123666,4.824523190977063,0.1687602604289627
419,0.046,19,334,19,67653,608791,2609,123647,4.821877772145482,0.16881565402122772
420,0.0461,19,293,19,67946,608498,2628,123628,4.819557090356102,0.16886164403395043
421,0.0462,23,298,23,68244,608200,2651,123605,4.817196806488404,0.16890428461133772
422,0.0463,14,306,14,68550,607894,2665,123591,4.8147731592954,0.1689590353869184
423,0.0464,20,316,20,68866,607578,2685,123571,4.812270307945761,0.16900932641636657
424,0.0465,12,349,12,69215,607229,2697,123559,4.8095060828792295,0.16907639424840035
425,0.0466,21,307,21,69522,606922,2718,123538,4.807074515270561,0.16912356597212716
426,0.0467,12,303,12,69825,606619,2730,123526,4.804674629324547,0.16918009436481796
427,0.0468,13,347,13,70172,606272,2743,123513,4.8019262450893425,0.1692457367580863
428,0.0469,18,334,18,70506,605938,2761,123495,4.799280826257762,0.16930273239625845
429,0.047,12,311,12,70817,605627,2773,123483,4.79681757698644,0.1693612760763122
430,0.0471,18,299,18,71116,605328,2791,123465,4.794449372703079,0.16941024406107083
431,0.0472,20,325,20,71441,605003,2811,123445,4.79187523761247,0.16946302275522757
432,0.0473,13,303,13,71744,604700,2824,123432,4.789475351666455,0.16951871363983453
433,0.0474,13,329,13,72073,604371,2837,123419,4.786869534913192,0.16958051086164966
434,0.0475,11,341,11,72414,604030,2848,123408,4.784168673171968,0.16964744761752892
435,0.0476,16,345,16,72759,603685,2864,123392,4.78143612976809,0.16970967311577728
436,0.0477,12,341,12,73100,603344,2876,123380,4.778735268026866,0.1697755956869458
437,0.0478,16,342,16,73442,603002,2892,123364,4.776026485869979,0.16983724458468596
438,0.0479,18,302,18,73744,602700,2910,123346,4.773634520339628,0.16988730741578356
439,0.048,16,369,16,74113,602331,2926,123330,4.770711886959828,0.1699553923939691
440,0.0481,14,320,14,74433,602011,2940,123316,4.768177353947535,0.17001435214737629
441,0.0482,17,313,17,74746,601698,2957,123299,4.765698263844887,0.17006828993775147
442,0.0483,19,345,19,75091,601353,2976,123280,4.7629657204410085,0.17012749902364369
443,0.0484,16,333,16,75424,601020,2992,123264,4.760328222025092,0.17018738505889955
444,0.0485,21,339,21,75763,600681,3013,123243,4.757643201115195,0.17024300893463956
445,0.0486,22,354,22,76117,600327,3035,123221,4.754839373970346,0.1703010719399404
446,0.0487,19,349,19,76466,599978,3054,123202,4.752075148903814,0.17036145911114797
447,0.0488,20,324,20,76790,599654,3074,123182,4.749508934228868,0.17041486588935803
448,0.0489,18,336,18,77126,599318,3092,123164,4.746847674565961,0.17047345124169183
449,0.049,16,331,16,77457,598987,3108,123148,4.744226016981371,0.17053321054927403
450,0.0491,19,320,19,77777,598667,3127,123129,4.7416914839690785,0.17058698025480884
451,0.0492,19,336,19,78113,598331,3146,123110,4.7390302243061715,0.1706445849348734
452,0.0493,23,321,23,78434,598010,3169,123087,4.736487770878216,0.17069409524654797
453,0.0494,21,308,21,78742,597702,3190,123066,4.734048282853884,0.17074287426744805
454,0.0495,20,321,20,79063,597381,3210,123046,4.731505829425928,0.17079593074662666
455,0.0496,19,351,19,79414,597030,3229,123027,4.72872576352807,0.17085730712985223
456,0.0497,11,308,11,79722,596722,3240,123016,4.726286275503738,0.1709177506259222
457,0.0498,20,320,20,80042,596402,3260,122996,4.723751742491446,0.170970728303387
458,0.0499,16,343,16,80385,596059,3276,122980,4.7210350399188945,0.17103383822017998
459,0.05,16,333,16,80718,595726,3292,122964,4.718397541502978,0.1710946305082859
460,0.0501,17,376,17,81094,595350,3309,122947,4.715419465213534,0.1711645739854127
461,0.0502,25,386,25,81480,594964,3334,122922,4.712362184767456,0.17122774368075153
462,0.0503,26,368,26,81848,594596,3360,122896,4.70944747180332,0.1712855334972376
463,0.0504,22,360,22,82208,594236,3382,122874,4.706596122164491,0.17134609753036495
464,0.0505,21,306,21,82514,593930,3403,122853,4.704172474971487,0.1713949689096979
465,0.0506,17,314,17,82828,593616,3420,122836,4.701685464453175,0.17145042515060324
466,0.0507,22,338,22,83166,593278,3442,122814,4.69900836395894,0.1715058958904722
467,0.0508,20,340,20,83506,592938,3462,122794,4.69631542263338,0.17156421677387626
468,0.0509,13,361,13,83867,592577,3475,122781,4.693456152578888,0.17163574042647178
469,0.051,15,349,15,84216,592228,3490,122766,4.690691927512356,0.1717021401578195
470,0.0511,22,292,22,84508,591936,3512,122744,4.688379166138639,0.17174679576873567
471,0.0512,20,334,20,84842,591602,3532,122724,4.685733747307059,0.17180391025946137
472,0.0513,24,345,24,85187,591257,3556,122700,4.6830012039031805,0.1718590895530123
473,0.0514,21,325,21,85512,590932,3577,122679,4.6804270688125715,0.1719129890094183
474,0.0515,17,365,17,85877,590567,3594,122662,4.677536117095425,0.1719812290302273
475,0.0516,17,374,17,86251,590193,3611,122645,4.674573881637309,0.17205171441477587
476,0.0517,16,328,16,86579,589865,3627,122629,4.671975985299708,0.17211232655994296
477,0.0518,27,326,27,86905,589539,3654,122602,4.6693939297934355,0.1721597267956767
478,0.0519,14,328,14,87233,589211,3668,122588,4.666796033455836,0.17222277637366729
479,0.052,21,342,21,87575,588869,3689,122567,4.664087251298948,0.17228113280744858
480,0.0521,18,332,18,87907,588537,3707,122549,4.6614576732986945,0.1723406170280388
481,0.0522,24,385,24,88292,588152,3731,122525,4.65840831326828,0.17240602974346997
482,0.0523,10,350,10,88642,587802,3741,122515,4.655636167786086,0.17247932965140916
483,0.0524,19,320,19,88962,587482,3760,122496,4.653101634773793,0.1725349236173515
484,0.0525,22,347,22,89309,587135,3782,122474,4.650353250538588,0.17259363959589014
485,0.0526,18,368,18,89677,586767,3800,122456,4.647438537574452,0.17266219510647568
486,0.0527,21,364,21,90041,586403,3821,122435,4.644555506272969,0.17272634932100142
487,0.0528,21,383,21,90424,586020,3842,122414,4.641521987073881,0.17279520745757543
488,0.0529,27,347,27,90771,585673,3869,122387,4.638773602838677,0.17284834618535153
489,0.053,22,336,22,91107,585337,3891,122365,4.63611234317577,0.17290469717479956
490,0.0531,21,367,21,91474,584970,3912,122344,4.633205550627297,0.17296985497247333
491,0.0532,18,326,18,91800,584644,3930,122326,4.630623495121024,0.17302855849611723
492,0.0533,19,365,19,92165,584279,3949,122307,4.627732543403877,0.17309570243395708
493,0.0534,20,373,20,92538,583906,3969,122287,4.624778228361424,0.17316371020386778
494,0.0535,24,381,24,92919,583525,3993,122263,4.621760549993664,0.17322907161923978
495,0.0536,19,356,19,93275,583169,4012,122244,4.618940882017489,0.17329422621925028
496,0.0537,19,339,19,93614,582830,4031,122225,4.616255861107591,0.17335527015622895
497,0.0538,16,381,16,93995,582449,4047,122209,4.61323818273983,0.17343023140303523
498,0.0539,24,369,24,94364,582080,4071,122185,4.61031554936003,0.1734929323479088
499,0.054,22,369,22,94733,581711,4093,122163,4.60739291598023,0.17355805158309584
500,0.0541,16,348,16,95081,581363,4109,122147,4.604636611329362,0.1736251083850976
501,0.0542,34,360,34,95441,581003,4143,122113,4.601785261690534,0.17367404525000144
502,0.0543,27,337,27,95778,580666,4170,122086,4.599116081611963,0.17372558171303676
503,0.0544,18,359,18,96137,580307,4188,122068,4.596272652388797,0.173793201637302
504,0.0545,29,381,29,96518,579926,4217,122039,4.593254974021036,0.1738533972491506
505,0.0546,21,346,21,96864,579580,4238,122018,4.590514510201495,0.17391440682556109
506,0.0547,22,347,22,97211,579233,4260,121996,4.587766125966291,0.1739745503965181
507,0.0548,32,388,32,97599,578845,4292,121964,4.584693004688886,0.17403315311304507
508,0.0549,23,357,23,97956,578488,4315,121941,4.581865416297047,0.17409473337054862
509,0.055,15,300,15,98256,578188,4330,121926,4.579489291598023,0.17415163816178508
510,0.0551,19,368,19,98624,577820,4349,121907,4.5765745786338865,0.17422080325612704
511,0.0552,26,361,26,98985,577459,4375,121881,4.573715308579394,0.17428003546200704
512,0.0553,18,376,18,99361,577083,4393,121863,4.57073723228995,0.17435252508777502
513,0.0554,31,335,31,99696,576748,4424,121832,4.568083893042707,0.174399496120702
514,0.0555,28,352,28,100048,576396,4452,121804,4.565295906729185,0.17445431108564882
515,0.0556,21,344,21,100392,576052,4473,121783,4.56257128374097,0.17451546569031362
516,0.0557,22,353,22,100745,575699,4495,121761,4.5597753770117855,0.17457775356292835
517,0.0558,18,352,18,101097,575347,4513,121743,4.556987390698263,0.17464459395486953
518,0.0559,20,366,20,101463,574981,4533,121723,4.554088518565455,0.17471264697776961
519,0.056,29,382,29,101845,574599,4562,121694,4.55106291978203,0.1747741252604866
520,0.0561,18,342,18,102187,574257,4580,121676,4.548354137625142,0.17483866981447926
521,0.0562,20,376,20,102563,573881,4600,121656,4.545376061335699,0.17490945844721417
522,0.0563,19,348,19,102911,573533,4619,121637,4.5426197566848305,0.17497446667721564
523,0.0564,18,329,18,103240,573204,4637,121619,4.540013939931567,0.1750359444059854
524,0.0565,22,351,22,103591,572853,4659,121597,4.537233874033709,0.17509827921376628
525,0.0566,30,355,30,103946,572498,4689,121567,4.534422126473197,0.17515218315287473
526,0.0567,25,419,25,104365,572079,4714,121542,4.531103472310227,0.17522825865998867
527,0.0568,22,337,22,104702,571742,4736,121520,4.5284342922316565,0.1752872651320857
528,0.0569,18,342,18,105044,571400,4754,121502,4.525725510074769,0.17535235863080204
529,0.057,19,356,19,105400,571044,4773,121483,4.522905842098593,0.17541987532616057
530,0.0571,18,357,18,105757,570687,4791,121465,4.520078253706754,0.17548890995041552
531,0.0572,31,356,31,106113,570331,4822,121434,4.517258585730579,0.17554227230345565
532,0.0573,22,359,22,106472,569972,4844,121412,4.514415156507414,0.17560718790136884
533,0.0574,28,337,28,106809,569635,4872,121384,4.511745976428843,0.17565942470467527
534,0.0575,27,317,27,107126,569318,4899,121357,4.509235204663541,0.17570782205813154
535,0.0576,24,383,24,107509,568935,4923,121333,4.506201685464453,0.1757766548644874
536,0.0577,34,360,34,107869,568575,4957,121299,4.503350335825624,0.17582775985179902
537,0.0578,33,414,33,108283,568161,4990,121266,4.50007128374097,0.17589389449499368
538,0.0579,26,349,26,108632,567812,5016,121240,4.497307058674439,0.17595188752082572
539,0.058,38,318,38,108950,567494,5054,121202,4.494788366493474,0.17598766364259413
540,0.0581,28,357,28,109307,567137,5082,121174,4.491960778101634,0.1760454213284402
541,0.0582,19,365,19,109672,566772,5101,121155,4.489069826384489,0.17611607045515004
542,0.0583,30,381,30,110053,566391,5131,121125,4.486052148016728,0.17617771804583457
543,0.0584,32,353,32,110406,566038,5163,121093,4.483256241287543,0.17622986009945701
544,0.0585,21,340,21,110746,565698,5184,121072,4.480563299961982,0.1762919172357558
545,0.0586,22,370,22,111116,565328,5206,121050,4.477632746166519,0.17636054768655174
546,0.0587,21,395,21,111511,564933,5227,121029,4.47450418197947,0.1764368871745082
547,0.0588,23,396,23,111907,564537,5250,121006,4.471367697376758,0.17651117435376046
548,0.0589,18,385,18,112292,564152,5268,120988,4.468318337346344,0.17658872639168638
549,0.059,24,397,24,112689,563755,5292,120964,4.465173932327969,0.17666225123006665
550,0.0591,16,391,16,113080,563364,5308,120948,4.462077049803574,0.17674394136008137
551,0.0592,23,357,23,113437,563007,5331,120925,4.459249461411735,0.17680851312703602
552,0.0593,27,392,27,113829,562615,5358,120898,4.456144658471676,0.1768773966259603
553,0.0594,24,354,24,114183,562261,5382,120874,4.453340831326828,0.1769401362834579
554,0.0595,22,393,22,114576,561868,5404,120852,4.450228107971106,0.1770154675415983
555,0.0596,30,375,30,114951,561493,5434,120822,4.447257952097326,0.17707657020584333
556,0.0597,28,367,28,115318,561126,5462,120794,4.444351159548853,0.17713808071328016
557,0.0598,17,346,17,115664,560780,5479,120777,4.441610695729312,0.17720748227954522
558,0.0599,16,341,16,116005,560439,5495,120761,4.438909833988088,0.17727686435701703
559,0.06,23,386,23,116391,560053,5518,120738,4.43585255354201,0.17734958305853044
560,0.0601,26,387,26,116778,559666,5544,120712,4.432787352680268,0.17741902295488685
561,0.0602,23,355,23,117133,559311,5567,120689,4.429975605119757,0.17748382352941178
562,0.0603,16,376,16,117509,558935,5583,120673,4.426997528830313,0.17756265376511166
563,0.0604,30,371,30,117880,558564,5613,120643,4.424059054619186,0.17762331660303854
564,0.0605,24,385,24,118265,558179,5637,120619,4.421009694588772,0.1776949843694295
565,0.0606,23,370,23,118635,557809,5660,120596,4.418079140793309,0.17776402001754116
566,0.0607,26,375,26,119010,557434,5686,120570,4.415108984919528,0.17783080925776248
567,0.0608,32,374,32,119384,557060,5718,120538,4.412146749461412,0.17789013544904206
568,0.0609,17,371,17,119755,556689,5735,120521,4.409208275250285,0.17796695264393614
569,0.061,27,398,27,120153,556291,5762,120494,4.406055949816246,0.17803881587210119
570,0.0611,28,367,28,120520,555924,5790,120466,4.403149157267773,0.17810139120921362
571,0.0612,21,376,21,120896,555548,5811,120445,4.40017108097833,0.17817492192966494
572,0.0613,37,379,37,121275,555169,5848,120408,4.397169243441896,0.1782298686900235
573,0.0614,26,371,26,121646,554798,5874,120382,4.394230769230769,0.17829615806155397
574,0.0615,24,389,24,122035,554409,5898,120358,4.391149727537702,0.17836971873254026
575,0.0616,38,365,38,122400,554044,5936,120320,4.388258775820555,0.17841996310597838
576,0.0617,14,374,14,122774,553670,5950,120306,4.385296540362439,0.1785019051123482
577,0.0618,22,393,22,123167,553277,5972,120284,4.382183817006717,0.17857922296570022
578,0.0619,26,344,26,123511,552933,5998,120258,4.379459194018502,0.17863875185497133
579,0.062,35,410,35,123921,552523,6033,120223,4.376211823596503,0.17870489010711324
580,0.0621,29,415,29,124336,552108,6062,120194,4.372924851096186,0.17877977456559702
581,0.0622,26,401,26,124737,551707,6088,120168,4.3697487644151565,0.1788546976744186
582,0.0623,24,402,24,125139,551305,6112,120144,4.366564757318464,0.17893242822611993
583,0.0624,28,367,28,125506,550938,6140,120116,4.363657964769991,0.17899602714535642
584,0.0625,21,381,21,125887,550557,6161,120095,4.36064028640223,0.17907200753893227
585,0.0626,22,418,22,126305,550139,6183,120073,4.357329552654924,0.17915674443310475
586,0.0627,20,400,20,126705,549739,6203,120053,4.354161386389558,0.17923922650613922
587,0.0628,25,402,25,127107,549337,6228,120028,4.350977379292865,0.17931621760922664
588,0.0629,29,411,29,127518,548926,6257,119999,4.347722088455202,0.17939081361886608
589,0.063,19,379,19,127897,548547,6276,119980,4.344720250918768,0.1794691912218953
590,0.0631,41,368,41,128265,548179,6317,119939,4.341805537954632,0.17951768998889417
591,0.0632,30,357,30,128622,547822,6347,119909,4.338977949562793,0.17957680562981201
592,0.0633,23,442,23,129064,547380,6370,119886,4.335477125839564,0.17966747893643614
593,0.0634,27,367,27,129431,547013,6397,119859,4.332570333291091,0.1797331421922048
594,0.0635,32,373,32,129804,546640,6429,119827,4.329616018248638,0.179794348407348
595,0.0636,25,375,25,130179,546265,6454,119802,4.326645862374858,0.17986478837714523
596,0.0637,40,366,40,130545,545899,6494,119762,4.323746990242048,0.17991440087371802
597,0.0638,24,390,24,130935,545509,6518,119738,4.320658028133316,0.1799902893211093
598,0.0639,28,354,28,131289,545155,6546,119710,4.317854200988468,0.18005158942040866
599,0.064,25,365,25,131654,544790,6571,119685,4.3149632492713215,0.18011964332743896
600,0.0641,20,390,20,132044,544400,6591,119665,4.31187428716259,0.180200733361945
601,0.0642,29,395,29,132439,544005,6620,119636,4.308745722975542,0.1802721652218594
602,0.0643,28,391,28,132830,543614,6648,119608,4.305648840451147,0.1803438366037315
603,0.0644,34,375,34,133205,543239,6682,119574,4.302678684577367,0.18040382430640317
604,0.0645,22,453,22,133658,542786,6704,119552,4.2990907362818405,0.18049998641177165
605,0.0646,28,370,28,134028,542416,6732,119524,4.296160182486377,0.18056621446052512
606,0.0647,33,384,33,134412,542032,6765,119491,4.293118742871626,0.18063015193727203
607,0.0648,33,396,33,134808,541636,6798,119458,4.289982258268914,0.18069744998441978
608,0.0649,25,367,25,135175,541269,6823,119433,4.287075465720441,0.18076682074520736
609,0.065,21,421,21,135596,540848,6844,119412,4.283740970726144,0.18085602641383697
610,0.0651,22,361,22,135957,540487,6866,119390,4.280881700671651,0.18092765773015274
611,0.0652,31,392,31,136349,540095,6897,119359,4.277776897731593,0.18099670333336365
612,0.0653,26,386,26,136735,539709,6923,119333,4.274719617285515,0.18107040218984527
613,0.0654,31,367,31,137102,539342,6954,119302,4.271812824737042,0.1811327515319353
614,0.0655,20,374,20,137476,538968,6974,119282,4.268850589278926,0.18121078617546524
615,0.0656,29,373,29,137849,538595,7003,119253,4.265896274236472,0.1812774379491919
616,0.0657,36,384,36,138233,538211,7039,119217,4.262854834621721,0.1813384887774783
617,0.0658,25,362,25,138595,537849,7064,119192,4.259987644151565,0.18140724855830914
618,0.0659,28,407,28,139002,537442,7092,119164,4.256764034976555,0.18148478691940068
619,0.066,38,387,38,139389,537055,7130,119126,4.2536988341148145,0.1815444214325011
620,0.0661,22,373,22,139762,536682,7152,119104,4.250744519072361,0.18162022367052666
621,0.0662,27,389,27,140151,536293,7179,119077,4.247663477379293,0.1816943100843798
622,0.0663,29,407,29,140558,535886,7208,119048,4.244439868204283,0.18177098761096538
623,0.0664,39,386,39,140944,535500,7247,119009,4.241382587758205,0.18182943244477923
624,0.0665,30,433,30,141377,535067,7277,118979,4.237953047775948,0.18191228139916765
625,0.0666,30,380,30,141757,534687,7307,118949,4.23494328982385,0.1819804906706485
626,0.0667,31,458,31,142215,534229,7338,118918,4.2313157394500065,0.18206927383881424
627,0.0668,34,360,34,142575,533869,7372,118884,4.228464389811177,0.1821270832918424
628,0.0669,36,376,36,142951,533493,7408,118848,4.225486313521734,0.18218692371014547
629,0.067,27,400,27,143351,533093,7435,118821,4.2223181472563684,0.18226483861368217
630,0.0671,29,395,29,143746,532698,7464,118792,4.219189583069319,0.18233894610815207
631,0.0672,40,398,40,144144,532300,7504,118752,4.216037257635281,0.18240017694439153
632,0.0673,29,427,29,144571,531873,7533,118723,4.2126552401470025,0.18248344594802304
633,0.0674,27,393,27,144964,531480,7560,118696,4.209542516791281,0.18255979919283394
634,0.0675,29,404,29,145368,531076,7589,118667,4.206342668863262,0.18263682717628354
635,0.0676,33,401,33,145769,530675,7622,118634,4.203166582182233,0.1827080788961804
636,0.0677,26,372,26,146141,530303,7648,118608,4.200220187555443,0.18278007307627703
637,0.0678,24,360,24,146501,529943,7672,118584,4.197368837916614,0.1828512922360981
638,0.0679,26,397,26,146898,529546,7698,118558,4.194224432898238,0.18293051732438004
639,0.068,30,405,30,147303,529141,7728,118528,4.191016664554556,0.1830070607053912
640,0.0681,26,411,26,147714,528730,7754,118502,4.187761373716893,0.18309045288242856
641,0.0682,43,433,43,148147,528297,7797,118459,4.1843318337346345,0.18315871828015512
642,0.0683,32,403,32,148550,527894,7829,118427,4.1811399062222785,0.18323248045475854
643,0.0684,34,369,34,148919,527525,7863,118393,4.1782172728424785,0.18329416427472217
644,0.0685,25,370,25,149289,527155,7888,118368,4.1752867190470155,0.18336759495788685
645,0.0686,39,394,39,149683,526761,7927,118329,4.172166075275631,0.18343021903920384
646,0.0687,29,384,29,150067,526377,7956,118300,4.1691246356608795,0.18350274633653751
647,0.0688,27,413,27,150480,525964,7983,118273,4.165853503991889,0.1835861647188845
648,0.0689,21,406,21,150886,525558,8004,118252,4.162637815232544,0.18367530793246456
649,0.069,28,374,28,151260,525184,8032,118224,4.159675579774427,0.18374654962325615
650,0.0691,32,396,32,151656,524788,8064,118192,4.1565390951717145,0.18381909235123955
651,0.0692,26,378,26,152034,524410,8090,118166,4.153545178050944,0.1838942008416125
652,0.0693,37,386,37,152420,524024,8127,118129,4.150487897604866,0.18395771724184112
653,0.0694,27,356,27,152776,523668,8154,118102,4.147668229628691,0.18402542967106597
654,0.0695,35,372,35,153148,523296,8189,118067,4.144721835001901,0.18408763835768513
655,0.0696,35,391,35,153539,522905,8224,118032,4.141624952477506,0.18415538500663872
656,0.0697,32,416,32,153955,522489,8256,118000,4.138330059561526,0.18423423353094276
657,0.0698,32,390,32,154345,522099,8288,117968,4.135241097452794,0.18430570549645584
658,0.0699,32,415,32,154760,521684,8320,117936,4.131954124952477,0.1843844782839811
659,0.07,40,395,40,155155,521289,8360,117896,4.128825560765429,0.18444738221328724
660,0.0701,30,398,30,155553,520891,8390,117866,4.12567323533139,0.18452400521638118
661,0.0702,29,401,29,155954,520490,8419,117837,4.122497148650361,0.18460287595542724
662,0.0703,30,429,30,156383,520061,8449,117807,4.119099290330756,0.1846886816708159
663,0.0704,32,440,32,156823,519621,8481,117775,4.115614307438855,0.18477524176493107
664,0.0705,28,399,28,157222,519222,8509,117747,4.112454061589152,0.1848551499366531
665,0.0706,30,391,30,157613,518831,8539,117717,4.109357179064757,0.1849302801988224
666,0.0707,24,436,24,158049,518395,8563,117693,4.105903877835509,0.185026285671165
667,0.0708,22,396,22,158445,517999,8585,117671,4.102767393232797,0.18511334497459372
668,0.0709,36,399,36,158844,517600,8621,117635,4.099607147383095,0.18518343605122514
669,0.071,36,408,36,159252,517192,8657,117599,4.096375617792422,0.18525624969478144
670,0.0711,35,416,35,159668,516776,8692,117564,4.093080724876441,0.18533278683355928
671,0.0712,32,360,32,160028,516416,8724,117532,4.090229375237612,0.18539690952570242
672,0.0713,29,375,29,160403,516041,8753,117503,4.087259219363832,0.18546935966562703
673,0.0714,40,403,40,160806,515638,8793,117463,4.084067291851476,0.18553595713796062
674,0.0715,29,355,29,161161,515283,8822,117434,4.081255544290965,0.18560272602127018
675,0.0716,33,393,33,161554,514890,8855,117401,4.078142820935243,0.18567558291988973
676,0.0717,38,392,38,161946,514498,8893,117363,4.075038017995184,0.18574180080745606
677,0.0718,27,384,27,162330,514114,8920,117336,4.071996578380434,0.18581993823739013
678,0.0719,22,398,22,162728,513716,8942,117314,4.068844252946395,0.18590875235725718
679,0.072,35,393,35,163121,513323,8977,117279,4.065731529590673,0.1859794291803705
680,0.0721,37,413,37,163534,512910,9014,117242,4.062460397921683,0.1860535235943074
681,0.0722,47,416,47,163950,512494,9061,117195,4.059165505005702,0.1861156856797562
682,0.0723,31,389,31,164339,512105,9092,117164,4.056084463312635,0.18619064342912173
683,0.0724,32,379,32,164718,511726,9124,117132,4.0530826257762005,0.18626144535014263
684,0.0725,35,401,35,165119,511325,9159,117097,4.049906539095172,0.18633497872448768
685,0.0726,28,418,28,165537,510907,9187,117069,4.046595805347865,0.18642272953106487
686,0.0727,33,422,33,165959,510485,9220,117036,4.043253389937904,0.1865053121728197
687,0.0728,35,397,35,166356,510088,9255,117001,4.040108984919528,0.18657798175378615
688,0.0729,31,419,31,166775,509669,9286,116970,4.036790330756558,0.18666249626978212
689,0.073,32,393,32,167168,509276,9318,116938,4.033677607400836,0.18673807995349834
690,0.0731,32,417,32,167585,508859,9350,116906,4.030374794069193,0.1868209311802354
691,0.0732,34,396,34,167981,508463,9384,116872,4.0272383094664805,0.1868950242669929
692,0.0733,27,427,27,168408,508036,9411,116845,4.023856291978203,0.1869876024395045
693,0.0734,35,431,35,168839,507605,9446,116810,4.020442592827272,0.18707109854824117
694,0.0735,39,377,39,169216,507228,9485,116771,4.017456596122164,0.18713331271364217
695,0.0736,31,400,31,169616,506828,9516,116740,4.014288429856799,0.1872129422933826
696,0.0737,30,357,30,169973,506471,9546,116710,4.01146084146496,0.18728106280518822
697,0.0738,43,426,43,170399,506045,9589,116667,4.008086744392346,0.18735306208969796
698,0.0739,46,408,46,170807,505637,9635,116621,4.0048552148016725,0.18741583073259002
699,0.074,32,389,32,171196,505248,9667,116589,4.001774173108605,0.18749125574708483
700,0.0741,38,391,38,171587,504857,9705,116551,3.99867729058421,0.18755954220093723
701,0.0742,27,397,27,171984,504460,9732,116524,3.9955328855658343,0.1876441260966466
702,0.0743,33,395,33,172379,504065,9765,116491,3.992404321378786,0.1877203668967829
703,0.0744,38,384,38,172763,503681,9803,116453,3.989362881764035,0.18778683316831524
704,0.0745,26,397,26,173160,503284,9829,116427,3.9862184767456594,0.18787305695719456
705,0.0746,32,371,32,173531,502913,9861,116395,3.983280002534533,0.18794364032113262
706,0.0747,28,402,28,173933,502511,9889,116367,3.9800959954378405,0.1880289814793869
707,0.0748,40,445,40,174378,502066,9929,116327,3.9765714104676215,0.18811176711249966
708,0.0749,34,430,34,174808,501636,9963,116293,3.9731656317323534,0.18819799685724412
709,0.075,34,408,34,175216,501228,9997,116259,3.9699341021416803,0.18827764795048316
710,0.0751,28,421,28,175637,500807,10025,116231,3.966599607147383,0.18836927385347418
711,0.0752,38,392,38,176029,500415,10063,116193,3.9634948042073246,0.18843900825159582
712,0.0753,33,385,33,176414,500030,10096,116160,3.9604454441769104,0.1885132832405589
713,0.0754,32,412,32,176826,499618,10128,116128,3.957182232923584,0.18859724626712962
714,0.0755,29,416,29,177242,499202,10157,116099,3.953887340007604,0.18868651277992396
715,0.0756,33,386,33,177628,498816,10190,116066,3.9508300595615258,0.18876142089051232
716,0.0757,29,366,29,177994,498450,10219,116037,3.947931187428716,0.1888355652764013
717,0.0758,27,405,27,178399,498045,10246,116010,3.9447234190850335,0.18892444487871607
718,0.0759,30,422,30,178821,497623,10276,115980,3.941381003675073,0.18901472124484398
719,0.076,29,419,29,179240,497204,10305,115951,3.9380623495121023,0.18910552796601185
720,0.0761,35,398,35,179638,496806,10340,115916,3.9349100240780635,0.18918204340630823
721,0.0762,31,412,31,180050,496394,10371,115885,3.931646812824737,0.18926829108951965
722,0.0763,42,402,42,180452,495992,10413,115843,3.9284628057280444,0.18933699445111835
723,0.0764,30,394,30,180846,495598,10443,115813,3.9253421619566593,0.18941922863671082
724,0.0765,48,420,48,181266,495178,10491,115765,3.922015587378026,0.18948576217421265
725,0.0766,35,417,35,181683,494761,10526,115730,3.918712774046382,0.1895687241908562
726,0.0767,41,419,41,182102,494342,10567,115689,3.9153941198834117,0.18964446069134192
727,0.0768,26,400,26,182502,493942,10593,115663,3.9122259536180457,0.18973433616850255
728,0.0769,33,381,33,182883,493561,10626,115630,3.9092082752502852,0.189809107488456
729,0.077,34,416,34,183299,493145,10660,115596,3.905913382334305,0.18989356721495676
730,0.0771,39,368,39,183667,492777,10699,115557,3.9029986693701684,0.1899565041572557
731,0.0772,49,418,49,184085,492359,10748,115508,3.8996879356228615,0.190021830433302
732,0.0773,29,381,29,184466,491978,10777,115479,3.8966702572551006,0.19010234469271076
733,0.0774,37,349,37,184815,491629,10814,115442,3.8939060321885695,0.19016227096995245
734,0.0775,44,419,44,185234,491210,10858,115398,3.890587378025599,0.1902348798565136
735,0.0776,31,431,31,185665,490779,10889,115367,3.8871736788746674,0.19032873268156517
736,0.0777,28,355,28,186020,490424,10917,115339,3.8843619313141553,0.19040284731817558
737,0.0778,42,426,42,186446,489998,10959,115297,3.880987834241541,0.19048067471233035
738,0.0779,40,422,40,186868,489576,10999,115257,3.8776454188315803,0.1905600388867671
739,0.078,31,408,31,187276,489168,11030,115226,3.8744138892409072,0.1906471606270082
740,0.0781,43,426,43,187702,488742,11073,115183,3.871039792168293,0.1907240137434284
741,0.0782,41,409,41,188111,488333,11114,115142,3.8678003421619565,0.1907982932184432
742,0.0783,39,427,39,188538,487906,11153,115103,3.8644183246736787,0.19088106479339445
743,0.0784,37,397,37,188935,487509,11190,115066,3.8612739196553036,0.1909571422644484
744,0.0785,36,414,36,189349,487095,11226,115030,3.85799486757065,0.19104006643138882
745,0.0786,33,415,33,189764,486680,11259,114997,3.8547078950703333,0.19112746540087122
746,0.0787,35,366,35,190130,486314,11294,114962,3.8518090229375237,0.19119672163864848
747,0.0788,34,406,34,190536,485908,11328,114928,3.8485933341781777,0.191280149658143
748,0.0789,42,436,42,190972,485472,11370,114886,3.845140032948929,0.19136248704939385
749,0.079,41,402,41,191374,485070,11411,114845,3.841956025852237,0.19143545335589207
750,0.0791,50,432,50,191806,484638,11461,114795,3.8385344062856417,0.19150597314462167
751,0.0792,29,389,29,192195,484249,11490,114766,3.8354533645925737,0.1915911955460214
752,0.0793,44,456,44,192651,483793,11534,114722,3.831841655050057,0.19167773572926325
753,0.0794,35,422,35,193073,483371,11569,114687,3.8284992396400965,0.19176568158941107
754,0.0795,42,391,42,193464,482980,11611,114645,3.8254023571157014,0.19183434427943946
755,0.0796,40,428,40,193892,482552,11651,114605,3.8220124192117604,0.19191770338453706
756,0.0797,34,417,34,194309,482135,11685,114571,3.8187096058801164,0.19200577839002791
757,0.0798,36,380,36,194689,481755,11721,114535,3.8156998479280193,0.192079357359674
758,0.0799,41,418,41,195107,481337,11762,114494,3.812389114180712,0.19215851474663118
759,0.08,41,393,41,195500,480944,11803,114453,3.8092763908249907,0.19222972235332056
760,0.0801,33,444,33,195944,480500,11836,114420,3.8057597262704346,0.19232838028642507
761,0.0802,40,422,40,196366,480078,11876,114380,3.802417310860474,0.19241056559084074
762,0.0803,35,405,35,196771,479673,11911,114345,3.7992095425167913,0.192494166843429
763,0.0804,50,428,50,197199,479245,11961,114295,3.7958196046128503,0.1925649492873269
764,0.0805,32,383,32,197582,478862,11993,114263,3.7927860854137627,0.19264573234984195
765,0.0806,46,433,46,198015,478429,12039,114217,3.789356545431504,0.19272381826587878
766,0.0807,37,424,37,198439,478005,12076,114180,3.785998289190217,0.19281136806910001
767,0.0808,29,407,29,198846,477598,12105,114151,3.782774680015207,0.19290442400409633
768,0.0809,30,387,30,199233,477211,12135,114121,3.779709479153466,0.1929897248922771
769,0.081,42,396,42,199629,476815,12177,114079,3.776572994550754,0.19306169972956233
770,0.0811,42,384,42,200013,476431,12219,114037,3.773531554936003,0.19312985631736182
771,0.0812,27,386,27,200399,476045,12246,114010,3.770474274489925,0.19321927616917067
772,0.0813,36,404,36,200803,475641,12282,113974,3.767274426561906,0.19330240919922323
773,0.0814,35,394,35,201197,475247,12317,113939,3.7641537827905207,0.19338375317811354
774,0.0815,34,388,34,201585,474859,12351,113905,3.761080661513116,0.19346461400493237
775,0.0816,33,433,33,202018,474426,12384,113872,3.757651121530858,0.19356176631571073
776,0.0817,36,432,36,202450,473994,12420,113836,3.754229501964263,0.1936546280387187
777,0.0818,52,434,52,202884,473560,12472,113784,3.7507920415663416,0.19372633414149118
778,0.0819,30,404,30,203288,473156,12502,113754,3.7475921936383223,0.19381847301971342
779,0.082,44,426,44,203714,472730,12546,113710,3.744218096565708,0.19389877907373304
780,0.0821,49,398,49,204112,472332,12595,113661,3.741065771131669,0.19396306781821626
781,0.0822,37,441,37,204553,471891,12632,113624,3.7375728678241034,0.19405822224878952
782,0.0823,41,412,41,204965,471479,12673,113583,3.734309656570777,0.1941383990072847
783,0.0824,33,418,33,205383,471061,12706,113550,3.7309989228234697,0.19423171989579396
784,0.0825,37,450,37,205833,470611,12743,113513,3.7274347357749336,0.1943303134266012
785,0.0826,33,427,33,206260,470184,12776,113480,3.724052718286656,0.19442693056278956
786,0.0827,36,453,36,206713,469731,12812,113444,3.7204647699911293,0.1945282290907532
787,0.0828,35,407,35,207120,469324,12847,113409,3.7172411608161195,0.19461571594538152
788,0.0829,37,402,37,207522,468922,12884,113372,3.7140571537194274,0.1946988978076367
789,0.083,41,375,41,207897,468547,12925,113331,3.711086997845647,0.19476763170286554
790,0.0831,26,441,26,208338,468106,12951,113305,3.707594094538081,0.19487935384779442
791,0.0832,39,415,39,208753,467691,12990,113266,3.7043071220377644,0.19496451544606572
792,0.0833,47,414,47,209167,467277,13037,113219,3.7010280699531113,0.19503838097075604
793,0.0834,33,362,33,209529,466915,13070,113186,3.6981608794829555,0.19511429906171512
794,0.0835,47,386,47,209915,466529,13117,113139,3.6951035990368775,0.19517896451071992
795,0.0836,40,389,40,210304,466140,13157,113099,3.6920225573438095,0.19525446318359088
796,0.0837,42,408,42,210712,465732,13199,113057,3.6887910277531364,0.19533370537449743
797,0.0838,44,385,44,211097,465347,13243,113013,3.685741667722722,0.19540251746317172
798,0.0839,37,416,37,211513,464931,13280,112976,3.682446774806742,0.19549166215325303
799,0.084,35,428,35,211941,464503,13315,112941,3.6790568369028005,0.19558779725826228
800,0.0841,38,435,38,212376,464068,13353,112903,3.6756114560892157,0.19568227865871943
801,0.0842,39,423,39,212799,463645,13392,112864,3.6722611202635913,0.1957714450251427
802,0.0843,37,438,37,213237,463207,13429,112827,3.668791978203016,0.19586864664238568
803,0.0844,34,447,34,213684,462760,13463,112793,3.66525155240147,0.195973263973952
804,0.0845,36,405,36,214089,462355,13499,112757,3.6620437840577873,0.19606094117319756
805,0.0846,35,415,35,214504,461940,13534,112722,3.6587568115574705,0.1961535650521524
806,0.0847,32,428,32,214932,461512,13566,112690,3.6553668736535294,0.19625497647169463
807,0.0848,41,395,41,215327,461117,13607,112649,3.652238309466481,0.19633265128989866
808,0.0849,50,428,50,215755,460689,13657,112599,3.6488483715625395,0.19640913467576507
809,0.085,40,423,40,216178,460266,13697,112559,3.6454980357369156,0.19649805787107755
810,0.0851,36,394,36,216572,459872,13733,112523,3.6423773919655305,0.19658277937438307
811,0.0852,44,419,44,216991,459453,13777,112479,3.63905873780256,0.19666498814544386
812,0.0853,30,416,30,217407,459037,13807,112449,3.6357638448865797,0.19676597501951054
813,0.0854,40,401,40,217808,458636,13847,112409,3.632587758205551,0.19684788414223048
814,0.0855,41,392,41,218200,458244,13888,112368,3.6294829552654924,0.19692540640575382
815,0.0856,39,370,39,218570,457874,13927,112329,3.626552401470029,0.1969982620224727
816,0.0857,40,428,40,218998,457446,13967,112289,3.623162463566088,0.19708987511737913
817,0.0858,39,420,39,219418,457026,14006,112250,3.619835888987454,0.19718027810763145
818,0.0859,49,371,49,219789,456655,14055,112201,3.6168974147763273,0.19723972323399946
819,0.086,40,416,40,220205,456239,14095,112161,3.613602521860347,0.19732758620689655
820,0.0861,46,419,46,220624,455820,14141,112115,3.610283867697377,0.19740815410214196
821,0.0862,42,438,42,221062,455382,14183,112073,3.6068147256368013,0.19750112343710075
822,0.0863,45,429,45,221491,454953,14228,112028,3.603416867317197,0.19758686799028538
823,0.0864,32,358,32,221849,454595,14260,111996,3.6005813585096944,0.1976663942773535
824,0.0865,40,397,40,222246,454198,14300,111956,3.5974369534913193,0.197748315829262
825,0.0866,38,393,38,222639,453805,14338,111918,3.5943242301355975,0.1978318010757915
826,0.0867,35,420,35,223059,453385,14373,111883,3.5909976555569636,0.19792912388459988
827,0.0868,45,399,45,223458,452986,14418,111838,3.5878374097072614,0.1980050422786567
828,0.0869,40,405,40,223863,452581,14458,111798,3.5846296413635788,0.19809029038996845
829,0.087,42,416,42,224279,452165,14500,111756,3.5813347484475986,0.19817669496259227
830,0.0871,42,390,42,224669,451775,14542,111714,3.5782457863388673,0.1982540919166124
831,0.0872,46,408,46,225077,451367,14588,111668,3.575014256748194,0.1983322528794835
832,0.0873,27,424,27,225501,450943,14615,111641,3.5716560005069065,0.1984432546961876
833,0.0874,41,447,41,225948,450496,14656,111600,3.5681155747053603,0.19854259770573
834,0.0875,42,411,42,226359,450085,14698,111558,3.5648602838676973,0.19862795405622433
835,0.0876,39,397,39,226756,449688,14737,111519,3.561715878849322,0.198712774430825
836,0.0877,26,392,26,227148,449296,14763,111493,3.5586110759092637,0.1988145273890893
837,0.0878,34,376,34,227524,448920,14797,111459,3.55563299961982,0.19889931635553795
838,0.0879,44,405,44,227929,448515,14841,111415,3.5524252312761373,0.1989802296715661
839,0.088,42,410,42,228339,448105,14883,111373,3.5491778608541376,0.1990659150136377
840,0.0881,48,414,48,228753,447691,14931,111325,3.545898808769484,0.19914456831289265
841,0.0882,51,383,51,229136,447308,14982,111274,3.5428652895703965,0.1992079945290038
842,0.0883,29,403,29,229539,446905,15011,111245,3.539673362058041,0.19931022126668457
843,0.0884,36,392,36,229931,446513,15047,111209,3.5365685591179825,0.1993986251214763
844,0.0885,41,367,41,230298,446146,15088,111168,3.5336617665695096,0.19947103428228968
845,0.0886,44,376,44,230674,445770,15132,111124,3.530683690280066,0.19954246229982725
846,0.0887,48,447,48,231121,445323,15180,111076,3.5271432644785197,0.19963371609222877
847,0.0888,35,372,35,231493,444951,15215,111041,3.5241968698517296,0.1997169024014734
848,0.0889,46,419,46,231912,444532,15261,110995,3.5208782156887595,0.19980126978526697
849,0.089,34,402,34,232314,444130,15295,110961,3.517694208592067,0.199896953832795
850,0.0891,37,396,37,232710,443734,15332,110924,3.514557723989355,0.19998629786282718
851,0.0892,31,383,31,233093,443351,15363,110893,3.5115242047902675,0.20007974826971514
852,0.0893,52,374,52,233467,442977,15415,110841,3.5085619693321504,0.20013975710431947
853,0.0894,43,401,43,233868,442576,15458,110798,3.5053858826511215,0.20022263424013415
854,0.0895,44,403,44,234271,442173,15502,110754,3.5021939551387655,0.20030492271131634
855,0.0896,36,373,36,234644,441800,15538,110718,3.499239640096312,0.2003880416565614
856,0.0897,41,422,41,235066,441378,15579,110677,3.4958972246863516,0.2004818360489444
857,0.0898,47,393,47,235459,440985,15626,110630,3.49278450133063,0.20055654759207056
858,0.0899,48,381,48,235840,440604,15674,110582,3.489766822962869,0.2006255601557369
859,0.09,52,388,52,236228,440216,15726,110530,3.4866937016854647,0.20069142581153562
860,0.0901,42,381,42,236609,439835,15768,110488,3.4836760233177038,0.20076936635394124
861,0.0902,31,452,31,237061,439383,15799,110457,3.4800959954378405,0.20088934962898297
862,0.0903,47,438,47,237499,438945,15846,110410,3.4766268533772653,0.20098115062209318
863,0.0904,45,443,45,237942,438502,15891,110365,3.473118109238373,0.20107785674853834
864,0.0905,39,434,39,238376,438068,15930,110326,3.469680648840451,0.20118017337899394
865,0.0906,27,411,27,238787,437657,15957,110299,3.466425358002788,0.2012917095533218
866,0.0907,43,369,43,239156,437288,16000,110256,3.4635027246229884,0.20136463918881406
867,0.0908,42,391,42,239547,436897,16042,110214,3.4604058420985933,0.20144723831178682
868,0.0909,48,384,48,239931,436513,16090,110166,3.4573644024838424,0.20151862427494013
869,0.091,48,408,48,240339,436105,16138,110118,3.4541328728931693,0.2015989806361138
870,0.0911,50,386,50,240725,435719,16188,110068,3.4510755924470917,0.2016684164335171
871,0.0912,42,418,42,241143,435301,16230,110026,3.4477648586997844,0.20176151190019934
872,0.0913,36,423,36,241566,434878,16266,109990,3.4444145228741605,0.20186540593318014
873,0.0914,35,424,35,241990,434454,16301,109955,3.441056266632873,0.2019713120099043
874,0.0915,54,399,54,242389,434055,16355,109901,3.4378960207831706,0.20204023854870615
875,0.0916,35,378,35,242767,433677,16390,109866,3.4349021036624,0.20212936235035683
876,0.0917,42,407,42,243174,433270,16432,109824,3.431678494487391,0.20221913701863767
877,0.0918,41,390,41,243564,432880,16473,109783,3.428589532378659,0.20230419247304496
878,0.0919,52,377,52,243941,432503,16525,109731,3.4256035356735524,0.20236835019567198
879,0.092,42,404,42,244345,432099,16567,109689,3.422403687745533,0.20245741876896498
880,0.0921,41,419,41,244764,431680,16608,109648,3.4190850335825624,0.2025537197410812
881,0.0922,48,389,48,245153,431291,16656,109600,3.4160039918894944,0.20262862573050763
882,0.0923,41,416,41,245569,430875,16697,109559,3.4127090989735143,0.20272410692147422
883,0.0924,42,396,42,245965,430479,16739,109517,3.409572614370802,0.20281076156119676
884,0.0925,49,436,49,246401,430043,16788,109468,3.4061193131415535,0.20290225778529075
885,0.0926,57,405,57,246806,429638,16845,109411,3.402911544797871,0.20297041641854452
886,0.0927,46,404,46,247210,429234,16891,109365,3.3997116968698515,0.20305459163496403
887,0.0928,34,438,34,247648,428796,16925,109331,3.3962425548092763,0.20316951202968817
888,0.0929,60,400,60,248048,428396,16985,109271,3.3930743885439107,0.20323174009191564
889,0.093,34,432,34,248480,427964,17019,109237,3.389652768977316,0.20334474433219596
890,0.0931,51,368,51,248848,427596,17070,109186,3.3867380560131797,0.20340846004523253
891,0.0932,48,371,48,249219,427225,17118,109138,3.383799581802053,0.20347786853306435
892,0.0933,44,470,44,249689,426755,17162,109094,3.3800769864402485,0.20359093699904265
893,0.0934,45,399,45,250088,426356,17207,109049,3.3769167405905463,0.20367572211690216
894,0.0935,42,414,42,250502,425942,17249,109007,3.3736376885058927,0.20377082675170904
895,0.0936,35,373,35,250875,425569,17284,108972,3.3706833734634394,0.20386088251415702
896,0.0937,40,407,40,251282,425162,17324,108932,3.3674597642884296,0.20395660688942396
897,0.0938,59,375,59,251657,424787,17383,108873,3.3644896084146496,0.2040119177004085
898,0.0939,32,377,32,252034,424410,17415,108841,3.3615036117095425,0.2041083842318158
899,0.094,45,412,45,252446,423998,17460,108796,3.358240400456216,0.2041989962349426
900,0.0941,38,398,38,252844,423600,17498,108758,3.355088075022177,0.20429485421464502
901,0.0942,34,383,34,253227,423217,17532,108724,3.3520545558230896,0.20439108848537713
902,0.0943,47,424,47,253651,422793,17579,108677,3.348696299581802,0.20448379024215854
903,0.0944,44,393,44,254044,422400,17623,108633,3.34558357622608,0.20456920756337177
904,0.0945,40,391,40,254435,422009,17663,108593,3.3424866937016855,0.20465998997365256
905,0.0946,44,405,44,254840,421604,17707,108549,3.339278925358003,0.20475032679245425
906,0.0947,51,393,51,255233,421211,17758,108498,3.336166202002281,0.2048256684330453
907,0.0948,39,387,39,255620,420824,17797,108459,3.3331010011405398,0.20491684032927565
908,0.0949,47,419,47,256039,420405,17844,108412,3.3297823469775696,0.20500853792521798
909,0.095,29,374,29,256413,420031,17873,108383,3.3268201115194524,0.20511000844035168
910,0.0951,57,412,57,256825,419619,17930,108326,3.323556900266126,0.20518425214747749
911,0.0952,45,380,45,257205,419239,17975,108281,3.3205471423140285,0.20526425538368215
912,0.0953,44,390,44,257595,418849,18019,108237,3.317458180205297,0.2053497911156813
913,0.0954,46,361,46,257956,418488,18065,108191,3.3145989101508047,0.2054211388720644
914,0.0955,26,407,26,258363,418081,18091,108165,3.3113753009757954,0.20554075470407376
915,0.0956,32,398,32,258761,417683,18123,108133,3.3082229755417565,0.2056479833249654
916,0.0957,42,399,42,259160,417284,18165,108091,3.3050627296920543,0.20574066143231026
917,0.0958,45,374,45,259534,416910,18210,108046,3.3021004942339376,0.20581915436722314
918,0.0959,34,413,34,259947,416497,18244,108012,3.2988293625649474,0.20592973619137137
919,0.096,43,373,43,260320,416124,18287,107969,3.295875047522494,0.20601114687660396
920,0.0961,36,392,36,260712,415732,18323,107933,3.2927702445824356,0.20611077692799787
921,0.0962,35,390,35,261102,415342,18358,107898,3.2896812824737043,0.20621129883036465
922,0.0963,36,380,36,261482,414962,18394,107862,3.2866715245216067,0.20630651997612964
923,0.0964,41,409,41,261891,414553,18435,107821,3.2834320745152707,0.20640575526347024
924,0.0965,52,375,52,262266,414178,18487,107769,3.2804619186414903,0.2064749869239597
925,0.0966,36,405,36,262671,413773,18523,107733,3.2772541502978076,0.20658055707892142
926,0.0967,44,373,44,263044,413400,18567,107689,3.2742998352553543,0.20666143403526077
927,0.0968,45,395,45,263439,413005,18612,107644,3.271171271068306,0.20674965283713212
928,0.0969,41,429,41,263868,412576,18653,107603,3.267773412748701,0.20685763938951784
929,0.097,44,375,44,264243,412201,18697,107559,3.264803256874921,0.2069397414191165
930,0.0971,38,423,38,264666,411778,18735,107521,3.2614529210492966,0.20705027354183236
931,0.0972,53,414,53,265080,411364,18788,107468,3.258173868964643,0.20713448669318776
932,0.0973,46,362,46,265442,411002,18834,107422,3.2553066784944873,0.20720877119886424
933,0.0974,53,401,53,265843,410601,18887,107369,3.2521305918134584,0.20728806687646004
934,0.0975,42,390,42,266233,410211,18929,107327,3.249041629704727,0.20737994118306288
935,0.0976,39,391,39,266624,409820,18968,107288,3.245944747180332,0.20747696806083063
936,0.0977,47,408,47,267032,409412,19015,107241,3.242713217589659,0.2075687163337869
937,0.0978,48,378,48,267410,409034,19063,107193,3.2397193004688885,0.20764702349935202
938,0.0979,39,403,39,267813,408631,19102,107154,3.236527372956533,0.2077493529280611
939,0.098,45,349,45,268162,408282,19147,107109,3.2337631478900013,0.20782085833862057
940,0.0981,48,395,48,268557,407887,19195,107061,3.230634583702953,0.2079064293870449
941,0.0982,52,409,52,268966,407478,19247,107009,3.2273951336966165,0.2079916499347894
942,0.0983,44,397,44,269363,407081,19291,106965,3.224250728678241,0.2080844904930687
943,0.0984,44,381,44,269744,406700,19335,106921,3.2212330503104805,0.20817100546901315
944,0.0985,38,373,38,270117,406327,19373,106883,3.2182787352680267,0.20826367373979462
945,0.0986,47,379,47,270496,405948,19420,106836,3.215276897731593,0.20834503416643266
946,0.0987,45,354,45,270850,405594,19465,106791,3.2124730705867446,0.2084194502180977
947,0.0988,32,384,32,271234,405210,19497,106759,3.2094316309719932,0.2085262974906684
948,0.0989,37,369,37,271603,404841,19534,106722,3.2065089975921937,0.20861946622410144
949,0.099,46,397,46,272000,404444,19580,106676,3.203364592573818,0.20871028329942087
950,0.0991,41,403,41,272403,404041,19621,106635,3.2001726650614626,0.20881145775403584
951,0.0992,55,422,55,272825,403619,19676,106580,3.1968302496515015,0.2088988806328511
952,0.0993,51,379,51,273204,403240,19727,106529,3.1938284121150677,0.2089750455598516
953,0.0994,39,387,39,273591,402853,19766,106490,3.1907632112533264,0.20907325711750235
954,0.0995,28,367,28,273958,402486,19794,106462,3.1878564187048535,0.20918050567052038
955,0.0996,46,423,46,274381,402063,19840,106416,3.1845060828792295,0.20928297923808062
956,0.0997,48,386,48,274767,401677,19888,106368,3.1814488024331515,0.2093672804574398
957,0.0998,42,337,42,275104,401340,19930,106326,3.1787796223545812,0.20944085284419284
958,0.0999,35,369,35,275473,400971,19965,106291,3.175856988974781,0.20953866049497105
959,0.1,43,361,43,275834,400610,20008,106248,3.172997718920289,0.20962084055100244
960,0.1001,46,369,46,276203,400241,20054,106202,3.170075085540489,0.20970178282649776
961,0.1002,34,427,34,276630,399814,20088,106168,3.1666930680522114,0.20982564597159584
962,0.1003,34,418,34,277048,399396,20122,106134,3.163382334304904,0.20994599727019167
963,0.1004,40,362,40,277410,399034,20162,106094,3.1605151438347483,0.21003389239955023
964,0.1005,49,373,49,277783,398661,20211,106045,3.157560828792295,0.21011242188521634
965,0.1006,59,378,59,278161,398283,20270,105986,3.1545669116715245,0.21017750446686193
966,0.1007,41,402,41,278563,397881,20311,105945,3.1513829045748323,0.2102809303211823
967,0.1008,28,404,28,278967,397477,20339,105917,3.148183056646813,0.2104057656626817
968,0.1009,49,387,49,279354,397090,20388,105868,3.1451178557850716,0.2104907368010848
969,0.101,36,379,36,279733,396711,20424,105832,3.142116018248638,0.2105929243865699
970,0.1011,43,406,43,280139,396305,20467,105789,3.1389003294892914,0.21069560679872693
971,0.1012,46,379,46,280518,395926,20513,105743,3.1358984919528576,0.21078240832102443
972,0.1013,41,395,41,280913,395531,20554,105702,3.132769927765809,0.2108839601542596
973,0.1014,41,403,41,281316,395128,20595,105661,3.1295780002534532,0.21098905926448064
974,0.1015,39,385,39,281701,394743,20634,105622,3.126528640223039,0.21108990436981004
975,0.1016,48,380,48,282081,394363,20682,105574,3.1235188822709414,0.21117460800060808
976,0.1017,43,382,43,282463,393981,20725,105531,3.1204932834875176,0.21126819776101474
977,0.1018,47,338,47,282801,393643,20772,105484,3.1178161829932836,0.2113369943922088
978,0.1019,45,355,45,283156,393288,20817,105439,3.1150044354327715,0.2114162658127593
979,0.102,52,362,52,283518,392926,20869,105387,3.1121372449626157,0.21148755902414748
980,0.1021,41,367,41,283885,392559,20910,105346,3.1092304524141428,0.21157851397354918
981,0.1022,43,384,43,284269,392175,20953,105303,3.106189012799392,0.21167368205227166
982,0.1023,47,396,47,284665,391779,21000,105256,3.1030525281966796,0.21176778295291077
983,0.1024,49,358,49,285023,391421,21049,105207,3.1002170193891776,0.21184266694588302
984,0.1025,42,388,42,285411,391033,21091,105165,3.097143898111773,0.21194160395648512
985,0.1026,41,352,41,285763,390681,21132,105124,3.0943559117982513,0.21202690573915148
986,0.1027,41,365,41,286128,390316,21173,105083,3.091464960081105,0.21211790899860516
987,0.1028,46,368,46,286496,389948,21219,105037,3.088550247116969,0.21220238997141327
988,0.1029,49,378,49,286874,389570,21268,104988,3.0855563299961983,0.2122865265550249
989,0.103,35,343,35,287217,389227,21303,104953,3.082839627423647,0.21237808086122464
990,0.1031,45,374,45,287591,388853,21348,104908,3.0798773919655305,0.2124671652884695
991,0.1032,50,330,50,287921,388523,21398,104858,3.077263654796604,0.21252946505844367
992,0.1033,45,364,45,288285,388159,21443,104813,3.074380623495121,0.21261450954618114
993,0.1034,38,361,38,288646,387798,21481,104775,3.0715213534406285,0.21270958822347144
994,0.1035,36,345,36,288991,387453,21517,104739,3.0687888100367506,0.21280110200897212
995,0.1036,50,396,50,289387,387057,21567,104689,3.065652325434039,0.21289242820480492
996,0.1037,50,366,50,289753,386691,21617,104639,3.0627534533012293,0.21297091567785398
997,0.1038,36,402,36,290155,386289,21653,104603,3.0595694462045366,0.21308760379065048
998,0.1039,41,419,41,290574,385870,21694,104562,3.0562507920415665,0.2132038692418113
999,0.104,51,416,51,290990,385454,21745,104511,3.0529558991255863,0.21330299102997152
1000,0.1041,41,421,41,291411,385033,21786,104470,3.049621404131289,0.21342055104871677
1001,0.1042,46,392,46,291803,384641,21832,104424,3.0465166011912306,0.21351763058080214
1002,0.1043,47,388,47,292191,384253,21879,104377,3.043443479913826,0.21361152610359577
1003,0.1044,38,397,38,292588,383856,21917,104339,3.0402990748954504,0.21372402421163675
1004,0.1045,45,367,45,292955,383489,21962,104294,3.0373922823469774,0.21381228948118322
1005,0.1046,53,375,53,293330,383114,22015,104241,3.0344221264731974,0.2138913112618112
1006,0.1047,48,345,48,293675,382769,22063,104193,3.0316895830693196,0.21396536074683445
1007,0.1048,55,355,55,294030,382414,22118,104138,3.0288778355088075,0.21403262138476464
1008,0.1049,50,361,50,294391,382053,22168,104088,3.026018565454315,0.21411072096367104
1009,0.105,53,394,53,294785,381659,22221,104035,3.02289792168293,0.21419865182604686
1010,0.1051,31,377,31,295162,381282,22252,104004,3.019911924977823,0.21431485763034583
1011,0.1052,45,393,45,295555,380889,22297,103959,3.016799201622101,0.21441565191565193
1012,0.1053,46,386,46,295941,380503,22343,103913,3.0137419211760235,0.21451190712115206
1013,0.1054,45,367,45,296308,380136,22388,103868,3.0108351286275505,0.21460153221874198
1014,0.1055,48,364,48,296672,379772,22436,103820,3.0079520973260676,0.2146851064533739
1015,0.1056,45,401,45,297073,379371,22481,103775,3.0047760106450387,0.21479014624978784
1016,0.1057,41,372,41,297445,378999,22522,103734,3.0018296160182487,0.21488897589350636
1017,0.1058,43,384,43,297829,378615,22565,103691,2.998788176403498,0.21499006854569505
1018,0.1059,43,356,43,298185,378259,22608,103648,2.9959685084273224,0.2150788430132785
1019,0.106,39,399,39,298584,377860,22647,103609,2.9928082625776202,0.21519350155461722
1020,0.1061,38,381,38,298965,377479,22685,103571,2.9897905842098593,0.2153019436648997
1021,0.1062,56,388,56,299353,377091,22741,103515,2.9867174629324547,0.2153843272868004
1022,0.1063,36,388,36,299741,376703,22777,103479,2.98364434165505,0.2154995397578418
1023,0.1064,44,337,44,300078,376366,22821,103435,2.9809751615764797,0.2155789587766595
1024,0.1065,38,352,38,300430,376014,22859,103397,2.9781871752629576,0.21567506794796115
1025,0.1066,36,417,36,300847,375597,22895,103361,2.974884361931314,0.21580389094659658
1026,0.1067,48,399,48,301246,375198,22943,103313,2.971724116081612,0.2159051725038714
1027,0.1068,50,359,50,301605,374839,22993,103263,2.9688806868584465,0.2159852918414899
1028,0.1069,49,398,49,302003,374441,23042,103214,2.9657283614244077,0.21608483110194596
1029,0.107,32,364,32,302367,374077,23074,103182,2.9628453301229247,0.2161970753825491
1030,0.1071,55,375,55,302742,373702,23129,103127,2.9598751742491447,0.21627669458023735
1031,0.1072,44,383,44,303125,373319,23173,103083,2.956841655050057,0.21637818481030727
1032,0.1073,42,339,42,303464,372980,23215,103041,2.9541566341401597,0.2164631392312524
1033,0.1074,47,395,47,303859,372585,23262,102994,2.9510280699531113,0.21656549174795356
1034,0.1075,45,373,45,304232,372212,23307,102949,2.948073754910658,0.21666130006460968
1035,0.1076,53,376,53,304608,371836,23360,102896,2.945095678621214,0.2167454479580058
1036,0.1077,50,405,50,305013,371431,23410,102846,2.9418879102775315,0.21684796015830413
1037,0.1078,65,390,65,305403,371041,23475,102781,2.9387989481687997,0.2169190117807953
1038,0.1079,46,364,46,305767,370677,23521,102735,2.9359159168673172,0.21700970824567184
1039,0.108,53,395,53,306162,370282,23574,102682,2.932787352680269,0.21710320447222198
1040,0.1081,43,329,43,306491,369953,23617,102639,2.9301815359270056,0.21718310932051327
1041,0.1082,37,374,37,306865,369579,23654,102602,2.9272193004688885,0.21729379199925453
1042,0.1083,36,368,36,307233,369211,23690,102566,2.924304587504752,0.2174035614283867
1043,0.1084,39,402,39,307635,368809,23729,102527,2.92112058040806,0.2175242290001188
1044,0.1085,40,364,40,307999,368445,23769,102487,2.918237549106577,0.21762589928057555
1045,0.1086,49,319,49,308318,368126,23818,102438,2.915710936509948,0.2176919611359985
1046,0.1087,48,359,48,308677,367767,23866,102390,2.9128675072867822,0.21777831660487879
1047,0.1088,53,366,53,309043,367401,23919,102337,2.909968635153973,0.21785974309082937
1048,0.1089,57,357,57,309400,367044,23976,102280,2.907141046762134,0.21793047020821438
1049,0.109,57,396,57,309796,366648,24033,102223,2.904004562159422,0.21801945524461952
1050,0.1091,46,391,46,310187,366257,24079,102177,2.900907679635027,0.21812464509407942
1051,0.1092,40,365,40,310552,365892,24119,102137,2.8980167279178812,0.21822793032055707
1052,0.1093,53,355,53,310907,365537,24172,102084,2.895204980357369,0.21830499485694613
1053,0.1094,51,336,51,311243,365201,24223,102033,2.892543720694462,0.21837665923284694
1054,0.1095,48,368,48,311611,364833,24271,101985,2.8896290077303255,0.218468439520327
1055,0.1096,36,342,36,311953,364491,24307,101949,2.886920225573438,0.2185683046050939
1056,0.1097,55,372,55,312325,364119,24362,101894,2.883973830946648,0.2186505526669857
1057,0.1098,38,367,38,312692,363752,24400,101856,2.881067038398175,0.21875912785003693
1058,0.1099,35,350,35,313042,363402,24435,101821,2.87829489291598,0.21886493144148075
1059,0.11,58,363,58,313405,363039,24493,101763,2.875419782030161,0.2189383866678715
1060,0.1101,51,380,51,313785,362659,24544,101712,2.8724100240780635,0.21903176554952827
1061,0.1102,59,334,59,314119,362325,24603,101653,2.869764605246483,0.2190901292733707
1062,0.1103,36,364,36,314483,361961,24639,101617,2.8668815739450006,0.21920151517112546
1063,0.1104,48,329,48,314812,361632,24687,101569,2.8642757571917374,0.21927629689918632
1064,0.1105,49,367,49,315179,361265,24736,101520,2.8613689646432645,0.21936752487656255
1065,0.1106,38,412,38,315591,360853,24774,101482,2.858105753389938,0.21949884823774968
1066,0.1107,48,385,48,315976,360468,24822,101434,2.8550563933595234,0.21960069451961672
1067,0.1108,43,373,43,316349,360095,24865,101391,2.85210207831707,0.2197054731887858
1068,0.1109,45,324,45,316673,359771,24910,101346,2.849535863642124,0.2197836991479386
1069,0.111,44,356,44,317029,359415,24954,101302,2.8467161956659486,0.2198790146662702
1070,0.1111,42,365,42,317394,359050,24996,101260,2.8438252439488023,0.21998218591818558
1071,0.1112,45,370,45,317764,358680,25041,101215,2.8408946901533394,0.22008284499722763
1072,0.1113,43,348,43,318112,358332,25084,101172,2.838138385502471,0.22017653818029875
1073,0.1114,58,347,58,318459,357985,25142,101114,2.8353900012672666,0.22024443529609083
1074,0.1115,44,357,44,318816,357628,25186,101070,2.832562412875428,0.22034105228276557
1075,0.1116,41,326,41,319142,357302,25227,101029,2.8299803573691547,0.22042803126997737
1076,0.1117,50,357,50,319499,356945,25277,100979,2.827152768977316,0.2205147579074257
1077,0.1118,50,370,50,319869,356575,25327,100929,2.8242222151818526,0.22060790725326992
1078,0.1119,47,353,47,320222,356222,25374,100882,2.8214263084526676,0.22069813434141902
1079,0.112,45,353,45,320575,355869,25419,100837,2.8186304017234827,0.22079193178981665
1080,0.1121,41,346,41,320921,355523,25460,100796,2.815889937903941,0.220889333996612
1081,0.1122,44,373,44,321294,355150,25504,100752,2.8129356228614877,0.22099486293106851
1082,0.1123,44,361,44,321655,354789,25548,100708,2.810076352806995,0.22109476022893673
1083,0.1124,40,336,40,321991,354453,25588,100668,2.807415093144088,0.22118952981734527
1084,0.1125,48,353,48,322344,354100,25636,100620,2.8046191864149033,0.22127902885292047
1085,0.1126,49,363,49,322707,353737,25685,100571,2.8017440755290837,0.22137184465164603
1086,0.1127,57,330,57,323037,353407,25742,100514,2.799130338360157,0.22143500741318423
1087,0.1128,41,353,41,323390,353054,25783,100473,2.796334431630972,0.22153697574786066
1088,0.1129,41,324,41,323714,352730,25824,100432,2.793768216956026,0.22162493766026278
1089,0.113,55,353,55,324067,352377,25879,100377,2.7909723102268407,0.22170317655945612
1090,0.1131,43,367,43,324434,352010,25922,100334,2.7880655176783677,0.22180906566683764
1091,0.1132,41,323,41,324757,351687,25963,100293,2.785507223419085,0.2218969865923271
1092,0.1133,43,322,43,325079,351365,26006,100250,2.7829568495754655,0.22198111223055036
1093,0.1134,39,396,39,325475,350969,26045,100211,2.7798203649727538,0.22210869276120396
1094,0.1135,39,353,39,325828,350616,26084,100172,2.777024458243569,0.22221532072725983
1095,0.1136,36,313,36,326141,350303,26120,100136,2.7745453681409202,0.2223075710584563
1096,0.1137,64,343,64,326484,349960,26184,100072,2.771828665568369,0.2223664094997689
1097,0.1138,49,295,49,326779,349665,26233,100023,2.7694921429476618,0.22242754976783904
1098,0.1139,36,341,36,327120,349324,26269,99987,2.7667912812064377,0.22253405770168103
1099,0.114,53,372,53,327492,348952,26322,99934,2.7638448865796477,0.2226266802707146
1100,0.1141,56,367,56,327859,348585,26378,99878,2.7609380940311747,0.22271179562193535
1101,0.1142,55,301,55,328160,348284,26433,99823,2.758554048916487,0.22276599115836174
1102,0.1143,46,351,46,328511,347933,26479,99777,2.7557739830186287,0.22286078041589422
1103,0.1144,47,328,47,328839,347605,26526,99730,2.753176086681029,0.22294253747191703
1104,0.1145,45,340,45,329179,347265,26571,99685,2.750483145355468,0.2230338964089943
1105,0.1146,51,381,51,329560,346884,26622,99634,2.7474654669877077,0.22313546150435146
1106,0.1147,52,318,52,329878,346566,26674,99582,2.744946774806742,0.22320395922429329
1107,0.1148,43,333,43,330211,346233,26717,99539,2.742309276390825,0.2232957655483072
1108,0.1149,50,337,50,330548,345896,26767,99489,2.7396400963122542,0.2233775273078348
1109,0.115,58,339,58,330887,345557,26825,99431,2.7369550754023573,0.22344647496112255
1110,0.1151,45,346,45,331233,345211,26870,99386,2.7342146115828156,0.223541769287692
1111,0.1152,53,329,53,331562,344882,26923,99333,2.7316087948295524,0.22361469108427226
1112,0.1153,45,348,45,331910,344534,26968,99288,2.7288524901786846,0.2237113076864148
1113,0.1154,49,362,49,332272,344172,27017,99239,2.7259852997085288,0.22380815992386296
1114,0.1155,55,370,55,332642,343802,27072,99184,2.7230547459130654,0.22389872366169586
1115,0.1156,49,347,49,332989,343455,27121,99135,2.720306361677861,0.22398834135430082
1116,0.1157,43,370,43,333359,343085,27164,99092,2.7173758078823975,0.2241003037245266
1117,0.1158,43,343,43,333702,342742,27207,99049,2.7146591053098468,0.22419877272284858
1118,0.1159,51,366,51,334068,342376,27258,98998,2.711760233177037,0.22429504229972766
1119,0.116,47,348,47,334416,342028,27305,98951,2.709003928526169,0.2243893700153522
1120,0.1161,41,373,41,334789,341655,27346,98910,2.7060496134837155,0.22450716693336964
1121,0.1162,51,322,51,335111,341333,27397,98859,2.7034992396400965,0.22458154623437046
1122,0.1163,38,358,38,335469,340975,27435,98821,2.700663730832594,0.22469735968494484
1123,0.1164,48,383,48,335852,340592,27483,98773,2.6976302116335065,0.2248085304928704
1124,0.1165,38,359,38,336211,340233,27521,98735,2.694786782410341,0.224925279291429
1125,0.1166,47,340,47,336551,339893,27568,98688,2.6920938410847803,0.22501658758587353
1126,0.1167,53,376,53,336927,339517,27621,98635,2.6891157647953365,0.2251159414997535
1127,0.1168,46,346,46,337273,339171,27667,98589,2.6863753009757954,0.2252124451754386
1128,0.1169,46,368,46,337641,338803,27713,98543,2.6834605880116587,0.2253204556575343
1129,0.117,49,356,49,337997,338447,27762,98494,2.6806409200354833,0.22541716158474484
1130,0.1171,59,380,59,338377,338067,27821,98435,2.677631162083386,0.225508703282001
1131,0.1172,48,320,48,338697,337747,27869,98387,2.675096629071094,0.22558892450485402
1132,0.1173,54,376,54,339073,337371,27923,98333,2.67211855278165,0.22568762278978388
1133,0.1174,46,373,46,339446,336998,27969,98287,2.6691642377391966,0.22579918903706767
1134,0.1175,46,367,46,339813,336631,28015,98241,2.6662574451907237,0.22590785334535218
1135,0.1176,63,387,63,340200,336244,28078,98178,2.6631922443289824,0.2259968417805728
1136,0.1177,43,347,43,340547,335897,28121,98135,2.660443860093778,0.2261008404910237
1137,0.1178,46,339,46,340886,335558,28167,98089,2.6577588391838805,0.22619550002651925
1138,0.1179,53,329,53,341215,335229,28220,98036,2.6551530224306172,0.22627260452609835
1139,0.118,49,372,49,341587,334857,28269,97987,2.652206627803827,0.22637948082912088
1140,0.1181,60,377,60,341964,334480,28329,97927,2.64922063109872,0.22646950673786503
1141,0.1182,43,331,43,342295,334149,28372,97884,2.64659897351413,0.22656602620633146
1142,0.1183,52,348,52,342643,333801,28424,97832,2.643842668863262,0.22665551521778918
1143,0.1184,51,372,51,343015,333429,28475,97781,2.640896274236472,0.22675958349759978
1144,0.1185,46,342,46,343357,333087,28521,97735,2.6381874920795845,0.22685703144221975
1145,0.1186,52,361,52,343718,332726,28573,97683,2.635328222025092,0.2269538973395073
1146,0.1187,46,354,46,344072,332372,28619,97637,2.6325243948802433,0.2270580383201282
1147,0.1188,58,329,58,344401,332043,28677,97579,2.62991857812698,0.2271275679550861
1148,0.1189,49,301,49,344702,331742,28726,97530,2.6275345330122923,0.22719860601203898
1149,0.119,55,368,55,345070,331374,28781,97475,2.624619820048156,0.2272944556242407
1150,0.1191,29,329,29,345399,331045,28810,97446,2.622014003294893,0.22741667853000413
1151,0.1192,58,344,58,345743,330701,28868,97388,2.6192893803066783,0.22749474992349722
1152,0.1193,54,346,54,346089,330355,28922,97334,2.616548916487137,0.2275812564737461
1153,0.1194,60,348,60,346437,330007,28982,97274,2.6137926118362693,0.2276581453422923
1154,0.1195,56,321,56,346758,329686,29038,97218,2.611250158408313,0.22772801379232802
1155,0.1196,49,367,49,347125,329319,29087,97169,2.6083433658598403,0.22783524976083736
1156,0.1197,46,325,46,347450,328994,29133,97123,2.605769230769231,0.22792566360882105
1157,0.1198,48,325,48,347775,328669,29181,97075,2.6031950956786214,0.22801260851591568
1158,0.1199,59,379,59,348154,328290,29240,97016,2.600193258142187,0.2281087029103751
1159,0.12,57,377,57,348531,327913,29297,96959,2.59720726143708,0.22820755427516992
1160,0.1201,49,380,49,348911,327533,29346,96910,2.594197503484983,0.22832276654344635
1161,0.1202,46,354,46,349265,327179,29392,96864,2.591393676340134,0.2284296639727575
1162,0.1203,43,358,43,349623,326821,29435,96821,2.588558167532632,0.22854438417342945
1163,0.1204,50,328,50,349951,326493,29485,96771,2.5859602711950322,0.2286303583579043
1164,0.1205,48,371,48,350322,326122,29533,96723,2.5830217969839055,0.22874339296905485
1165,0.1206,34,325,34,350647,325797,29567,96689,2.580447661893296,0.22885728757876
1166,0.1207,45,339,45,350986,325458,29612,96644,2.5777626409833987,0.2289588772382031
1167,0.1208,40,309,40,351295,325149,29652,96604,2.575315232543404,0.22905349813753548
1168,0.1209,53,375,53,351670,324774,29705,96551,2.5723450766696234,0.2291603868747404
1169,0.121,45,335,45,352005,324439,29750,96506,2.5696917374223798,0.2292603546781646
1170,0.1211,56,327,56,352332,324112,29806,96450,2.5671017615004437,0.22933598375507058
1171,0.1212,43,333,43,352665,323779,29849,96407,2.5644642630845267,0.229438867549133
1172,0.1213,49,334,49,352999,323445,29898,96358,2.5618188442529464,0.22953147071364427
1173,0.1214,61,318,61,353317,323127,29959,96297,2.5593001520719807,0.22959344243533988
1174,0.1215,41,327,41,353644,322800,30000,96256,2.556710176150044,0.22969722423733344
1175,0.1216,50,354,50,353998,322446,30050,96206,2.553906349005196,0.22979945157314427
1176,0.1217,38,325,38,354323,322121,30088,96168,2.5513322139145864,0.2299080300940259
1177,0.1218,58,349,58,354672,321772,30146,96110,2.548567988848055,0.22999315596268805
1178,0.1219,49,333,49,355005,321439,30195,96061,2.545930490432138,0.23008622754491018
1179,0.122,46,337,46,355342,321102,30241,96015,2.5432613103535675,0.23018721365947684
1180,0.1221,36,340,36,355682,320762,30277,95979,2.5405683690280068,0.2303085129612877
1181,0.1222,38,323,38,356005,320439,30315,95941,2.538010074768724,0.23041692684566983
1182,0.1223,57,320,57,356325,320119,30372,95884,2.535475541756431,0.2304887224370978
1183,0.1224,49,352,49,356677,319767,30421,95835,2.5326875554429096,0.23059321177472678
1184,0.1225,40,325,40,357002,319442,30461,95795,2.5301134203523,0.23069957638649735
1185,0.1226,46,327,46,357329,319115,30507,95749,2.5275234444303636,0.23079611631763663
1186,0.1227,59,349,59,357678,318766,30566,95690,2.5247592193638324,0.23088096203215783
1187,0.1228,51,397,51,358075,318369,30617,95639,2.521614814345457,0.2310076133794516
1188,0.1229,38,325,38,358400,318044,30655,95601,2.5190406792548474,0.2311184711528001
1189,0.123,60,337,60,358737,317707,30715,95541,2.5163714991762767,0.23119531129007279
1190,0.1231,62,313,62,359050,317394,30777,95479,2.513892409073628,0.23125513172331444
1191,0.1232,57,339,57,359389,317055,30834,95422,2.5112073881637307,0.23133895950562092
1192,0.1233,48,343,48,359732,316712,30882,95374,2.50849068559118,0.23144198055745646
1193,0.1234,43,320,43,360052,316392,30925,95331,2.505956152578887,0.23154159471295022
1194,0.1235,44,327,44,360379,316065,30969,95287,2.503366176656951,0.231643458643692
1195,0.1236,50,338,50,360717,315727,31019,95237,2.500689076162717,0.2317404930845524
1196,0.1237,39,341,39,361058,315386,31058,95198,2.497988214421493,0.2318599848021355
1197,0.1238,45,361,45,361419,315025,31103,95153,2.4951289443670004,0.231979774634427
1198,0.1239,42,295,42,361714,314730,31145,95111,2.492792421746293,0.23206804590072735
1199,0.124,43,332,43,362046,314398,31188,95068,2.49016284374604,0.2321755652483967
1200,0.1241,39,340,39,362386,314058,31227,95029,2.487469902420479,0.2322953308220501
1201,0.1242,58,288,58,362674,313770,31285,94971,2.4851888227094157,0.23235007009328645
1202,0.1243,69,316,69,362990,313454,31354,94902,2.482685971359777,0.23240016064414384
1203,0.1244,51,344,51,363334,313110,31405,94851,2.4799613483715626,0.2325001654569922
1204,0.1245,45,315,45,363649,312795,31450,94806,2.4774664174375873,0.23259511139570316
1205,0.1246,31,324,31,363973,312471,31481,94775,2.4749002027626408,0.23272174557883932
1206,0.1247,51,309,51,364282,312162,31532,94724,2.472452794322646,0.2328023082632482
1207,0.1248,53,340,53,364622,311822,31585,94671,2.4697598529970852,0.2328969994563252
1208,0.1249,46,331,46,364953,311491,31631,94625,2.4671381954124953,0.23299993105418157
1209,0.125,52,310,52,365263,311181,31683,94573,2.4646828665568368,0.233079649245602
1210,0.1251,44,373,44,365636,310808,31727,94529,2.4617285515143834,0.23321088378312368
1211,0.1252,55,321,55,365957,310487,31782,94474,2.4591860980864277,0.23329160091959472
1212,0.1253,59,353,59,366310,310134,31841,94415,2.4563901913572423,0.23338334787627704
1213,0.1254,55,301,55,366611,309833,31896,94360,2.4540061462425546,0.23345283070216455
1214,0.1255,47,329,47,366940,309504,31943,94313,2.4514003294892914,0.2335538127419103
1215,0.1256,40,335,40,367275,309169,31983,94273,2.448746990242048,0.23367175455207936
1216,0.1257,46,297,46,367572,308872,32029,94227,2.446394626790014,0.23375647173523129
1217,0.1258,35,333,35,367905,308539,32064,94192,2.443757128374097,0.23388316270662055
1218,0.1259,34,339,34,368244,308200,32098,94158,2.4410721074642,0.23401547875275253
1219,0.126,38,304,38,368548,307896,32136,94120,2.4386643011025217,0.23412003502348167
1220,0.1261,40,298,40,368846,307598,32176,94080,2.4363040172348245,0.23421745776467717
1221,0.1262,66,310,66,369156,307288,32242,94014,2.4338486883791663,0.2342724431973925
1222,0.1263,53,308,53,369464,306980,32295,93961,2.4314092003548344,0.23435118882828146
1223,0.1264,47,345,47,369809,306635,32342,93914,2.4286766569509566,0.23446319925901699
1224,0.1265,50,341,50,370150,306294,32392,93864,2.4259757952097325,0.23456734589837014
1225,0.1266,38,285,38,370435,306009,32430,93826,2.4237184767456594,0.23466179799167156
1226,0.1267,50,295,50,370730,305714,32480,93776,2.4213819541249526,0.23473929259806253
1227,0.1268,47,315,47,371045,305399,32527,93729,2.418887023190977,0.23483443907718826
1228,0.1269,40,348,40,371393,305051,32567,93689,2.416130718540109,0.2349626322917189
1229,0.127,45,316,45,371709,304735,32612,93644,2.41362786719047,0.23506259115063796
1230,0.1271,56,363,56,372072,304372,32668,93588,2.410752756304651,0.23516936375515127
1231,0.1272,39,326,39,372398,304046,32707,93549,2.4081707007983777,0.2352871640739949
1232,0.1273,35,317,35,372715,303729,32742,93514,2.405659929033076,0.23540754651435017
1233,0.1274,53,323,53,373038,303406,32795,93461,2.403101634773793,0.23549703049132328
1234,0.1275,60,349,60,373387,303057,32855,93401,2.4003374097072614,0.23558863738403563
1235,0.1276,45,331,45,373718,302726,32900,93356,2.3977157521226715,0.23569866845754162
1236,0.1277,50,316,50,374034,302410,32950,93306,2.3952129007730325,0.2357903142657866
1237,0.1278,57,320,57,374354,302090,33007,93249,2.39267836776074,0.23587098667219777
1238,0.1279,42,318,42,374672,301772,33049,93207,2.3901596755797745,0.23597963436030775
1239,0.128,43,324,43,374996,301448,33092,93164,2.3875934609048284,0.23609013410641339
1240,0.1281,41,331,41,375327,301117,33133,93123,2.384971803320238,0.23620890827922078
1241,0.1282,38,349,38,375676,300768,33171,93085,2.382207578253707,0.23634452447994556
1242,0.1283,43,330,43,376006,300438,33214,93042,2.3795938410847803,0.23645928636779506
1243,0.1284,52,380,52,376386,300058,33266,92990,2.3765840831326828,0.2365868799739472
1244,0.1285,49,323,49,376709,299735,33315,92941,2.3740257888734,0.236686224775642
1245,0.1286,48,318,48,377027,299417,33363,92893,2.3715070966924343,0.2367846855802809
1246,0.1287,35,303,35,377330,299114,33398,92858,2.36910721074642,0.23689957445940016
1247,0.1288,40,325,40,377655,298789,33438,92818,2.3665330756558105,0.23701823511837122
1248,0.1289,37,313,37,377968,298476,33475,92781,2.364053985553162,0.2371356934189037
1249,0.129,51,287,51,378255,298189,33526,92730,2.361780826257762,0.23721026606534856
1250,0.1291,55,332,55,378587,297857,33581,92675,2.3591512482575085,0.23730449745475402
1251,0.1292,56,303,56,378890,297554,33637,92619,2.356751362311494,0.23737931635454015
1252,0.1293,45,290,45,379180,297264,33682,92574,2.354454441769104,0.2374678712696043
1253,0.1294,53,319,53,379499,296945,33735,92521,2.351927829172475,0.23755860588600802
1254,0.1295,46,319,46,379818,296626,33781,92475,2.349401216575846,0.23766322882747667
1255,0.1296,56,335,56,380153,296291,33837,92419,2.3467478773286023,0.23775822592678347
1256,0.1297,30,281,30,380434,296010,33867,92389,2.344522240527183,0.23787136424141153
1257,0.1298,51,320,51,380754,295690,33918,92338,2.3419877075148903,0.23796736317997672
1258,0.1299,57,305,57,381059,295385,33975,92281,2.3395719807375492,0.23804254177565223
1259,0.13,57,330,57,381389,295055,34032,92224,2.3369582435686227,0.23813323211431553
1260,0.1301,53,341,53,381730,294714,34085,92171,2.334257381827398,0.23823875311785156
1261,0.1302,53,284,53,382014,294430,34138,92118,2.332007983778989,0.2383093432122272
1262,0.1303,41,305,41,382319,294125,34179,92077,2.3295922570016474,0.2384166834972372
1263,0.1304,41,333,41,382652,293792,34220,92036,2.3269547585857304,0.23854152627595715
1264,0.1305,47,320,47,382972,293472,34267,91989,2.324420225573438,0.2386467113404469
1265,0.1306,47,277,47,383249,293195,34314,91942,2.3222262704346726,0.2387254405575159
1266,0.1307,60,304,60,383553,292891,34374,91882,2.3198184640729944,0.23879534166898406
1267,0.1308,46,303,46,383856,292588,34420,91836,2.31741857812698,0.23889247289451232
1268,0.1309,52,309,52,384165,292279,34472,91784,2.3149711696869852,0.23898162541041443
1269,0.131,58,317,58,384482,291962,34530,91726,2.312460397921683,0.23906403119201017
1270,0.1311,55,313,55,384795,291649,34585,91671,2.3099813078190343,0.23915005739330064
1271,0.1312,45,271,45,385066,291378,34630,91626,2.3078348751742492,0.23922987749475202
1272,0.1313,46,287,46,385353,291091,34676,91580,2.3055617158788495,0.2393178474459784
1273,0.1314,52,298,52,385651,290793,34728,91528,2.303201432011152,0.2394009222616597
1274,0.1315,57,293,57,385944,290500,34785,91471,2.3008807502217716,0.23947105932125737
1275,0.1316,41,346,41,386290,290154,34826,91430,2.2981402864022304,0.23960648245209443
1276,0.1317,48,310,48,386600,289844,34874,91382,2.295684957546572,0.23970558146611196
1277,0.1318,53,332,53,386932,289512,34927,91329,2.2930553795463187,0.23980873908008854
1278,0.1319,44,323,44,387255,289189,34971,91285,2.290497085287036,0.2399244100779554
1279,0.132,44,315,44,387570,288874,35015,91241,2.2880021543530606,0.2400352524893782
1280,0.1321,42,311,42,387881,288563,35057,91199,2.2855389050817387,0.24014777676544782
1281,0.1322,63,322,63,388203,288241,35120,91136,2.2829885312381193,0.24022542220535245
1282,0.1323,47,301,47,388504,287940,35167,91089,2.2806044861234316,0.2403219806400038
1283,0.1324,40,300,40,388804,287640,35207,91049,2.2782283614244077,0.24043212240123163
1284,0.1325,41,310,41,389114,287330,35248,91008,2.275773032568749,0.24054681263843442
1285,0.1326,49,309,49,389423,287021,35297,90959,2.2733256241287543,0.2406450076723636
1286,0.1327,46,319,46,389742,286702,35343,90913,2.2707990115321253,0.24075579624750076
1287,0.1328,46,331,46,390073,286371,35389,90867,2.268177353947535,0.2408744612154661
1288,0.1329,41,278,41,390351,286093,35430,90826,2.265975478393106,0.2409695451807948
1289,0.133,54,312,54,390663,285781,35484,90772,2.263504308706121,0.24106035538157974
1290,0.1331,45,291,45,390954,285490,35529,90727,2.2611994677480673,0.2411560349479157
1291,0.1332,55,304,55,391258,285186,35584,90672,2.2587916613863896,0.24124004278211453
1292,0.1333,26,279,26,391537,284907,35610,90646,2.256581865416297,0.24136673119373298
1293,0.1334,68,299,68,391836,284608,35678,90578,2.2542136611329364,0.24142158822557344
1294,0.1335,52,311,52,392147,284297,35730,90526,2.2517504118616145,0.2415166625313815
1295,0.1336,41,312,41,392459,283985,35771,90485,2.2492792421746293,0.24163484391273
1296,0.1337,53,318,53,392777,283667,35824,90432,2.2467605499936636,0.24173280334884617
1297,0.1338,44,310,44,393087,283357,35868,90388,2.2443052211380055,0.24184403804733173
1298,0.1339,48,271,48,393358,283086,35916,90340,2.24215878849322,0.24192209433729842
1299,0.134,57,275,57,393633,282811,35973,90283,2.239980674185781,0.24198459369488654
1300,0.1341,48,323,48,393956,282488,36021,90235,2.2374223799264987,0.24209667769362234
1301,0.1342,53,306,53,394262,282182,36074,90182,2.234998732733494,0.24218775176977367
1302,0.1343,50,317,50,394579,281865,36124,90132,2.2324879609681916,0.24229227655061733
1303,0.1344,44,323,44,394902,281542,36168,90088,2.229929666708909,0.242413152867099
1304,0.1345,52,310,52,395212,281232,36220,90036,2.2274743378532507,0.24250945408707456
1305,0.1346,55,288,55,395500,280944,36275,89981,2.225193258142187,0.24258542832108917
1306,0.1347,57,290,57,395790,280654,36332,89924,2.2228963375997974,0.2426587654960629
1307,0.1348,43,336,43,396126,280318,36375,89881,2.22023507793689,0.24279103941393682
1308,0.1349,45,266,45,396392,280052,36420,89836,2.218128247370422,0.24287351847045593
1309,0.135,41,306,41,396698,279746,36461,89795,2.215704600177417,0.2429906289153301
1310,0.1351,43,327,43,397025,279419,36504,89752,2.213114624255481,0.2431176880090798
1311,0.1352,46,283,46,397308,279136,36550,89706,2.2108731466227347,0.24320982968317056
1312,0.1353,49,310,49,397618,278826,36599,89657,2.2084178177670766,0.2433138028077279
1313,0.1354,53,290,53,397908,278536,36652,89604,2.2061208972246864,0.24339653392731025
1314,0.1355,45,268,45,398176,278268,36697,89559,2.2039982258268913,0.24348131050738528
1315,0.1356,43,305,43,398481,277963,36740,89516,2.2015824990495503,0.24359487208792882
1316,0.1357,48,314,48,398795,277649,36788,89468,2.199095488531238,0.24370432314493745
1317,0.1358,44,306,44,399101,277343,36832,89424,2.1966718413382336,0.24381691918847662
1318,0.1359,45,281,45,399382,277062,36877,89379,2.1944462045368143,0.24391102524007957
1319,0.136,39,267,39,399649,276795,36916,89340,2.1923314535546825,0.24400835757302633
1320,0.1361,43,299,43,399948,276496,36959,89297,2.189963249271322,0.2441189415871818
1321,0.1362,51,316,51,400264,276180,37010,89246,2.187460397921683,0.24422454888267392
1322,0.1363,50,275,50,400539,275905,37060,89196,2.185282283614244,0.2443050005340988
1323,0.1364,43,309,43,400848,275596,37103,89153,2.1828348751742492,0.2444228771017878
1324,0.1365,57,297,57,401145,275299,37160,89096,2.1804825117222153,0.24450390373084152
1325,0.1366,42,292,42,401437,275007,37202,89054,2.1781697503484985,0.2446128533405116
1326,0.1367,34,274,34,401711,274733,37236,89020,2.175999556456723,0.2447265039738504
1327,0.1368,53,331,53,402042,274402,37289,88967,2.1733778988721326,0.24483926807184983
1328,0.1369,62,326,62,402368,274076,37351,88905,2.17079584336586,0.2449301754086302
1329,0.137,54,312,54,402680,273764,37405,88851,2.1683246736788746,0.2450284737255767
1330,0.1371,25,300,25,402980,273464,37430,88826,2.1659485489798507,0.24517927627039113
1331,0.1372,37,292,37,403272,273172,37467,88789,2.1636357876061334,0.24529990800113824
1332,0.1373,47,301,47,403573,272871,37514,88742,2.161251742491446,0.24540600033737725
1333,0.1374,44,303,44,403876,272568,37558,88698,2.1588518565454313,0.24551992160900832
1334,0.1375,47,328,47,404204,272240,37605,88651,2.156253960207832,0.24564480688074794
1335,0.1376,52,336,52,404540,271904,37657,88599,2.1535927005449245,0.2457649450906095
1336,0.1377,39,309,39,404849,271595,37696,88560,2.1511452921049297,0.24589412891671641
1337,0.1378,65,300,65,405149,271295,37761,88495,2.1487691674059053,0.24596292281608717
1338,0.1379,55,268,55,405417,271027,37816,88440,2.1466464960081106,0.2460309291256221
1339,0.138,57,265,57,405682,270762,37873,88383,2.144547585857306,0.24609280374222112
1340,0.1381,47,275,47,405957,270487,37920,88336,2.142369471549867,0.24618265830228275
1341,0.1382,54,305,54,406262,270182,37974,88282,2.1399537447725256,0.24627856632744152
1342,0.1383,32,282,32,406544,269900,38006,88250,2.137720187555443,0.24640513751221554
1343,0.1384,44,290,44,406834,269610,38050,88206,2.135423267013053,0.24651217385471863
1344,0.1385,47,286,47,407120,269324,38097,88159,2.1331580281333165,0.24661032832330487
1345,0.1386,36,262,36,407382,269062,38133,88123,2.131082879229502,0.24671528759606368
1346,0.1387,48,326,48,407708,268736,38181,88075,2.128500823723229,0.24683936313622618
1347,0.1388,39,293,39,408001,268443,38220,88036,2.126180141933849,0.24695984896726034
1348,0.1389,41,275,41,408276,268168,38261,87995,2.12400202762641,0.2470638443633954
1349,0.139,54,293,54,408569,267875,38315,87941,2.1216813458370294,0.2471530229107179
1350,0.1391,49,261,49,408830,267614,38364,87892,2.1196141173488785,0.24723070777989684
1351,0.1392,54,311,54,409141,267303,38418,87838,2.1171508680775566,0.24733274952765238
1352,0.1393,38,280,38,409421,267023,38456,87800,2.1149331516918006,0.2474473188040234
1353,0.1394,50,331,50,409752,266692,38506,87750,2.1123114941072108,0.24757224031012126
1354,0.1395,51,266,51,410018,266426,38557,87699,2.1102046635407428,0.24764984115778327
1355,0.1396,49,279,49,410297,266147,38606,87650,2.10799486757065,0.24774093618657025
1356,0.1397,50,279,50,410576,265868,38656,87600,2.1057850716005575,0.2478300723120622
1357,0.1398,52,304,52,410880,265564,38708,87548,2.10337726523888,0.2479326672557149
1358,0.1399,51,289,51,411169,265275,38759,87497,2.101088265112153,0.2480270543013618
1359,0.14,56,294,56,411463,264981,38815,87441,2.0987596629071095,0.2481144763947767
1360,0.1401,40,271,40,411734,264710,38855,87401,2.0966132302623244,0.24822002152730246
1361,0.1402,45,303,45,412037,264407,38900,87356,2.0942133443163096,0.24833765916256115
1362,0.1403,34,291,34,412328,264116,38934,87322,2.091908503358256,0.24847056948878607
1363,0.1404,48,287,48,412615,263829,38982,87274,2.0896353440628563,0.24857093217659776
1364,0.1405,55,293,55,412908,263536,39037,87219,2.087314662273476,0.24866074610483102
1365,0.1406,40,306,40,413214,263230,39077,87179,2.0848910150804714,0.24879212577302523
1366,0.1407,43,304,43,413518,262926,39120,87136,2.0824832087187937,0.24891590632516525
1367,0.1408,42,302,42,413820,262624,39162,87094,2.0800912431884426,0.2490406556139518
1368,0.1409,34,275,34,414095,262349,39196,87060,2.0779131288810038,0.24916358765801683
1369,0.141,49,261,49,414356,262088,39245,87011,2.0758459003928524,0.2492444836564986
1370,0.1411,33,294,33,414650,261794,39278,86978,2.073517298187809,0.249383551431881
1371,0.1412,46,270,46,414920,261524,39324,86932,2.071378785958687,0.24947769589273824
1372,0.1413,35,276,35,415196,261248,39359,86897,2.069192751235585,0.2496000229789312
1373,0.1414,63,317,63,415513,260931,39422,86834,2.0666819794702826,0.24969160208761665
1374,0.1415,47,269,47,415782,260662,39469,86787,2.064551387656824,0.24978342145178142
1375,0.1416,34,275,34,416057,260387,39503,86753,2.0623732733493854,0.24990781817134297
1376,0.1417,33,284,33,416341,260103,39536,86720,2.0601238753009756,0.2500410872404656
1377,0.1418,39,267,39,416608,259836,39575,86681,2.0580091243188443,0.25014934332226124
1378,0.1419,47,261,47,416869,259575,39622,86634,2.055941895830693,0.25023612904343906
1379,0.142,38,271,38,417140,259304,39660,86596,2.053795463185908,0.2503498120844175
1380,0.1421,42,283,42,417423,259021,39702,86554,2.051553985553162,0.2504637198871446
1381,0.1422,49,272,49,417695,258749,39751,86505,2.049399632492713,0.250554664102371
1382,0.1423,53,243,53,417938,258506,39804,86452,2.0474749714865035,0.25061601702236214
1383,0.1424,40,267,40,418205,258239,39844,86412,2.045360220504372,0.25072319534833787
1384,0.1425,40,276,40,418481,257963,39884,86372,2.04317418578127,0.2508371208271015
1385,0.1426,51,254,51,418735,257709,39935,86321,2.041162400202763,0.25091125773915063
1386,0.1427,41,265,41,419000,257444,39976,86280,2.0390634900519577,0.25101534952461857
1387,0.1428,57,288,57,419288,257156,40033,86223,2.0367824103408947,0.25110155251194743
1388,0.1429,50,249,50,419537,256907,40083,86173,2.0348102268407047,0.2511746531421243
1389,0.143,50,246,50,419783,256661,40133,86123,2.0328618045875047,0.25124568241224793
1390,0.1431,61,317,61,420100,256344,40194,86062,2.0303510328222023,0.25134489465721976
1391,0.1432,50,289,50,420389,256055,40244,86012,2.028062032695476,0.25144781577878017
1392,0.1433,50,277,50,420666,255778,40294,85962,2.0258680775567104,0.2515421080353485
1393,0.1434,33,287,33,420953,255491,40327,85929,2.02359491826131,0.2516812137543202
1394,0.1435,49,276,49,421229,255215,40376,85880,2.021408883538208,0.25177736407745643
1395,0.1436,50,277,50,421506,254938,40426,85830,2.0192149283994425,0.2518722415250258
1396,0.1437,45,308,45,421814,254630,40471,85785,2.016775440375111,0.2520012337881703
1397,0.1438,49,281,49,422095,254349,40520,85736,2.0145498035736917,0.25210168046223735
1398,0.1439,47,285,47,422380,254064,40567,85689,2.0122924851096187,0.25220969351264005
1399,0.144,44,285,44,422665,253779,40611,85645,2.0100351666455456,0.25232452625624585
1400,0.1441,54,291,54,422956,253488,40665,85591,2.007730325687492,0.2524220019523474
1401,0.1442,49,302,49,423258,253186,40714,85542,2.005338360157141,0.2525389102760917
1402,0.1443,43,282,43,423540,252904,40757,85499,2.0031048029400584,0.2526543795415525
1403,0.1444,56,259,56,423799,252645,40813,85443,2.001053415283234,0.2527241428267197
1404,0.1445,50,262,50,424061,252383,40863,85393,1.9989782663794196,0.2528095542608119
1405,0.1446,35,308,35,424369,252075,40898,85358,1.996538778355088,0.2529628103949525
1406,0.1447,53,287,53,424656,251788,40951,85305,1.9942656190596884,0.25306072804834273
1407,0.1448,52,283,52,424939,251505,41003,85253,1.9920241414269422,0.253158054151646
1408,0.1449,49,264,49,425203,251241,41052,85204,1.9899331516918009,0.2532479305681464
1409,0.145,40,270,40,425473,250971,41092,85164,1.987794639462679,0.25336248828595653
1410,0.1451,55,259,55,425732,250712,41147,85109,1.9857432518058549,0.2534356100422547
1411,0.1452,31,273,31,426005,250439,41178,85078,1.9835809783297427,0.25357284429701027
1412,0.1453,48,286,48,426291,250153,41226,85030,1.9813157394500063,0.25368231682394393
1413,0.1454,68,271,68,426562,249882,41294,84962,1.9791693068052212,0.2537360681391932
1414,0.1455,48,284,48,426846,249598,41342,84914,1.9769199087568115,0.2538444061797484
1415,0.1456,57,255,57,427101,249343,41399,84857,1.974900202762641,0.25391083183722324
1416,0.1457,60,292,60,427393,249051,41459,84797,1.9725874413889242,0.2539988258129448
1417,0.1458,48,272,48,427665,248779,41507,84749,1.9704330883284755,0.2540986064138543
1418,0.1459,55,264,55,427929,248515,41562,84694,1.9683420985933342,0.2541768079493651
1419,0.146,58,273,58,428202,248242,41620,84636,1.9661798251172222,0.25425531275722635
1420,0.1461,47,268,47,428470,247974,41667,84589,1.9640571537194271,0.25435481397509646
1421,0.1462,47,248,47,428718,247726,41714,84542,1.9620928906349004,0.2544391876437093
1422,0.1463,42,258,42,428976,247468,41756,84500,1.9600494233937398,0.25454260651629074
1423,0.1464,51,257,51,429233,247211,41807,84449,1.9580138765682422,0.25462521859735876
1424,0.1465,39,280,39,429513,246931,41846,84410,1.9557961601824865,0.2547526566286696
1425,0.1466,39,287,39,429800,246644,41885,84371,1.9535230008870865,0.254885730253916
1426,0.1467,55,261,55,430061,246383,41940,84316,1.9514557723989354,0.2549629723706452
1427,0.1468,52,284,52,430345,246099,41992,84264,1.949206374350526,0.2550648831739632
1428,0.1469,50,266,50,430611,245833,42042,84214,1.9470995437840577,0.25515759876623634
1429,0.147,36,270,36,430881,245563,42078,84178,1.944961031554936,0.25528520869409627
1430,0.1471,50,257,50,431138,245306,42128,84128,1.9429254847294386,0.25537133386353567
1431,0.1472,41,291,41,431429,245015,42169,84087,1.940620643771385,0.25550437250457303
1432,0.1473,41,260,41,431689,244755,42210,84046,1.9385613356988975,0.2556135778175857
1433,0.1474,54,255,54,431944,244500,42264,83992,1.9365416297047269,0.25568963627729135
1434,0.1475,38,280,38,432224,244220,42302,83954,1.934323913318971,0.25582160683052285
1435,0.1476,52,265,52,432489,243955,42354,83902,1.9322250031681663,0.2559103511591944
1436,0.1477,59,274,59,432763,243681,42413,83843,1.9300548092763907,0.2559904007034599
1437,0.1478,36,249,36,433012,243432,42449,83807,1.9280826257762007,0.2561033373161512
1438,0.1479,48,252,48,433264,243180,42497,83759,1.9260866810290205,0.2561915219658713
1439,0.148,50,242,50,433506,242938,42547,83709,1.9241699404384742,0.25626746916395987
1440,0.1481,48,259,48,433765,242679,42595,83661,1.92211855278165,0.25636146350432065
1441,0.1482,41,276,41,434041,242403,42636,83620,1.9199325180585478,0.2564849719191591
1442,0.1483,55,252,55,434293,242151,42691,83565,1.9179365733113674,0.2565578602217883
1443,0.1484,31,269,31,434562,241882,42722,83534,1.915805981497909,0.25669911743737245
1444,0.1485,56,276,56,434838,241606,42778,83478,1.9136199467748067,0.2567890145316287
1445,0.1486,39,236,39,435074,241370,42817,83439,1.9117507286782411,0.2568863547500223
1446,0.1487,51,261,51,435335,241109,42868,83388,1.90968350019009,0.25697618159798086
1447,0.1488,47,257,47,435592,240852,42915,83341,1.9076479533645925,0.2570721761419895
1448,0.1489,36,264,36,435856,240588,42951,83305,1.9055569636294514,0.25719913675195205
1449,0.149,54,260,54,436116,240328,43005,83251,1.9034976555569636,0.25728183843821756
1450,0.1491,45,244,45,436360,240084,43050,83206,1.9015650741350907,0.25737263756998363
1451,0.1492,47,286,47,436646,239798,43097,83159,1.8992998352553543,0.25749248351947784
1452,0.1493,51,248,51,436894,239550,43148,83108,1.8973355721708276,0.25757303398645004
1453,0.1494,47,255,47,437149,239295,43195,83061,1.895315866176657,0.2576685403715147
1454,0.1495,53,264,53,437413,239031,43248,83008,1.8932248764415156,0.2577576007874823
1455,0.1496,47,252,47,437665,238779,43295,82961,1.8912289316943354,0.25785105986200035
1456,0.1497,53,275,53,437940,238504,43348,82908,1.8890508173868965,0.25794929871940064
1457,0.1498,42,277,42,438217,238227,43390,82866,1.8868568622481308,0.25807476338630864
1458,0.1499,55,271,55,438488,237956,43445,82811,1.8847104296033457,0.2581655843649752
1459,0.15,42,237,42,438725,237719,43487,82769,1.8828332910911165,0.2582592795986121
1460,0.1501,55,254,55,438979,237465,43542,82714,1.8808215055126094,0.258336742884449
1461,0.1502,47,270,47,439249,237195,43589,82667,1.8786829932834874,0.25844582976408575
1462,0.1503,37,249,37,439498,236946,43626,82630,1.8767108097832974,0.25856134378050916
1463,0.1504,36,261,36,439759,236685,43662,82594,1.8746435812951463,0.2586891088984869
1464,0.1505,56,252,56,440011,236433,43718,82538,1.872647636547966,0.2587633358518486
1465,0.1506,47,217,47,440228,236216,43765,82491,1.870928906349005,0.258830210820597
1466,0.1507,36,301,36,440529,235915,43801,82455,1.8685448612343176,0.2589911109715111
1467,0.1508,42,276,42,440805,235639,43843,82413,1.8663588265112152,0.25911800586067685
1468,0.1509,66,242,66,441047,235397,43909,82347,1.8644420859206692,0.25916146331638046
1469,0.151,42,258,42,441305,235139,43951,82305,1.8623986186795083,0.25927407668754177
1470,0.1511,44,231,44,441536,234908,43995,82261,1.8605690026612596,0.25936015184333905
1471,0.1512,43,265,43,441801,234643,44038,82218,1.858470092510455,0.2594765528102228
1472,0.1513,55,250,55,442051,234393,44093,82163,1.8564899885946013,0.2595528121406639
1473,0.1514,63,256,63,442307,234137,44156,82100,1.8544623621847676,0.2596154150210127
1474,0.1515,52,238,52,442545,233899,44208,82048,1.8525773032568749,0.2596891250747752
1475,0.1516,55,273,55,442818,233626,44263,81993,1.8504150297807629,0.25978474046239297
1476,0.1517,40,275,40,443093,233351,44303,81953,1.848236915473324,0.25991741303630783
1477,0.1518,54,242,54,443335,233109,44357,81899,1.8463201748827778,0.25999022247054043
1478,0.1519,34,247,34,443582,232862,44391,81865,1.8443638322139146,0.2601143213006828
1479,0.152,51,235,51,443817,232627,44442,81814,1.8425025345330124,0.26018871584812414
1480,0.1521,48,251,48,444068,232376,44490,81766,1.8405145102014955,0.26028356603064856
1481,0.1522,68,278,68,444346,232098,44558,81698,1.8383126346470662,0.2603538604698594
1482,0.1523,41,240,41,444586,231858,44599,81657,1.8364117348878468,0.26045643749102915
1483,0.1524,45,259,45,444845,231599,44644,81612,1.8343603472310226,0.26056556123507796
1484,0.1525,45,245,45,445090,231354,44689,81567,1.8324198453934863,0.2606632344904944
1485,0.1526,44,279,44,445369,231075,44733,81523,1.8302100494233937,0.2607918156866007
1486,0.1527,41,261,41,445630,230814,44774,81482,1.8281428209352426,0.2609127238261137
1487,0.1528,46,294,46,445924,230520,44820,81436,1.825814218730199,0.2610496352049648
1488,0.1529,49,260,49,446184,230260,44869,81387,1.8237549106577113,0.2611512384203923
1489,0.153,46,262,46,446446,229998,44915,81341,1.821679761753897,0.26126183998792313
1490,0.1531,66,267,66,446713,229731,44981,81275,1.8195650107717654,0.2613293634206414
1491,0.1532,38,275,38,446988,229456,45019,81237,1.8173868964643265,0.26147032601313835
1492,0.1533,39,267,39,447255,229189,45058,81198,1.815272145482195,0.2616024511335848
1493,0.1534,56,278,56,447533,228911,45114,81142,1.8130702699277659,0.26170364421566633
1494,0.1535,60,271,60,447804,228640,45174,81082,1.8109238372829806,0.26178960487146535
1495,0.1536,43,244,43,448048,228396,45217,81039,1.8089912558611076,0.26189345096708516
1496,0.1537,54,249,54,448297,228147,45271,80985,1.8070190723609174,0.26197546679088546
1497,0.1538,44,233,44,448530,227914,45315,80941,1.805173615511342,0.26206796069352933
1498,0.1539,58,257,58,448787,227657,45373,80883,1.8031380686858447,0.2621475335450833
1499,0.154,38,276,38,449063,227381,45411,80845,1.8009520339627423,0.2622913057302109
1500,0.1541,38,230,38,449293,227151,45449,80807,1.7991303383601571,0.2623961709064223
1501,0.1542,41,268,41,449561,226883,45490,80766,1.7970076669623622,0.2625264505979217
1502,0.1543,53,228,53,449789,226655,45543,80713,1.7952018121911038,0.26259402410140287
1503,0.1544,46,267,46,450056,226388,45589,80667,1.7930870612089722,0.26271189200631806
1504,0.1545,43,278,43,450334,226110,45632,80624,1.7908851856545431,0.2628466358473466
1505,0.1546,50,240,50,450574,225870,45682,80574,1.7889842858953238,0.26293221600031325
1506,0.1547,68,270,68,450844,225600,45750,80506,1.786845773666202,0.263000398554749
1507,0.1548,42,265,42,451109,225335,45792,80464,1.7847468635153974,0.263127086746523
1508,0.1549,49,217,49,451326,225118,45841,80415,1.7830281333164364,0.2631957922712113
1509,0.155,42,249,42,451575,224869,45883,80373,1.7810559498162464,0.2633091121143224
1510,0.1551,40,250,40,451825,224619,45923,80333,1.7790758459003928,0.2634283428211653
1511,0.1552,53,267,53,452092,224352,45976,80280,1.7769610949182613,0.2635310801229024
1512,0.1553,47,236,47,452328,224116,46023,80233,1.7750918768216957,0.26362169745916697
1513,0.1554,54,249,54,452577,223867,46077,80179,1.7731196933215054,0.26370680752254594
1514,0.1555,38,267,38,452844,223600,46115,80141,1.7710049423393739,0.2638465008016698
1515,0.1556,56,237,56,453081,223363,46171,80085,1.7691278038271447,0.26391671719701565
1516,0.1557,45,251,45,453332,223112,46216,80040,1.7671397794956278,0.2640259671715839
1517,0.1558,34,247,34,453579,222865,46250,80006,1.7651834368267647,0.264158668211879
1518,0.1559,46,236,46,453815,222629,46296,79960,1.763314218730199,0.2642528313983654
1519,0.156,47,252,47,454067,222377,46343,79913,1.7613182739830187,0.26435872837341623
1520,0.1561,45,231,45,454298,222146,46388,79868,1.75948865796477,0.2644513168263723
1521,0.1562,55,231,55,454529,221915,46443,79813,1.7576590419465214,0.2645196998621275
1522,0.1563,53,234,53,454763,221681,46496,79760,1.7558056646812825,0.2645957251999562
1523,0.1564,45,244,45,455007,221437,46541,79715,1.7538730832594094,0.2647002178301987
1524,0.1565,40,253,40,455260,221184,46581,79675,1.7518692180965658,0.2648250509374823
1525,0.1566,42,253,42,455513,220931,46623,79633,1.749865352933722,0.2649452362891098
1526,0.1567,57,240,57,455753,220691,46680,79576,1.7479644531745027,0.2650174677870029
1527,0.1568,52,250,52,456003,220441,46732,79524,1.745984349258649,0.26511092960845434
1528,0.1569,40,226,40,456229,220215,46772,79484,1.7441943353187175,0.26521276347268424
1529,0.157,47,231,47,456460,219984,46819,79437,1.742364719300469,0.26530203292354243
1530,0.1571,48,235,48,456695,219749,46867,79389,1.7405034216195665,0.26539256129278127
1531,0.1572,54,266,54,456961,219483,46921,79335,1.7383965910530985,0.26549605445455093
1532,0.1573,40,252,40,457213,219231,46961,79295,1.736400646305918,0.2656217548890214
1533,0.1574,44,232,44,457445,218999,47005,79251,1.734563109872006,0.2657200335289187
1534,0.1575,41,258,41,457703,218741,47046,79210,1.7325196426308453,0.26584908256726775
1535,0.1576,31,207,31,457910,218534,47077,79179,1.7308801165885186,0.26595748254191115
1536,0.1577,42,233,42,458143,218301,47119,79137,1.729034659738943,0.2660621709398261
1537,0.1578,45,213,45,458356,218088,47164,79092,1.727347611202636,0.26614173228346455
1538,0.1579,42,228,42,458584,217860,47206,79050,1.7255417564313775,0.266242295645145
1539,0.158,58,230,58,458814,217630,47264,78992,1.7237200608287924,0.2663052639386155
1540,0.1581,41,228,41,459042,217402,47305,78951,1.7219142060575339,0.2664086410463198
1541,0.1582,34,235,34,459277,217167,47339,78917,1.7200529083766316,0.2665358479350455
1542,0.1583,40,254,40,459531,216913,47379,78877,1.7180411227981245,0.26666553974103246
1543,0.1584,39,231,39,459762,216682,47418,78838,1.7162115067798758,0.2667772062804548
1544,0.1585,53,260,53,460022,216422,47471,78785,1.7141521987073882,0.26688052790076117
1545,0.1586,55,230,55,460252,216192,47526,78730,1.7123305031048028,0.2669519398349394
1546,0.1587,53,248,53,460500,215944,47579,78677,1.7103662400202764,0.2670447795642537
1547,0.1588,45,250,45,460750,215694,47624,78632,1.7083861361044228,0.26715954417890364
1548,0.1589,39,249,39,460999,215445,47663,78593,1.7064139526042326,0.26728858174793735
1549,0.159,43,239,43,461238,215206,47706,78550,1.7045209732606768,0.26739879355655716
1550,0.1591,43,223,43,461461,214983,47749,78507,1.7027547205677354,0.2674946335479914
1551,0.1592,52,199,52,461660,214784,47801,78455,1.701178557850716,0.2675462677201873
1552,0.1593,53,260,53,461920,214524,47854,78402,1.6991192497782284,0.2676512156653899
1553,0.1594,53,246,53,462166,214278,47907,78349,1.6971708275250286,0.2677435780020299
1554,0.1595,44,222,44,462388,214056,47951,78305,1.6954124952477505,0.2678366813631093
1555,0.1596,46,233,46,462621,213823,47997,78259,1.6935670383981751,0.2679350319430845
1556,0.1597,54,220,54,462841,213603,48051,78205,1.691824546952224,0.26800156267134556
1557,0.1598,47,243,47,463084,213360,48098,78158,1.6898998859460144,0.26810694365356513
1558,0.1599,35,223,35,463307,213137,48133,78123,1.6881336332530732,0.2682242669779578
1559,0.16,44,228,44,463535,212909,48177,78079,1.6863277784818147,0.26832377967476323
1560,0.1601,40,212,40,463747,212697,48217,78039,1.684648650361171,0.26841877166914313
1561,0.1602,44,221,44,463968,212476,48261,77995,1.6828982384995566,0.2685121750536198
1562,0.1603,43,235,43,464203,212241,48304,77952,1.681036940818654,0.26862122794140453
1563,0.1604,35,270,35,464473,211971,48339,77917,1.6788984285895323,0.2687831162379954
1564,0.1605,44,236,44,464709,211735,48383,77873,1.6770292104929667,0.2688910527333499
1565,0.1606,41,213,41,464922,211522,48424,77832,1.6753421619566595,0.26898539505242713
1566,0.1607,41,270,41,465192,211252,48465,77791,1.6732036497275378,0.2691329663752452
1567,0.1608,40,190,40,465382,211062,48505,77751,1.671698770751489,0.26920879600295
1568,0.1609,22,223,22,465605,210839,48527,77729,1.6699325180585478,0.26936112112223115
1569,0.161,45,229,45,465834,210610,48572,77684,1.668118742871626,0.2694610363032182
1570,0.1611,49,195,49,466029,210415,48621,77635,1.66657426181726,0.2695191806977955
1571,0.1612,42,216,42,466245,210199,48663,77593,1.6648634520339627,0.2696148607327514
1572,0.1613,43,223,43,466468,209976,48706,77550,1.6630971993410215,0.26971473884100916
1573,0.1614,48,235,48,466703,209741,48754,77502,1.661235901660119,0.2698133635980685
1574,0.1615,46,237,46,466940,209504,48800,77456,1.65935876314789,0.2699191524951213
1575,0.1616,59,212,59,467152,209292,48859,77397,1.6576796350272462,0.2699685024538786
1576,0.1617,52,228,52,467380,209064,48911,77345,1.6558737802559877,0.2700508713064184
1577,0.1618,53,233,53,467613,208831,48964,77292,1.6540283234064124,0.27013557106559066
1578,0.1619,49,230,49,467843,208601,49013,77243,1.6522066278038272,0.27022781657127665
1579,0.162,53,248,53,468091,208353,49066,77190,1.6502423647193005,0.27032706107311333
1580,0.1621,43,182,43,468273,208171,49109,77147,1.648800849068559,0.27038953027849627
1581,0.1622,30,207,30,468480,207964,49139,77117,1.6471613230262325,0.27050908338331914
1582,0.1623,45,224,45,468704,207740,49184,77072,1.6453871499176276,0.2706065755656363
1583,0.1624,36,244,36,468948,207496,49220,77036,1.6434545684957547,0.2707463483896363
1584,0.1625,50,250,50,469198,207246,49270,76986,1.641474464579901,0.2708562019758507
1585,0.1626,50,224,50,469422,207022,49320,76936,1.6397002914712964,0.27094147726072165
1586,0.1627,60,213,60,469635,206809,49380,76876,1.6380132429349892,0.27099071152863213
1587,0.1628,41,233,41,469868,206576,49421,76835,1.6361677860854138,0.27110803744385364
1588,0.1629,38,222,38,470090,206354,49459,76797,1.634409453808136,0.27122277512705234
1589,0.163,47,234,47,470324,206120,49506,76750,1.632556076542897,0.2713260508360731
1590,0.1631,44,237,44,470561,205883,49550,76706,1.6306789380306679,0.27144014805954936
1591,0.1632,46,217,46,470778,205666,49596,76660,1.628960207831707,0.2715300751613383
1592,0.1633,54,244,54,471022,205422,49650,76606,1.627027626409834,0.27162551236047483
1593,0.1634,38,250,38,471272,205172,49688,76568,1.6250475224939804,0.27176829701142896
1594,0.1635,52,212,52,471484,204960,49740,76516,1.6233683943733368,0.2718384515908994
1595,0.1636,46,231,46,471715,204729,49786,76470,1.621538778355088,0.2719426455997354
1596,0.1637,36,195,36,471910,204534,49822,76434,1.6199942973007224,0.2720380968651234
1597,0.1638,51,267,51,472177,204267,49873,76383,1.6178795463185909,0.2721646178514164
1598,0.1639,46,202,46,472379,204065,49919,76337,1.6162796223545812,0.27224128215918575
1599,0.164,32,199,32,472578,203866,49951,76305,1.6147034596375618,0.27235152817386526
1600,0.1641,50,226,50,472804,203640,50001,76255,1.6129134456976302,0.27244145125850766
1601,0.1642,41,231,41,473035,203409,50042,76214,1.6110838296793817,0.27255983949818147
1602,0.1643,37,215,37,473250,203194,50079,76177,1.6093809403117476,0.27267325527703307
1603,0.1644,51,232,51,473482,202962,50130,76126,1.6075434038778356,0.2727670125551797
1604,0.1645,51,206,51,473688,202756,50181,76075,1.6059117982511721,0.27283551685429525
1605,0.1646,52,208,52,473896,202548,50233,76023,1.604264351793182,0.2729034967746104
1606,0.1647,43,230,43,474126,202318,50276,75980,1.602442656190597,0.2730166943348497
1607,0.1648,45,181,45,474307,202137,50321,75935,1.601009060955519,0.27307675709888085
1608,0.1649,38,247,38,474554,201890,50359,75897,1.5990527182866556,0.27322012909171417
1609,0.165,33,224,33,474778,201666,50392,75864,1.597278545178051,0.27335423197492165
1610,0.1651,40,221,40,474999,201445,50432,75824,1.5955281333164364,0.2734672826749474
1611,0.1652,49,221,49,475220,201224,50481,75775,1.5937777214548219,0.2735569442488962
1612,0.1653,49,222,49,475442,201002,50530,75726,1.592019389177544,0.2736477696510653
1613,0.1654,39,194,39,475636,200808,50569,75687,1.5904828285388417,0.27373731893885966
1614,0.1655,46,223,46,475859,200585,50615,75641,1.5887165758459003,0.2738373650561497
1615,0.1656,40,241,40,476100,200344,50655,75601,1.5868077556710176,0.27397126238924424
1616,0.1657,42,216,42,476316,200128,50697,75559,1.5850969458877202,0.27407531004363644
1617,0.1658,43,240,43,476556,199888,50740,75516,1.5831960461285008,0.2742008104457452
1618,0.1659,45,234,45,476790,199654,50785,75471,1.581342668863262,0.27431531122217173
1619,0.166,41,230,41,477020,199424,50826,75430,1.5795209732606768,0.27443660998202685
1620,0.1661,41,260,41,477280,199164,50867,75389,1.577461665188189,0.27458814873630955
1621,0.1662,42,224,42,477504,198940,50909,75347,1.5756874920795843,0.27470131650424556
1622,0.1663,49,229,49,477733,198711,50958,75298,1.5738737168926624,0.2748011926615549
1623,0.1664,47,235,47,477968,198476,51005,75251,1.5720124192117602,0.2749125953961429
1624,0.1665,54,244,54,478212,198232,51059,75197,1.5700798377898872,0.27501472045759595
1625,0.1666,52,210,52,478422,198022,51111,75145,1.5684165505005703,0.2750881329003869
1626,0.1667,49,238,49,478660,197784,51160,75096,1.5665314915726778,0.27519788918205806
1627,0.1668,46,247,46,478907,197537,51206,75050,1.5645751489038144,0.2753249421285681
1628,0.1669,56,208,56,479115,197329,51262,74994,1.5629277024458244,0.27538621416479697
1629,0.167,33,201,33,479316,197128,51295,74961,1.561335698897478,0.2755017659662831
1630,0.1671,48,200,48,479516,196928,51343,74913,1.5597516157647953,0.2755765318697327
1631,0.1672,45,228,45,479744,196700,51388,74868,1.557945760993537,0.27568785718494077
1632,0.1673,60,229,60,479973,196471,51448,74808,1.5561319858066152,0.2757603795354598
1633,0.1674,45,209,45,480182,196262,51493,74763,1.5544766189329615,0.27585278110875383
1634,0.1675,44,238,44,480420,196024,51537,74719,1.552591560005069,0.2759775876015262
1635,0.1676,46,219,46,480639,195805,51583,74673,1.5508569889747814,0.2760779065210479
1636,0.1677,45,222,45,480861,195583,51628,74628,1.5490986566975036,0.2761841671878643
1637,0.1678,48,228,48,481089,195355,51676,74580,1.547292801926245,0.2762887361772279
1638,0.1679,40,231,40,481320,195124,51716,74540,1.5454631859079964,0.2764180609944227
1639,0.168,40,214,40,481534,194910,51756,74500,1.5437682169560258,0.27653019561263503
1640,0.1681,44,225,44,481759,194685,51800,74456,1.5419861234317578,0.2766430978557708
1641,0.1682,45,182,45,481941,194503,51845,74411,1.5405446077810163,0.27670928252154964
1642,0.1683,37,218,37,482159,194285,51882,74374,1.538817957166392,0.2768342024648346
1643,0.1684,52,225,52,482384,194060,51934,74322,1.537035863642124,0.2769261723960623
1644,0.1685,59,210,59,482594,193850,51993,74263,1.535372576352807,0.2769839582564068
1645,0.1686,47,215,47,482809,193635,52040,74216,1.533669686985173,0.27707942102138877
1646,0.1687,37,228,37,483037,193407,52077,74179,1.5318638322139146,0.27721554939346604
1647,0.1688,47,197,47,483234,193210,52124,74132,1.530303510328222,0.27729275609518894
1648,0.1689,42,217,42,483451,192993,52166,74090,1.5285847801292611,0.27740440237678926
1649,0.169,40,202,40,483653,192791,52206,74050,1.5269848561652515,0.2775060803999385
1650,0.1691,52,203,52,483856,192588,52258,73998,1.5253770117855785,0.27757646688123155
1651,0.1692,47,222,47,484078,192366,52305,73951,1.5236186795083007,0.27768035836991256
1652,0.1693,40,212,40,484290,192154,52345,73911,1.5219395513876568,0.27779302050250876
1653,0.1694,33,206,33,484496,191948,52378,73878,1.5203079457609936,0.27791863850789617
1654,0.1695,43,187,43,484683,191761,52421,73835,1.518826828031935,0.27799740959954217
1655,0.1696,55,201,55,484884,191560,52476,73780,1.517234824483589,0.2780583402427075
1656,0.1697,55,218,55,485102,191342,52531,73725,1.5155081738689646,0.27813722568256327
1657,0.1698,44,188,44,485290,191154,52575,73681,1.5140191357242427,0.27821473747805237
1658,0.1699,49,206,49,485496,190948,52624,73632,1.5123875300975795,0.2782976793408421
1659,0.17,39,202,39,485698,190746,52663,73593,1.5107876061335699,0.27840386776071635
1660,0.1701,51,225,51,485923,190521,52714,73542,1.5090055126093018,0.2785017211801729
1661,0.1702,43,183,43,486106,190338,52757,73499,1.507556076542897,0.27857730341081804
1662,0.1703,49,251,49,486357,190087,52806,73450,1.5055680522113801,0.27870849254563873
1663,0.1704,41,184,41,486541,189903,52847,73409,1.5041106957293118,0.2787909400255211
1664,0.1705,37,223,37,486764,189680,52884,73372,1.5023444430363706,0.27892583975791857
1665,0.1706,50,215,50,486979,189465,52934,73322,1.5006415536687365,0.27901684634323615
1666,0.1707,46,184,46,487163,189281,52980,73276,1.4991841971866684,0.2790860651210975
1667,0.1708,28,215,28,487378,189066,53008,73248,1.4974813078190343,0.2792378599693497
1668,0.1709,54,208,54,487586,188858,53062,73194,1.4958338613610442,0.27931097644742264
1669,0.171,32,228,32,487814,188630,53094,73162,1.4940280065897857,0.2794661410585503
1670,0.1711,57,201,57,488015,188429,53151,73105,1.4924360030414396,0.27952388599570227
1671,0.1712,58,212,58,488227,188217,53209,73047,1.4907568749207958,0.27959075877273565
1672,0.1713,39,228,39,488455,187989,53248,73008,1.4889510201495375,0.27972735318796765
1673,0.1714,42,198,42,488653,187791,53290,72966,1.4873827778481814,0.2798237439455125
1674,0.1715,42,220,42,488873,187571,53332,72924,1.4856402864022304,0.27994395285898
1675,0.1716,42,199,42,489072,187372,53374,72882,1.484064123685211,0.2800418053132709
1676,0.1717,48,201,48,489273,187171,53422,72834,1.4824721201368647,0.28012538220418837
1677,0.1718,51,204,51,489477,186967,53473,72783,1.4808563553415284,0.28020404234841195
1678,0.1719,37,216,37,489693,186751,53510,72746,1.479145545558231,0.28033464741403563
1679,0.172,48,206,48,489899,186545,53558,72698,1.4775139399315675,0.2804241580293393
1680,0.1721,44,200,44,490099,186345,53602,72654,1.4759298567988848,0.28051845760022237
1681,0.1722,48,223,48,490322,186122,53650,72606,1.4741636041059434,0.28062675860363007
1682,0.1723,38,228,38,490550,185894,53688,72568,1.472357749334685,0.2807685462466436
1683,0.1724,44,211,44,490761,185683,53732,72524,1.4706865416297048,0.2808754216578172
1684,0.1725,27,219,27,490980,185464,53759,72497,1.468951970599417,0.2810386066110769
1685,0.1726,32,190,32,491170,185274,53791,72465,1.4674470916233684,0.2811565188039063
1686,0.1727,44,204,44,491374,185070,53835,72421,1.4658313268280319,0.28125643226365193
1687,0.1728,48,220,48,491594,184850,53883,72373,1.464088835382081,0.2813628641295685
1688,0.1729,47,219,47,491813,184631,53930,72326,1.4623542643517933,0.2814712189198971
1689,0.173,37,210,37,492023,184421,53967,72289,1.4606909770624763,0.2815979120408243
1690,0.1731,42,224,42,492247,184197,54009,72247,1.4589168039538716,0.28172622482881254
1691,0.1732,24,190,24,492437,184007,54033,72223,1.4574119249778228,0.2818678531007298
1692,0.1733,40,197,40,492634,183810,54073,72183,1.4558516030921302,0.2819725539370217
1693,0.1734,42,202,42,492836,183608,54115,72141,1.4542516791281206,0.282077349276048
1694,0.1735,35,212,35,493048,183396,54150,72106,1.452572551007477,0.2822130550837175
1695,0.1736,47,180,47,493228,183216,54197,72059,1.4511468761880624,0.2822798942317109
1696,0.1737,33,199,33,493427,183017,54230,72026,1.449570713471043,0.28240728034096213
1697,0.1738,57,194,57,493621,182823,54287,71969,1.4480341528323406,0.2824617727401174
1698,0.1739,32,190,32,493811,182633,54319,71937,1.446529273856292,0.2825823938405939
1699,0.174,42,219,42,494030,182414,54361,71895,1.4447947028260044,0.28270725770617633
1700,0.1741,52,175,52,494205,182239,54413,71843,1.443408630084907,0.28275517352665674
1701,0.1742,55,207,55,494412,182032,54468,71788,1.4417691040425802,0.2828303522181073
1702,0.1743,48,197,48,494609,181835,54516,71740,1.4402087821568876,0.28291432515035
1703,0.1744,37,181,37,494790,181654,54553,71703,1.4387751869218097,0.28301171864207425
1704,0.1745,46,211,46,495001,181443,54599,71657,1.4371039792168292,0.28311734492295537
1705,0.1746,47,191,47,495192,181252,54646,71610,1.4355911798251173,0.2831979498698895
1706,0.1747,42,212,42,495404,181040,54688,71568,1.4339120517044734,0.283316442868001
1707,0.1748,37,210,37,495614,180830,54725,71531,1.4322487644151565,0.2834471253482115
1708,0.1749,47,192,47,495806,180638,54772,71484,1.430728044607781,0.28352940243215585
1709,0.175,43,199,43,496005,180439,54815,71441,1.4291518818907616,0.28363109417182786
1710,0.1751,31,201,31,496206,180238,54846,71410,1.4275598783424155,0.2837693921668362
1711,0.1752,42,209,42,496415,180029,54888,71368,1.4259045114687618,0.2838856470045386
1712,0.1753,53,244,53,496659,179785,54941,71315,1.423971930046889,0.28401035444046197
1713,0.1754,39,232,39,496891,179553,54980,71276,1.4221343936129769,0.28416171973735094
1714,0.1755,53,175,53,497066,179378,55033,71223,1.4207483208718794,0.28420876213582547
1715,0.1756,37,176,37,497242,179202,55070,71186,1.4193543277151184,0.2843027621132003
1716,0.1757,40,173,40,497415,179029,55110,71146,1.4179840958053478,0.28438493054861597
1717,0.1758,45,184,45,497599,178845,55155,71101,1.4165267393232797,0.2844654445360198
1718,0.1759,42,188,42,497787,178657,55197,71059,1.4150377011785578,0.2845592593185859
1719,0.176,35,199,35,497986,178458,55232,71024,1.4134615384615385,0.28468586912081834
1720,0.1761,42,212,42,498198,178246,55274,70982,1.4117824103408947,0.28480748551527113
1721,0.1762,31,203,31,498401,178043,55305,70951,1.4101745659612217,0.2849506413809168
1722,0.1763,50,206,50,498607,177837,55355,70901,1.4085429603345583,0.2850428965417427
1723,0.1764,48,192,48,498799,177645,55403,70853,1.4070222405271828,0.28512503118737376
1724,0.1765,48,196,48,498995,177449,55451,70805,1.4054698390571536,0.2852119200496266
1725,0.1766,47,202,47,499197,177247,55498,70758,1.4038699150931442,0.28530876393621096
1726,0.1767,32,196,32,499393,177051,55530,70726,1.402317513623115,0.2854421516121351
1727,0.1768,47,203,47,499596,176848,55577,70679,1.400709669243442,0.285540567291649
1728,0.1769,46,189,46,499785,176659,55623,70633,1.3992127106830567,0.2856258997460492
1729,0.177,49,199,49,499984,176460,55672,70584,1.3976365479660373,0.2857142857142857
1730,0.1771,49,198,49,500182,176262,55721,70535,1.3960683056646812,0.28580169126853244
1731,0.1772,42,196,42,500378,176066,55763,70493,1.3945159041946522,0.2859072270734388
1732,0.1773,49,192,49,500570,175874,55812,70444,1.3929951843872765,0.2859880317313392
1733,0.1774,48,208,48,500778,175666,55860,70396,1.3913477379292865,0.286090497516886
1734,0.1775,47,173,47,500951,175493,55907,70349,1.3899775060195159,0.28615533554071315
1735,0.1776,28,205,28,501156,175288,55935,70321,1.388353820808516,0.2863127979837872
1736,0.1777,46,193,46,501349,175095,55981,70275,1.3868251805854772,0.286404205893141
1737,0.1778,44,183,44,501532,174912,56025,70231,1.3853757445190724,0.28648992628792175
1738,0.1779,43,228,43,501760,174684,56068,70188,1.383569889747814,0.28663138292659024
1739,0.178,38,174,38,501934,174510,56106,70150,1.38219173742238,0.2867244339082809
1740,0.1781,52,189,52,502123,174321,56158,70098,1.3806947788619948,0.28679439814417046
1741,0.1782,39,190,39,502313,174131,56197,70059,1.379189899885946,0.2869036406077235
1742,0.1783,40,192,40,502505,173939,56237,70019,1.3776691800785705,0.2870125185482747
1743,0.1784,37,220,37,502725,173719,56274,69982,1.3759266886326194,0.28716336822581773
1744,0.1785,48,183,48,502908,173536,56322,69934,1.3744772525662148,0.28723867416930216
1745,0.1786,39,194,39,503102,173342,56361,69895,1.3729406919275124,0.28735348651726506
1746,0.1787,49,191,49,503293,173151,56410,69846,1.3714278925358003,0.28743564735367105
1747,0.1788,43,219,43,503512,172932,56453,69803,1.3696933215055127,0.28756874781139924
1748,0.1789,34,180,34,503692,172752,56487,69769,1.3682676466860981,0.28768230380049564
1749,0.179,51,196,51,503888,172556,56538,69718,1.366715245216069,0.2877650924160248
1750,0.1791,33,190,33,504078,172366,56571,69685,1.3652103662400203,0.28789387360514934
1751,0.1792,39,207,39,504285,172159,56610,69646,1.3635708401976936,0.28802547507288934
1752,0.1793,40,156,40,504441,172003,56650,69606,1.362335255354201,0.2880935726732034
1753,0.1794,39,206,39,504647,171797,56689,69567,1.3607036497275378,0.288224424520641
1754,0.1795,40,218,40,504865,171579,56729,69527,1.3589769991129135,0.2883669423407132
1755,0.1796,45,191,45,505056,171388,56774,69482,1.3574641997212014,0.28846265620459166
1756,0.1797,43,200,43,505256,171188,56817,69439,1.3558801165885186,0.28857526379001525
1757,0.1798,43,172,43,505428,171016,56860,69396,1.3545178050944113,0.2886544764820392
1758,0.1799,46,160,46,505588,170856,56906,69350,1.3532505385882652,0.2887105234673572
1759,0.18,42,200,42,505788,170656,56948,69308,1.3516664554555824,0.28882665733193313
1760,0.1801,32,183,32,505971,170473,56980,69276,1.3502170193891776,0.2889521958381474
1761,0.1802,43,207,43,506178,170266,57023,69233,1.3485774933468508,0.28907427588424167
1762,0.1803,40,189,40,506367,170077,57063,69193,1.3470805347864656,0.28918376729218037
1763,0.1804,52,198,52,506565,169879,57115,69141,1.3455122924851097,0.289268680445151
1764,0.1805,45,171,45,506736,169708,57160,69096,1.3441579014066658,0.28934188707056835
1765,0.1806,38,184,38,506920,169524,57198,69058,1.3427005449245977,0.28945184464879997
1766,0.1807,41,167,41,507087,169357,57239,69017,1.3413778355088075,0.28953241544799346
1767,0.1808,42,193,42,507280,169164,57281,68975,1.3398491952857685,0.2896417638438055
1768,0.1809,56,178,56,507458,168986,57337,68919,1.3384393612976808,0.2896912633193922
1769,0.181,42,189,42,507647,168797,57379,68877,1.3369424027372956,0.2897961072729874
1770,0.1811,49,183,49,507830,168614,57428,68828,1.3354929666708908,0.2898728952754778
1771,0.1812,35,208,35,508038,168406,57463,68793,1.3338455202129007,0.2900223019489964
1772,0.1813,50,192,50,508230,168214,57513,68743,1.3323248004055253,0.2901074878564465
1773,0.1814,48,183,48,508413,168031,57561,68695,1.3308753643391205,0.29018781206965016
1774,0.1815,40,162,40,508575,167869,57601,68655,1.3295922570016474,0.29026652686408144
1775,0.1816,54,196,54,508771,167673,57655,68601,1.3280398555316184,0.29034510779857287
1776,0.1817,33,217,33,508988,167456,57688,68568,1.3263211253326574,0.2905128292038098
1777,0.1818,35,209,35,509197,167247,57723,68533,1.324665758459004,0.2906650267198236
1778,0.1819,38,168,38,509365,167079,57761,68495,1.3233351286275503,0.29075789348569875
1779,0.182,37,202,37,509567,166877,57798,68458,1.3217352046635407,0.29089595682750125
1780,0.1821,41,175,41,509742,166702,57839,68417,1.3203491319224432,0.29098881842811514
1781,0.1822,38,186,38,509928,166516,57877,68379,1.3188759346090482,0.2911045360693076
1782,0.1823,38,193,38,510121,166323,57915,68341,1.3173472943860094,0.2912291616950193
1783,0.1824,50,202,50,510323,166121,57965,68291,1.3157473704219997,0.29132894220432404
1784,0.1825,39,186,39,510509,165935,58004,68252,1.3142741731086047,0.291442308924065
1785,0.1826,50,179,50,510688,165756,58054,68202,1.3128564187048537,0.29151386146231373
1786,0.1827,40,179,40,510867,165577,58094,68162,1.3114386643011025,0.29161586213682783
1787,0.1828,44,187,44,511054,165390,58138,68118,1.309957546572044,0.29171591551467185
1788,0.1829,46,199,46,511253,165191,58184,68072,1.3083813838550247,0.29182510728233796
1789,0.183,45,187,45,511440,165004,58229,68027,1.3069002661259663,0.2919225339117971
1790,0.1831,35,185,35,511625,164819,58264,67992,1.3054349892282346,0.2920480561485497
1791,0.1832,36,170,36,511795,164649,58300,67956,1.3040885185654543,0.29215193138582574
1792,0.1833,39,171,39,511966,164478,58339,67917,1.3027341274870106,0.2922481120506035
1793,0.1834,40,176,40,512142,164302,58379,67877,1.3013401343302498,0.292347714478915
1794,0.1835,52,178,52,512320,164124,58431,67825,1.299930300342162,0.2924134184669906
1795,0.1836,40,193,40,512513,163931,58471,67785,1.298401660119123,0.2925348271159523
1796,0.1837,34,158,34,512671,163773,58505,67751,1.2971502344443036,0.29263056961697276
1797,0.1838,43,176,43,512847,163597,58548,67708,1.2957562412875427,0.2927217310477508
1798,0.1839,45,197,45,513044,163400,58593,67663,1.2941959194018502,0.29283355621627
1799,0.184,44,204,44,513248,163196,58637,67619,1.2925801546065137,0.292957563416589
1800,0.1841,33,184,33,513432,163012,58670,67586,1.2911227981244455,0.2930901395502129
1801,0.1842,42,173,42,513605,162839,58712,67544,1.289752566214675,0.29318135452702676
1802,0.1843,37,189,37,513794,162650,58749,67507,1.2882556076542897,0.29330848073271726
1803,0.1844,41,194,41,513988,162456,58790,67466,1.2867190470155874,0.2934299458077087
1804,0.1845,47,192,47,514180,162264,58837,67419,1.285198327208212,0.29353064876373086
1805,0.1846,37,166,37,514346,162098,58874,67382,1.283883538208085,0.29362907442914415
1806,0.1847,48,169,48,514515,161929,58922,67334,1.2825449879609683,0.2936976311048883
1807,0.1848,43,154,43,514669,161775,58965,67291,1.2813252439488025,0.29376249639841795
1808,0.1849,37,199,37,514868,161576,59002,67254,1.279749081231783,0.29390377135865053
1809,0.185,39,195,39,515063,161381,59041,67215,1.2782046001774172,0.2940340163432431
1810,0.1851,32,171,32,515234,161210,59073,67183,1.2768502090989735,0.29415524994198594
1811,0.1852,48,173,48,515407,161037,59121,67135,1.275479977189203,0.2942297915607524
1812,0.1853,48,255,48,515662,160782,59169,67087,1.2734602711950322,0.2944103849141393
1813,0.1854,32,160,32,515822,160622,59201,67055,1.272193004688886,0.2945181111838262
1814,0.1855,37,191,37,516013,160431,59238,67018,1.270680205297174,0.2946506689411692
1815,0.1856,33,144,33,516157,160287,59271,66985,1.2695396654416424,0.2947349431518181
1816,0.1857,40,152,40,516309,160135,59311,66945,1.2683357622608034,0.29480799718161
1817,0.1858,51,168,51,516477,159967,59362,66894,1.2670051324293499,0.2948677824747312
1818,0.1859,42,190,42,516667,159777,59404,66852,1.2655002534533013,0.29498431356975496
1819,0.186,37,190,37,516857,159587,59441,66815,1.2639953744772525,0.2951166509129778
1820,0.1861,40,195,40,517052,159392,59481,66775,1.2624508934228869,0.2952464329455668
1821,0.1862,43,189,43,517241,159203,59524,66732,1.2609539348625016,0.29535928475003875
1822,0.1863,46,169,46,517410,159034,59570,66686,1.2596153846153846,0.29543682438419283
1823,0.1864,43,176,43,517586,158858,59613,66643,1.2582213914586238,0.29553305750307096
1824,0.1865,41,184,41,517770,158674,59654,66602,1.2567640349765556,0.29564622951401837
1825,0.1866,42,160,42,517930,158514,59696,66560,1.2554967684704093,0.29572496156819533
1826,0.1867,40,183,40,518113,158331,59736,66520,1.2540473324040045,0.2958403565027507
1827,0.1868,30,172,30,518285,158159,59766,66490,1.2526850209098974,0.29597282872392044
1828,0.1869,32,169,32,518454,157990,59798,66458,1.2513464706627804,0.2960953093812375
1829,0.187,46,211,46,518665,157779,59844,66412,1.2496752629578,0.2962295542639981
1830,0.1871,42,178,42,518843,157601,59886,66370,1.2482654289697124,0.2963330073982792
1831,0.1872,42,162,42,519005,157439,59928,66328,1.2469823216322393,0.29641546787506645
1832,0.1873,47,189,47,519194,157250,59975,66281,1.245485363071854,0.296518156318363
1833,0.1874,33,179,33,519373,157071,60008,66248,1.2440676086681028,0.2966518746725536
1834,0.1875,33,175,33,519548,156896,60041,66215,1.2426815359270054,0.29678052628512264
1835,0.1876,42,161,42,519709,156735,60083,66173,1.2414063490051959,0.29686238268702786
1836,0.1877,38,174,38,519883,156561,60121,66135,1.2400281966797617,0.29697435068434097
1837,0.1878,40,171,40,520054,156390,60161,66095,1.238673805601318,0.29707620738476753
1838,0.1879,50,191,50,520245,156199,60211,66045,1.237161006209606,0.2971733770090531
1839,0.188,34,194,34,520439,156005,60245,66011,1.2356244455709036,0.29732541798789275
1840,0.1881,37,149,37,520588,155856,60282,65974,1.234444303637055,0.2974079249876031
1841,0.1882,41,183,41,520771,155673,60323,65933,1.2329948675706501,0.2975235327563333
1842,0.1883,41,196,41,520967,155477,60364,65892,1.231442466100621,0.2976568534889709
1843,0.1884,47,161,47,521128,155316,60411,65845,1.2301672791788114,0.29772428231017223
1844,0.1885,42,181,42,521309,155135,60453,65803,1.2287336839437333,0.29783468665417445
1845,0.1886,53,181,53,521490,154954,60506,65750,1.2273000887086554,0.2979103233289836
1846,0.1887,40,173,40,521663,154781,60546,65710,1.2259298567988848,0.2980166990942941
1847,0.1888,47,167,47,521830,154614,60593,65663,1.2246071473830946,0.29809285581336226
1848,0.1889,37,157,37,521987,154457,60630,65626,1.2233636421239387,0.2981875019878864
1849,0.189,39,163,39,522150,154294,60669,65587,1.2220726143708023,0.2982840718388583
1850,0.1891,44,183,44,522333,154111,60713,65543,1.2206231783043975,0.2983920165350961
1851,0.1892,44,168,44,522501,153943,60757,65499,1.2192925484729438,0.29847978053426416
1852,0.1893,40,159,40,522660,153784,60797,65459,1.218033202382461,0.2985682553148789
1853,0.1894,35,178,35,522838,153606,60832,65424,1.2166233683943732,0.29869880838241336
1854,0.1895,32,153,32,522991,153453,60864,65392,1.215411544797871,0.29880509036075764
1855,0.1896,44,186,44,523177,153267,60908,65348,1.213938347484476,0.2989181895112412
1856,0.1897,33,167,33,523344,153100,60941,65315,1.2126156380686859,0.29904081679371836
1857,0.1898,38,190,38,523534,152910,60979,65277,1.211110759092637,0.29917914449531824
1858,0.1899,40,169,40,523703,152741,61019,65237,1.2097722088455203,0.2992824963987191
1859,0.19,32,182,32,523885,152559,61051,65205,1.2083306931947788,0.2994296577946768
1860,0.1901,41,168,41,524053,152391,61092,65164,1.2070000633633253,0.2995288547723564
1861,0.1902,30,155,30,524208,152236,61122,65134,1.205772398935496,0.2996457652849979
1862,0.1903,31,150,31,524358,152086,61153,65103,1.204584336585984,0.29975274990906536
1863,0.1904,42,171,42,524529,151915,61195,65061,1.2032299455075401,0.29985344001179853
1864,0.1905,39,184,39,524713,151731,61234,65022,1.201772589025472,0.29998200716945095
1865,0.1906,37,151,37,524864,151580,61271,64985,1.2005766062602965,0.30007157204534435
1866,0.1907,44,176,44,525040,151404,61315,64941,1.1991826131035357,0.3001733342577827
1867,0.1908,35,162,35,525202,151242,61350,64906,1.1978995057660626,0.30028498991431796
1868,0.1909,53,183,53,525385,151059,61403,64853,1.1964500696996578,0.3003677424135759
1869,0.191,44,161,44,525546,150898,61447,64809,1.1951748827778481,0.30044922047036027
1870,0.1911,52,173,52,525719,150725,61499,64757,1.1938046508680775,0.30052162129551424
1871,0.1912,38,181,38,525900,150544,61537,64719,1.1923710556329996,0.3006508317732262
1872,0.1913,37,174,37,526074,150370,61574,64682,1.1909929033075657,0.300773766344884
1873,0.1914,43,169,43,526243,150201,61617,64639,1.1896543530604486,0.3008704151927015
1874,0.1915,30,148,30,526391,150053,61647,64609,1.1884821315422633,0.300980145531114
1875,0.1916,53,173,53,526564,149880,61700,64556,1.1871118996324928,0.3010501967953142
1876,0.1917,46,161,46,526725,149719,61746,64510,1.185836712710683,0.30112636477787785
1877,0.1918,33,163,33,526888,149556,61779,64477,1.1845456849575466,0.30124793840202213
1878,0.1919,36,189,36,527077,149367,61815,64441,1.1830487263971614,0.3013965801092569
1879,0.192,47,152,47,527229,149215,61862,64394,1.1818448232163223,0.30145733559915544
1880,0.1921,36,143,36,527372,149072,61898,64358,1.1807122037764541,0.3015414890127911
1881,0.1922,47,190,47,527562,148882,61945,64311,1.1792073248004056,0.3016562457491569
1882,0.1923,31,167,31,527729,148715,61976,64280,1.1778846153846154,0.3017911218573206
1883,0.1924,39,167,39,527896,148548,62015,64241,1.1765619059688253,0.30190000422954194
1884,0.1925,49,154,49,528050,148394,62064,64192,1.1753421619566595,0.3019577959037754
1885,0.1926,37,167,37,528217,148227,62101,64155,1.1740194525408694,0.3020736220583665
1886,0.1927,48,147,48,528364,148080,62149,64107,1.1728551514383474,0.3021250123711632
1887,0.1928,48,166,48,528530,147914,62197,64059,1.1715403624382208,0.3022035825317375
1888,0.1929,41,148,41,528678,147766,62238,64018,1.1703681409200355,0.3022796811846032
1889,0.193,45,196,45,528874,147570,62283,63973,1.1688157394500063,0.3024113300841909
1890,0.1931,47,169,47,529043,147401,62330,63926,1.1674771892028895,0.3024980243887435
1891,0.1932,33,154,33,529197,147247,62363,63893,1.1662574451907237,0.3026096428909728
1892,0.1933,39,157,39,529354,147090,62402,63854,1.1650139399315675,0.30270593143203883
1893,0.1934,35,163,35,529517,146927,62437,63819,1.1637229121784312,0.30282425289210707
1894,0.1935,51,134,51,529651,146793,62488,63768,1.1626615764795336,0.30284810577457366
1895,0.1936,52,148,52,529799,146645,62540,63716,1.1614893549613483,0.30288884346433037
1896,0.1937,47,137,47,529936,146508,62587,63669,1.1604042580154605,0.30293038724503635
1897,0.1938,33,157,33,530093,146351,62620,63636,1.1591607527563046,0.3030473315014739
1898,0.1939,40,179,40,530272,146172,62660,63596,1.1577429983525536,0.3031730292513634
1899,0.194,38,154,38,530426,146018,62698,63558,1.1565232543403878,0.30326945833492386
1900,0.1941,38,169,38,530595,145849,62736,63520,1.1551847040932708,0.3033877985757204
1901,0.1942,33,155,33,530750,145694,62769,63487,1.1539570396654417,0.3035027081809533
1902,0.1943,27,169,27,530919,145525,62796,63460,1.1526184894183247,0.3036581572840156
1903,0.1944,30,166,30,531085,145359,62826,63430,1.1513037004181979,0.3037995296687086
1904,0.1945,34,167,34,531252,145192,62860,63396,1.149980991002408,0.3039292768519761
1905,0.1946,42,146,42,531398,145046,62902,63354,1.1488246103155493,0.30400191938579657
1906,0.1947,50,177,50,531575,144869,62952,63304,1.1474226967431251,0.3040932301499234
1907,0.1948,37,142,37,531717,144727,62989,63267,1.1462979977189203,0.30417704356856445
1908,0.1949,34,162,34,531879,144565,63023,63233,1.1450148903814472,0.30430033012829766
1909,0.195,43,146,43,532025,144419,63066,63190,1.1438585096945888,0.3043702344310699
1910,0.1951,50,143,50,532168,144276,63116,63140,1.1427258902547206,0.3044123886296139
1911,0.1952,37,168,37,532336,144108,63153,63103,1.141395260423267,0.3045349909029926
1912,0.1953,45,149,45,532485,143959,63198,63058,1.1402151184894183,0.30460300361806036
1913,0.1954,42,157,42,532642,143802,63240,63016,1.1389716132302623,0.30469301511473856
1914,0.1955,37,184,37,532826,143618,63277,62979,1.1375142567481942,0.3048398573067373
1915,0.1956,40,170,40,532996,143448,63317,62939,1.1361677860854138,0.30495622301792263
1916,0.1957,39,151,39,533147,143297,63356,62900,1.1349718033202383,0.3050480850836821
1917,0.1958,40,185,40,533332,143112,63396,62860,1.1335065264225066,0.3051871128114501
1918,0.1959,54,151,54,533483,142961,63450,62806,1.132310543657331,0.3052287295824889
1919,0.196,36,138,36,533621,142823,63486,62770,1.13121752629578,0.305311951282388
1920,0.1961,42,179,42,533800,142644,63528,62728,1.129799771892029,0.30543598932668525
1921,0.1962,40,152,40,533952,142492,63568,62688,1.1285958687111899,0.3055268544692465
1922,0.1963,33,186,33,534138,142306,63601,62655,1.1271226713977949,0.3056923024380248
1923,0.1964,37,144,37,534282,142162,63638,62618,1.1259821315422633,0.305781814630335
1924,0.1965,34,154,34,534436,142008,63672,62584,1.1247623875300976,0.30589661374833815
1925,0.1966,43,137,43,534573,141871,63715,62541,1.1236772905842098,0.30595561904389174
1926,0.1967,36,151,36,534724,141720,63751,62505,1.1224813078190343,0.30605949320602277
1927,0.1968,29,142,29,534866,141578,63780,62476,1.1213566087948295,0.3061738559400943
1928,0.1969,37,172,37,535038,141406,63817,62439,1.1199942973007224,0.3063062621109176
1929,0.197,44,152,44,535190,141254,63861,62395,1.1187903941198833,0.3063850055733149
1930,0.1971,34,161,34,535351,141093,63895,62361,1.1175152071980738,0.3065115456073609
1931,0.1972,39,128,39,535479,140965,63934,62322,1.1165013939931567,0.3065714974395805
1932,0.1973,35,151,35,535630,140814,63969,62287,1.1153054112279812,0.3066799277206907
1933,0.1974,34,147,34,535777,140667,64003,62253,1.1141411101254595,0.306785925487877
1934,0.1975,43,161,43,535938,140506,64046,62210,1.1128659232036497,0.30688253517235936
1935,0.1976,42,158,42,536096,140348,64088,62168,1.1116144975288302,0.3069782140670367
1936,0.1977,36,156,36,536252,140192,64124,62132,1.1103789126853376,0.30709159565844885
1937,0.1978,36,157,36,536409,140035,64160,62096,1.1091354074261817,0.30720671247854114
1938,0.1979,39,153,39,536562,139882,64199,62057,1.1079235838296795,0.3073056715146653
1939,0.198,43,163,43,536725,139719,64242,62014,1.1066325560765429,0.30740632420080005
1940,0.1981,32,144,32,536869,139575,64274,61982,1.1054920162210113,0.3075159880331618
1941,0.1982,45,139,45,537008,139436,64319,61937,1.1043910784437967,0.30757350786848286
1942,0.1983,17,161,17,537169,139275,64336,61920,1.103115891521987,0.30776112726459404
1943,0.1984,31,141,31,537310,139134,64367,61889,1.1019991129134457,0.30787024370345684
1944,0.1985,35,151,35,537461,138983,64402,61854,1.1008031301482701,0.3079810991002654
1945,0.1986,35,147,35,537608,138836,64437,61819,1.0996388290457484,0.3080860182900999
1946,0.1987,38,136,38,537744,138700,64475,61781,1.098561652515524,0.3081638659025045
1947,0.1988,37,157,37,537901,138543,64512,61744,1.097318147256368,0.3082776216129854
1948,0.1989,32,157,32,538058,138386,64544,61712,1.096074641997212,0.308408879648972
1949,0.199,37,155,37,538213,138231,64581,61675,1.0948469775693828,0.30852000440206895
1950,0.1991,37,177,37,538390,138054,64618,61638,1.0934450639969586,0.3086653446307313
1951,0.1992,34,162,34,538552,137892,64652,61604,1.0921619566594856,0.3087981713919076
1952,0.1993,31,159,31,538711,137733,64683,61573,1.0909026105690027,0.3089370114296609
1953,0.1994,43,147,43,538858,137586,64726,61530,1.0897383094664808,0.30901585005725307
1954,0.1995,46,162,46,539020,137424,64772,61484,1.0884552021290077,0.3091077281959499
1955,0.1996,51,140,51,539160,137284,64823,61433,1.0873463439361297,0.30914818561069257
1956,0.1997,38,154,38,539314,137130,64861,61395,1.086126599923964,0.30925576123913867
1957,0.1998,37,129,37,539443,137001,64898,61358,1.0851048663033835,0.3093280365398091
1958,0.1999,41,141,41,539584,136860,64939,61317,1.0839880876948422,0.30940522865922887
1959,0.2,30,162,30,539746,136698,64969,61287,1.0827049803573692,0.3095537540722782
1960,0.2001,44,125,44,539871,136573,65013,61243,1.0817149283994425,0.30959578598293364
1961,0.2002,34,134,34,540005,136439,65047,61209,1.080653592700545,0.3096869181575326
1962,0.2003,34,154,34,540159,136285,65081,61175,1.0794338486883792,0.3098095816874304
1963,0.2004,42,132,42,540291,136153,65123,61133,1.0783883538208086,0.30986993501819693
1964,0.2005,35,140,35,540431,136013,65158,61098,1.0772794956279306,0.30996748025224363
1965,0.2006,36,161,36,540592,135852,65194,61062,1.0760043087061208,0.31009476218044424
1966,0.2007,34,160,34,540752,135692,65228,61028,1.0747370421999747,0.3102277348515657
1967,0.2008,28,147,28,540899,135545,65256,61000,1.0735727410974527,0.3103614948230685
1968,0.2009,44,150,44,541049,135395,65300,60956,1.0723846787479407,0.3104440517236989
1969,0.201,34,150,34,541199,135245,65334,60922,1.0711966163984286,0.31056191918110587
1970,0.2011,41,142,41,541341,135103,65375,60881,1.0700719173742237,0.3106427055269818
1971,0.2012,29,164,29,541505,134939,65404,60852,1.068772969205424,0.31080080289696665
1972,0.2013,42,148,42,541653,134791,65446,60810,1.0676007476872387,0.31088798114529065
1973,0.2014,44,135,44,541788,134656,65490,60766,1.0665314915726778,0.3109475903429501
1974,0.2015,43,153,43,541941,134503,65533,60723,1.0653196679761754,0.311039513179597
1975,0.2016,38,125,38,542066,134378,65571,60685,1.0643296160182487,0.3111046174825569
1976,0.2017,37,144,37,542210,134234,65608,60648,1.063189076162717,0.31120370275346104
1977,0.2018,31,157,31,542367,134077,65639,60617,1.061945570903561,0.31134498238261066
1978,0.2019,32,150,32,542517,133927,65671,60585,1.0607575085540488,0.31147178580241835
1979,0.202,37,163,37,542680,133764,65708,60548,1.0594664808009124,0.3116019597348594
1980,0.2021,45,151,45,542831,133613,65753,60503,1.058270498035737,0.31168476581013416
1981,0.2022,38,146,38,542977,133467,65791,60465,1.0571141173488785,0.31178454303570324
1982,0.2023,33,135,33,543112,133332,65824,60432,1.0560448612343176,0.31188456059949216
1983,0.2024,36,155,36,543267,133177,65860,60396,1.0548171968064883,0.31200632319590027
1984,0.2025,32,127,32,543394,133050,65892,60364,1.0538113040172348,0.3120973662713144
1985,0.2026,33,142,33,543536,132908,65925,60331,1.0526866049930301,0.3122092331258183
1986,0.2027,35,141,35,543677,132767,65960,60296,1.0515698263844886,0.31231256118469103
1987,0.2028,35,154,35,543831,132613,65995,60261,1.0503500823723229,0.3124371351244854
1988,0.2029,37,138,37,543969,132475,66032,60224,1.0492570650107718,0.3125288662629282
1989,0.203,30,115,30,544084,132360,66062,60194,1.048346217209479,0.31260841114700294
1990,0.2031,45,145,45,544229,132215,66107,60149,1.0471977569382842,0.31268324634547007
1991,0.2032,33,139,33,544368,132076,66140,60116,1.0460968191610696,0.3127913752913753
1992,0.2033,43,134,43,544502,131942,66183,60073,1.045035483462172,0.31285576647657737
1993,0.2034,39,161,39,544663,131781,66222,60034,1.0437602965403625,0.3129786513046425
1994,0.2035,33,143,33,544806,131638,66255,60001,1.0426276771004943,0.3130938900745673
1995,0.2036,33,171,33,544977,131467,66288,59968,1.0412732860220504,0.3132551518792279
1996,0.2037,45,150,45,545127,131317,66333,59923,1.0400852236725384,0.3133392595691278
1997,0.2038,43,137,43,545264,131180,66376,59880,1.0390001267266507,0.3134094001884225
1998,0.2039,43,138,43,545402,131042,66419,59837,1.0379071093650996,0.3134813153882826
1999,0.204,36,168,36,545570,130874,66455,59801,1.0365764795336458,0.3136279008784581
2000,0.2041,31,121,31,545691,130753,66486,59770,1.0356181092383727,0.313715404439359
2001,0.2042,41,158,41,545849,130595,66527,59729,1.0343666835635534,0.31382799857085814
2002,0.2043,43,129,43,545978,130466,66570,59686,1.033344949942973,0.3138857335184484
2003,0.2044,46,163,46,546141,130303,66616,59640,1.0320539221898366,0.3139889335221619
2004,0.2045,26,135,26,546276,130168,66642,59614,1.0309846660752757,0.3141183041595093
2005,0.2046,37,144,37,546420,130024,66679,59577,1.029844126219744,0.31422302624986154
2006,0.2047,30,144,30,546564,129880,66709,59547,1.0287035863642124,0.31435328649031025
2007,0.2048,33,143,33,546707,129737,66742,59514,1.0275709669243442,0.3144712577476473
2008,0.2049,30,129,30,546836,129608,66772,59484,1.0265492333037638,0.31457703128635794
2009,0.205,42,143,42,546979,129465,66814,59442,1.0254166138638956,0.31466277056964537
2010,0.2051,33,127,33,547106,129338,66847,59409,1.024410721074642,0.31475467159742937
2011,0.2052,53,141,53,547247,129197,66900,59356,1.0232939424661007,0.31479743096105606
2012,0.2053,39,128,39,547375,129069,66939,59317,1.0222801292611836,0.3148694701304768
2013,0.2054,38,131,38,547506,128938,66977,59279,1.0212425548092763,0.3149502967319636
2014,0.2055,41,131,41,547637,128807,67018,59238,1.0202049803573692,0.3150203408758542
2015,0.2056,34,149,34,547786,128658,67052,59204,1.0190248384235205,0.31514622435617634
2016,0.2057,36,149,36,547935,128509,67088,59168,1.0178446964896717,0.31526505645337466
2017,0.2058,36,138,36,548073,128371,67124,59132,1.0167516791281206,0.3153656208167336
2018,0.2059,36,156,36,548229,128215,67160,59096,1.015516094284628,0.31549668732749275
2019,0.206,34,128,34,548357,128087,67194,59062,1.014502281079711,0.3155881142832716
2020,0.2061,27,153,27,548510,127934,67221,59035,1.0132904574832087,0.3157475303392541
2021,0.2062,34,141,34,548651,127793,67255,59001,1.0121736788746674,0.3158613231688384
2022,0.2063,39,132,39,548783,127661,67294,58962,1.0111281840070967,0.31594176494858617
2023,0.2064,30,130,30,548913,127531,67324,58932,1.010098529970853,0.31605197814043534
2024,0.2065,28,142,28,549055,127389,67352,58904,1.008973830946648,0.31619008765761464
2025,0.2066,49,134,49,549189,127255,67401,58855,1.0079124952477505,0.31623770888184405
2026,0.2067,28,157,28,549346,127098,67429,58827,1.0066689899885946,0.3164017749092376
2027,0.2068,33,125,33,549471,126973,67462,58794,1.0056789380306679,0.31649324153374925
2028,0.2069,46,135,46,549606,126838,67508,58748,1.004609681916107,0.3165540504132855
2029,0.207,39,129,39,549735,126709,67547,58709,1.0035879482955266,0.3166305320950501
2030,0.2071,34,116,34,549851,126593,67581,58675,1.0026691800785705,0.3167033702528229
2031,0.2072,40,137,40,549988,126456,67621,58635,1.0015840831326828,0.3167901194547547
2032,0.2073,32,115,32,550103,126341,67653,58603,1.0006732353313903,0.3168688900423912
2033,0.2074,31,120,31,550223,126221,67684,58572,0.9997227854517805,0.3169600580108554
2034,0.2075,44,124,44,550347,126097,67728,58528,0.9987406539095172,0.3170101557210562
2035,0.2076,37,143,37,550490,125954,67765,58491,0.997608034469649,0.31711892434058936
2036,0.2077,27,132,27,550622,125822,67792,58464,0.9965625396020783,0.3172460197736128
2037,0.2078,32,130,32,550752,125692,67824,58432,0.9955328855658345,0.31735135017705457
2038,0.2079,40,143,40,550895,125549,67864,58392,0.9944002661259663,0.3174496169967544
2039,0.208,41,129,41,551024,125420,67905,58351,0.9933785325053859,0.31752017456508375
2040,0.2081,38,115,38,551139,125305,67943,58313,0.9924676847040933,0.3175777973836988
2041,0.2082,45,157,45,551296,125148,67988,58268,0.9912241794449372,0.3176822087495093
2042,0.2083,32,121,32,551417,125027,68020,58236,0.9902658091496642,0.3177728182993839
2043,0.2084,29,153,29,551570,124874,68049,58207,0.9890539855531618,0.31793031499718705
2044,0.2085,25,118,25,551688,124756,68074,58182,0.988119376504879,0.3180421782243164
2045,0.2086,32,125,32,551813,124631,68106,58150,0.9871293245469522,0.31814028810434347
2046,0.2087,45,150,45,551963,124481,68151,58105,0.9859412621974402,0.3182335995092723
2047,0.2088,35,121,35,552084,124360,68186,58070,0.984982891902167,0.31831387381461385
2048,0.2089,48,142,48,552226,124218,68234,58022,0.9838581928779623,0.31838235294117645
2049,0.209,26,166,26,552392,124052,68260,57996,0.9825434038778356,0.3185753207945157
2050,0.2091,31,137,31,552529,123915,68291,57965,0.9814583069319478,0.31869914229162083
2051,0.2092,35,128,35,552657,123787,68326,57930,0.9804444937270308,0.3187924079750381
2052,0.2093,38,160,38,552817,123627,68364,57892,0.9791772272208845,0.31893080063244067
2053,0.2094,36,132,36,552949,123495,68400,57856,0.9781317323533139,0.31902774178251014
2054,0.2095,30,126,30,553075,123369,68430,57826,0.9771337599797237,0.31913684152432464
2055,0.2096,41,148,41,553223,123221,68471,57785,0.9759615384615384,0.31924356098692863
2056,0.2097,29,140,29,553363,123081,68500,57756,0.9748526802686605,0.31938154249406925
2057,0.2098,36,118,36,553481,122963,68536,57720,0.9739180712203777,0.31945451425978094
2058,0.2099,41,131,41,553612,122832,68577,57679,0.9728804967684704,0.31953177368692215
2059,0.21,38,138,38,553750,122694,68615,57641,0.9717874794069192,0.3196329054260127
2060,0.2101,32,126,32,553876,122568,68647,57609,0.9707895070333291,0.3197355933332223
2061,0.2102,34,109,34,553985,122459,68681,57575,0.969926181726017,0.31980070431140784
2062,0.2103,41,142,41,554127,122317,68722,57534,0.9688014827018122,0.31989813790304195
2063,0.2104,33,142,33,554269,122175,68755,57501,0.9676767836776075,0.3200260468843919
2064,0.2105,42,119,42,554388,122056,68797,57459,0.9667342542136611,0.3200791020249004
2065,0.2106,31,116,31,554504,121940,68828,57428,0.9658154859967051,0.32016859194505154
2066,0.2107,16,112,16,554616,121828,68844,57412,0.9649283994424027,0.3203079669716581
2067,0.2108,33,135,33,554751,121693,68877,57379,0.9638591433278418,0.320424186919228
2068,0.2109,41,108,41,554859,121585,68918,57338,0.9630037384361931,0.3204618746611671
2069,0.211,39,152,39,555011,121433,68957,57299,0.9617998352553542,0.3205861289528456
2070,0.2111,37,132,37,555143,121301,68994,57262,0.9607543403877835,0.32068233620626896
2071,0.2112,29,136,29,555279,121165,69023,57233,0.9596771638575592,0.32081637686521147
2072,0.2113,36,141,36,555420,121024,69059,57197,0.9585603852490179,0.3209329989170749
2073,0.2114,22,139,22,555559,120885,69081,57175,0.9574594474718033,0.32109962933842523
2074,0.2115,38,146,38,555705,120739,69119,57137,0.9563030667849449,0.321218151971036
2075,0.2116,37,116,37,555821,120623,69156,57100,0.9553842985679889,0.32128649640170376
2076,0.2117,30,136,30,555957,120487,69186,57070,0.9543071220377646,0.32141791086805926
2077,0.2118,25,107,25,556064,120380,69211,57045,0.9534596375617792,0.321516133577568
2078,0.2119,23,146,23,556210,120234,69234,57022,0.9523032568749208,0.32169291871643274
2079,0.212,40,115,40,556325,120119,69274,56982,0.9513924090736282,0.32174860672723476
2080,0.2121,42,127,42,556452,119992,69316,56940,0.9503865162843746,0.3218185517599982
2081,0.2122,30,123,30,556575,119869,69346,56910,0.9494123051577746,0.3219273782519417
2082,0.2123,40,126,40,556701,119743,69386,56870,0.9484143327841845,0.32200347652777545
2083,0.2124,32,130,32,556831,119613,69418,56838,0.9473846787479407,0.32211775507081286
2084,0.2125,30,131,30,556962,119482,69448,56808,0.9463471042960334,0.3222417607351523
2085,0.2126,32,146,32,557108,119336,69480,56776,0.945190723609175,0.322385754519851
2086,0.2127,40,100,40,557208,119236,69520,56736,0.9443986820428336,0.32241492964789853
2087,0.2128,32,113,32,557321,119123,69552,56704,0.9435036750728678,0.32249881986270595
2088,0.2129,39,117,39,557438,119006,69591,56665,0.9425769864402483,0.3225632005282602
2089,0.213,40,144,40,557582,118862,69631,56625,0.9414364465847168,0.32267347438841626
2090,0.2131,39,155,39,557737,118707,69670,56586,0.9402087821568876,0.3228080984408961
2091,0.2132,28,139,28,557876,118568,69698,56558,0.9391078443796731,0.3229560430775556
2092,0.2133,40,131,40,558007,118437,69738,56518,0.9380702699277658,0.32304306821754164
2093,0.2134,30,104,30,558111,118333,69768,56488,0.9372465466987707,0.32311907608353685
2094,0.2135,42,122,42,558233,118211,69810,56446,0.9362802559878343,0.323182008164574
2095,0.2136,47,144,47,558377,118067,69857,56399,0.9351397161323026,0.3232664244036087
2096,0.2137,23,121,23,558498,117946,69880,56376,0.9341813458370295,0.3234015213226099
2097,0.2138,28,144,28,558642,117802,69908,56348,0.9330408059814979,0.3235601492965834
2098,0.2139,34,92,34,558734,117710,69942,56314,0.9323121277404638,0.32359904381004917
2099,0.214,31,116,31,558850,117594,69973,56283,0.9313933595235078,0.3236943356510637
2100,0.2141,30,118,30,558968,117476,70003,56253,0.930458750475225,0.32379740860765904
2101,0.2142,29,123,29,559091,117353,70032,56224,0.929484539348625,0.3239138825996532
2102,0.2143,29,132,29,559223,117221,70061,56195,0.9284390444810544,0.3240473774046224
2103,0.2144,42,133,42,559356,117088,70103,56153,0.9273856291978203,0.3241322781558638
2104,0.2145,23,120,23,559476,116968,70126,56130,0.9264351793182106,0.3242671781303077
2105,0.2146,40,129,40,559605,116839,70166,56090,0.9254134456976302,0.3243527690555083
2106,0.2147,34,138,34,559743,116701,70200,56056,0.9243204283360791,0.32447889231695387
2107,0.2148,27,130,27,559873,116571,70227,56029,0.9232907742998353,0.3246176129779838
2108,0.2149,39,123,39,559996,116448,70266,55990,0.9223165631732353,0.32469641262366766
2109,0.215,29,123,29,560119,116325,70295,55961,0.9213423520466354,0.32481455254634733
2110,0.2151,28,111,28,560230,116214,70323,55933,0.9204631859079965,0.32491417219004687
2111,0.2152,46,118,46,560348,116096,70369,55887,0.9195285768597136,0.3249565364018537
2112,0.2153,38,118,38,560466,115978,70407,55849,0.9185939678114308,0.32503040849226256
2113,0.2154,30,143,30,560609,115835,70437,55819,0.9174613483715626,0.3251832174024491
2114,0.2155,42,131,42,560740,115704,70479,55777,0.9164237739196553,0.3252663560394446
2115,0.2156,30,141,30,560881,115563,70509,55747,0.9153069953111139,0.32541591267293213
2116,0.2157,40,130,40,561011,115433,70549,55707,0.9142773412748701,0.3255054341474816
2117,0.2158,36,121,36,561132,115312,70585,55671,0.913318970979597,0.3255937724803051
2118,0.2159,38,133,38,561265,115179,70623,55633,0.9122655556963629,0.32569725780390135
2119,0.216,37,128,37,561393,115051,70660,55596,0.9112517424914459,0.32579535532414866
2120,0.2161,38,115,38,561508,114936,70698,55558,0.9103408946901533,0.32586483981841
2121,0.2162,30,140,30,561648,114796,70728,55528,0.9092320364972754,0.326013949883751
2122,0.2163,34,131,34,561779,114665,70762,55494,0.9081944620453681,0.32613026639789844
2123,0.2164,39,123,39,561902,114542,70801,55455,0.9072202509187682,0.326211639028924
2124,0.2165,38,124,38,562026,114418,70839,55417,0.9062381193765049,0.3262990549651132
2125,0.2166,39,101,39,562127,114317,70878,55378,0.9054381573945001,0.32633843071392793
2126,0.2167,35,137,35,562264,114180,70913,55343,0.9043530604486123,0.32646307580682266
2127,0.2168,32,119,32,562383,114061,70945,55311,0.9034105309846661,0.3265651937746499
2128,0.2169,31,112,31,562495,113949,70976,55280,0.9025234444303637,0.32665796051504176
2129,0.217,30,121,30,562616,113828,71006,55250,0.9015650741350906,0.32677225895740425
2130,0.2171,36,110,36,562726,113718,71042,55214,0.9006938284121151,0.32684156938886655
2131,0.2172,34,106,34,562832,113612,71076,55180,0.8998542643517932,0.3269112280202853
2132,0.2173,35,140,35,562972,113472,71111,55145,0.8987454061589152,0.32704294347545027
2133,0.2174,34,118,34,563090,113354,71145,55111,0.8978107971106324,0.32713620039770874
2134,0.2175,33,114,33,563204,113240,71178,55078,0.8969078697250031,0.3272258463147138
2135,0.2176,22,128,22,563332,113112,71200,55056,0.8958940565200861,0.32738689881547023
2136,0.2177,30,131,30,563463,112981,71230,55026,0.8948564820681789,0.3275220675329004
2137,0.2178,24,115,24,563578,112866,71254,55002,0.8939456342668863,0.32765029666166273
2138,0.2179,30,123,30,563701,112743,71284,54972,0.8929714231402864,0.3277703246579018
2139,0.218,39,122,39,563823,112621,71323,54933,0.8920051324293499,0.3278525132196187
2140,0.2181,32,138,32,563961,112483,71355,54901,0.8909121150677988,0.32799431247909
2141,0.2182,42,138,42,564099,112345,71397,54859,0.8898190977062477,0.3280962177938327
2142,0.2183,17,97,17,564196,112248,71414,54842,0.8890508173868965,0.3282183254533485
2143,0.2184,33,108,33,564304,112140,71447,54809,0.8881954124952478,0.32829786341936756
2144,0.2185,36,115,36,564419,112025,71483,54773,0.8872845646939551,0.32837923716111705
2145,0.2186,35,122,35,564541,111903,71518,54738,0.8863182739830187,0.3284785857021981
2146,0.2187,36,123,36,564664,111780,71554,54702,0.8853440628564188,0.3285760622770029
2147,0.2188,34,107,34,564771,111673,71588,54668,0.8844965783804334,0.32865018245652006
2148,0.2189,32,103,32,564874,111570,71620,54636,0.8836807755671018,0.32872459477997185
2149,0.219,34,109,34,564983,111461,71654,54602,0.8828174502597896,0.3288029241914213
2150,0.2191,42,140,42,565123,111321,71696,54560,0.8817085920669117,0.3289104840216782
2151,0.2192,30,114,30,565237,111207,71726,54530,0.8808056646812825,0.3290152470480339
2152,0.2193,41,112,41,565349,111095,71767,54489,0.8799185781269802,0.329071649434728
2153,0.2194,23,110,23,565459,110985,71790,54466,0.8790473324040046,0.32919716411505523
2154,0.2195,34,122,34,565581,110863,71824,54432,0.878081041693068,0.3293021567500529
2155,0.2196,32,116,32,565697,110747,71856,54400,0.877162273476112,0.32940350112324174
2156,0.2197,36,135,36,565832,110612,71892,54364,0.8760930173615511,0.3295267190379207
2157,0.2198,36,108,36,565940,110504,71928,54328,0.8752376124699024,0.32959619491360903
2158,0.2199,35,116,35,566056,110388,71963,54293,0.8743188442529464,0.329685877545072
2159,0.22,42,114,42,566170,110274,72005,54251,0.8734159168673172,0.32974320012156205
2160,0.2201,29,109,29,566279,110165,72034,54222,0.8725525915600051,0.32984360077135055
2161,0.2202,36,106,36,566385,110059,72070,54186,0.8717130274996832,0.3299095862887759
2162,0.2203,35,114,35,566499,109945,72105,54151,0.870810100114054,0.32999585608424337
2163,0.2204,25,110,25,566609,109835,72130,54126,0.8699388543910784,0.3301150883441794
2164,0.2205,31,109,31,566718,109726,72161,54095,0.8690755290837663,0.3302079708950623
2165,0.2206,43,141,43,566859,109585,72204,54052,0.867958750475225,0.3303164932136375
2166,0.2207,30,109,30,566968,109476,72234,54022,0.8670954251679128,0.3304138276920819
2167,0.2208,33,110,33,567078,109366,72267,53989,0.8662241794449372,0.3305010559823697
2168,0.2209,33,104,33,567182,109262,72300,53956,0.8654004562159422,0.33057628447842763
2169,0.221,33,117,33,567299,109145,72333,53923,0.8644737675833227,0.33067799936222925
2170,0.2211,37,125,37,567424,109020,72370,53886,0.863483715625396,0.3307797134543847
2171,0.2212,30,116,30,567540,108904,72400,53856,0.86256494740844,0.3308921110838044
2172,0.2213,30,110,30,567650,108794,72430,53826,0.8616937016854644,0.3309924978477432
2173,0.2214,40,118,40,567768,108676,72470,53786,0.8607590926371816,0.33106818825325307
2174,0.2215,28,115,28,567883,108561,72498,53758,0.859848244835889,0.33118735329813515
2175,0.2216,35,100,35,567983,108461,72533,53723,0.8590562032695476,0.3312472253736497
2176,0.2217,32,117,32,568100,108344,72565,53691,0.8581295146369281,0.3313543370259512
2177,0.2218,45,124,45,568224,108220,72610,53646,0.8571473830946648,0.33142228757120085
2178,0.2219,40,125,40,568349,108095,72650,53606,0.8561573311367381,0.33151310134136464
2179,0.222,27,126,27,568475,107969,72677,53579,0.8551593587631479,0.3316599400797286
2180,0.2221,40,107,40,568582,107862,72717,53539,0.8543118742871626,0.33171417773124084
2181,0.2222,31,118,31,568700,107744,72748,53508,0.8533772652388797,0.33182844243792325
2182,0.2223,32,112,32,568812,107632,72780,53476,0.8524901786845773,0.331926409613427
2183,0.2224,29,122,29,568934,107510,72809,53447,0.8515238879736409,0.33205763029877544
2184,0.2225,31,98,31,569032,107412,72840,53416,0.8507476872386263,0.3321312209316786
2185,0.2226,43,98,43,569130,107314,72883,53373,0.8499714865036118,0.3321550592144977
2186,0.2227,39,106,39,569236,107208,72922,53334,0.8491319224432898,0.332212131404866
2187,0.2228,33,111,33,569347,107097,72955,53301,0.8482527563046509,0.3323046422025212
2188,0.2229,38,153,38,569500,106944,72993,53263,0.8470409327081485,0.332463625184917
2189,0.223,37,85,37,569585,106859,73030,53226,0.8463676973767583,0.3324858668832183
2190,0.2231,25,96,25,569681,106763,73055,53201,0.8456073374730706,0.3325810807431672
2191,0.2232,42,117,42,569798,106646,73097,53159,0.8446806488404511,0.3326491661712712
2192,0.2233,24,113,24,569911,106533,73121,53135,0.8437856418704853,0.33278427737555427
2193,0.2234,34,120,34,570031,106413,73155,53101,0.8428351919908756,0.33289241069749365
2194,0.2235,35,132,35,570163,106281,73190,53066,0.841789697123305,0.3330216445869706
2195,0.2236,28,120,28,570283,106161,73218,53038,0.8408392472436953,0.33315535901607424
2196,0.2237,27,100,27,570383,106061,73245,53011,0.8400472056773539,0.333251609334138
2197,0.2238,23,113,23,570496,105948,73268,52988,0.8391521987073881,0.33339205718024867
2198,0.2239,28,115,28,570611,105833,73296,52960,0.8382413509060955,0.3335159610310278
2199,0.224,22,113,22,570724,105720,73318,52938,0.8373463439361297,0.3336610823280263
2200,0.2241,37,114,37,570838,105606,73355,52901,0.8364434165505006,0.3337455128164687
2201,0.2242,34,117,34,570955,105489,73389,52867,0.8355167279178811,0.3338490489782515
2202,0.2243,36,101,36,571056,105388,73425,52831,0.8347167659358763,0.33391059228032033
2203,0.2244,35,113,35,571169,105275,73460,52796,0.8338217589659105,0.33400180931353635
2204,0.2245,38,92,38,571261,105183,73498,52758,0.8330930807248764,0.3340361274146675
2205,0.2246,35,123,35,571384,105060,73533,52723,0.8321188695982765,0.33414879930030483
2206,0.2247,26,101,26,571485,104959,73559,52697,0.8313189076162717,0.33425305728928806
2207,0.2248,37,107,37,571592,104852,73596,52660,0.8304714231402864,0.33432373406470617
2208,0.2249,34,102,34,571694,104750,73630,52626,0.8296635407426182,0.3343966043106954
2209,0.225,28,93,28,571787,104657,73658,52598,0.8289269420859207,0.3344758513242822
2210,0.2251,25,108,25,571895,104549,73683,52573,0.828071537194272,0.3345998650730006
2211,0.2252,33,121,33,572016,104428,73716,52540,0.8271131668989988,0.33471790428622394
2212,0.2253,27,98,27,572114,104330,73743,52513,0.8263369661639843,0.3348125195258953
2213,0.2254,27,105,27,572219,104225,73770,52486,0.8255053225193258,0.33492224540715076
2214,0.2255,29,104,29,572323,104121,73799,52457,0.8246815992903308,0.33502152281929776
2215,0.2256,38,115,38,572438,104006,73837,52419,0.8237707514890381,0.33510628096531886
2216,0.2257,33,115,33,572553,103891,73870,52386,0.8228599036877455,0.3352124752842709
2217,0.2258,37,103,37,572656,103788,73907,52349,0.8220441008744139,0.33527607165502094
2218,0.2259,23,101,23,572757,103687,73930,52326,0.8212441388924091,0.33539512732913285
2219,0.226,28,113,28,572870,103574,73958,52298,0.8203491319224433,0.33551888729213714
2220,0.2261,46,108,46,572978,103466,74004,52252,0.8194937270307946,0.3355552986809489
2221,0.2262,37,105,37,573083,103361,74041,52215,0.8186620833861361,0.3356237465933049
2222,0.2263,40,106,40,573189,103255,74081,52175,0.8178225193258142,0.3356816573377083
2223,0.2264,27,112,27,573301,103143,74108,52148,0.8169354327715118,0.33580825675666975
2224,0.2265,32,108,32,573409,103035,74140,52116,0.8160800278798631,0.3359050215596419
2225,0.2266,47,94,47,573503,102941,74187,52069,0.8153355088075022,0.33590736081543127
2226,0.2267,38,102,38,573605,102839,74225,52031,0.814527626409834,0.33596564860851036
2227,0.2268,43,140,43,573745,102699,74268,51988,0.813418768216956,0.3360851267398036
2228,0.2269,22,111,22,573856,102588,74290,51966,0.8125396020783171,0.33623199658371833
2229,0.227,37,119,37,573975,102469,74327,51929,0.8115970726143708,0.3363320768403736
2230,0.2271,23,101,23,574076,102368,74350,51906,0.810797110632366,0.3364533233078808
2231,0.2272,28,106,28,574182,102262,74378,51878,0.8099575465720441,0.33656416244972104
2232,0.2273,40,95,40,574277,102167,74418,51838,0.8092051070840197,0.3365994610564592
2233,0.2274,30,127,30,574404,102040,74448,51808,0.8081992142947662,0.3367479590244917
2234,0.2275,40,94,40,574498,101946,74488,51768,0.8074546952224053,0.3367812951325188
2235,0.2276,28,113,28,574611,101833,74516,51740,0.8065596882524395,0.33690818047443233
2236,0.2277,29,115,29,574726,101718,74545,51711,0.8056488404511469,0.33703537140957707
2237,0.2278,45,121,45,574847,101597,74590,51666,0.8046904701558738,0.3371068033380529
2238,0.2279,35,119,35,574966,101478,74625,51631,0.8037479406919276,0.3372172765807366
2239,0.228,20,101,20,575067,101377,74645,51611,0.8029479787099227,0.3373532564645593
2240,0.2281,32,114,32,575181,101263,74677,51579,0.8020450513242935,0.3374661415056071
2241,0.2282,32,98,32,575279,101165,74709,51547,0.8012688505892789,0.33754387343496256
2242,0.2283,29,114,29,575393,101051,74738,51518,0.8003659232036497,0.337670168907183
2243,0.2284,32,114,32,575507,100937,74770,51486,0.7994629958180205,0.33778366781916114
2244,0.2285,23,120,23,575627,100817,74793,51463,0.7985125459384108,0.337949829261886
2245,0.2286,23,105,23,575732,100712,74816,51440,0.7976809022937523,0.33808296966191703
2246,0.2287,32,118,32,575850,100594,74848,51408,0.7967462932454695,0.338206076235839
2247,0.2288,24,107,24,575957,100487,74872,51384,0.7958988087694843,0.338339775203956
2248,0.2289,26,94,26,576051,100393,74898,51358,0.7951542896971233,0.3384359905371299
2249,0.229,29,107,29,576158,100286,74927,51329,0.7943068052211381,0.3385482966724928
2250,0.2291,36,127,36,576285,100159,74963,51293,0.7933009124318844,0.33867495972321265
2251,0.2292,36,108,36,576393,100051,74999,51257,0.7924455075402357,0.3387593517857615
2252,0.2293,33,106,33,576499,99945,75032,51224,0.7916059434799139,0.33885254251863806
2253,0.2294,38,91,38,576590,99854,75070,51186,0.7908851856545431,0.33889036016949153
2254,0.2295,28,102,28,576692,99752,75098,51158,0.790077303256875,0.33899675303160826
2255,0.2296,37,106,37,576798,99646,75135,51121,0.789237739196553,0.339072874037422
2256,0.2297,37,117,37,576915,99529,75172,51084,0.7883110505639336,0.3391739092906987
2257,0.2298,35,119,35,577034,99410,75207,51049,0.7873685210999873,0.33928844402794117
2258,0.2299,41,102,41,577136,99308,75248,51008,0.7865606387023191,0.3393384603102797
2259,0.23,36,134,36,577270,99174,75284,50972,0.7854993030034216,0.3394829033074474
2260,0.2301,31,111,31,577381,99063,75315,50941,0.7846201368647827,0.33959761073038053
2261,0.2302,23,101,23,577482,98962,75338,50918,0.7838201748827779,0.3397251134240726
2262,0.2303,29,93,29,577575,98869,75367,50889,0.7830835762260804,0.3398082239346145
2263,0.2304,38,101,38,577676,98768,75405,50851,0.7822836142440756,0.33986993630488105
2264,0.2305,31,105,31,577781,98663,75436,50820,0.7814519705994171,0.3399717693650783
2265,0.2306,30,112,30,577893,98551,75466,50790,0.7805648840451147,0.340094146952277
2266,0.2307,35,107,35,578000,98444,75501,50755,0.7797173995691293,0.3401832451960134
2267,0.2308,26,101,26,578101,98343,75527,50729,0.7789174375871246,0.3402986476333584
2268,0.2309,30,111,30,578212,98232,75557,50699,0.7780382714484856,0.34041938884449846
2269,0.231,29,107,29,578319,98125,75586,50670,0.7771907869725003,0.34053563627810074
2270,0.2311,36,96,36,578415,98029,75622,50634,0.7764304270688126,0.3405958442921238
2271,0.2312,31,102,31,578517,97927,75653,50603,0.7756225446711443,0.34069211607082744
2272,0.2313,26,113,26,578630,97814,75679,50577,0.7747275377011785,0.34083603453039607
2273,0.2314,40,113,40,578743,97701,75719,50537,0.7738325307312127,0.340917983243163
2274,0.2315,45,99,45,578842,97602,75764,50492,0.7730484095805348,0.34094561562251
2275,0.2316,23,99,23,578941,97503,75787,50469,0.7722642884298568,0.34107128375638635
2276,0.2317,30,105,30,579046,97398,75817,50439,0.7714326447851984,0.3411798129020475
2277,0.2318,35,91,35,579137,97307,75852,50404,0.7707118869598276,0.34123389591838116
2278,0.2319,31,124,31,579261,97183,75883,50373,0.7697297554175643,0.3413822548727263
2279,0.232,29,88,29,579349,97095,75912,50344,0.7690327588391839,0.3414564667421781
2280,0.2321,28,99,28,579448,96996,75940,50316,0.7682486376885059,0.34156076898012383
2281,0.2322,34,94,34,579542,96902,75974,50282,0.767504118616145,0.3416268072616589
2282,0.2323,34,91,34,579633,96811,76008,50248,0.7667833607907742,0.34168598997681204
2283,0.2324,26,115,26,579748,96696,76034,50222,0.7658725129894817,0.34183694305667106
2284,0.2325,27,87,27,579835,96609,76061,50195,0.7651834368267647,0.34191847633579464
2285,0.2326,37,108,37,579943,96501,76098,50158,0.764328031935116,0.34200424113078637
2286,0.2327,27,87,27,580030,96414,76125,50131,0.7636389557723989,0.34208604865399705
2287,0.2328,28,104,28,580134,96310,76153,50103,0.7628152325434039,0.3422032196594565
2288,0.2329,24,120,24,580254,96190,76177,50079,0.7618647826637942,0.34237603319910576
2289,0.233,41,96,41,580350,96094,76218,50038,0.7611044227601065,0.3424164454055238
2290,0.2331,30,114,30,580464,95980,76248,50008,0.7602014953744772,0.3425487026330931
2291,0.2332,24,108,24,580572,95872,76272,49984,0.7593460904828285,0.3426941641070645
2292,0.2333,28,84,28,580656,95788,76300,49956,0.7586807755671018,0.3427653968602481
2293,0.2334,33,119,33,580775,95669,76333,49923,0.7577382461031555,0.34289658772460024
2294,0.2335,22,107,22,580882,95562,76355,49901,0.7568907616271702,0.343049435251576
2295,0.2336,34,99,34,580981,95463,76389,49867,0.7561066404764922,0.3431294295740728
2296,0.2337,26,103,26,581084,95360,76415,49841,0.7552908376631605,0.34325521174096596
2297,0.2338,19,94,19,581178,95266,76434,49822,0.7545463185907997,0.34339159682399645
2298,0.2339,30,92,30,581270,95174,76464,49792,0.7538176403497655,0.3434736420953879
2299,0.234,36,102,36,581372,95072,76500,49756,0.7530097579520973,0.34355235175518545
2300,0.2341,36,103,36,581475,94969,76536,49720,0.7521939551387656,0.3436335865200534
2301,0.2342,34,97,34,581572,94872,76570,49686,0.7514256748194145,0.3437097912256672
2302,0.2343,33,91,33,581663,94781,76603,49653,0.7507049169940438,0.34377639613941313
2303,0.2344,25,123,25,581786,94658,76628,49628,0.749730705867444,0.3439557545430603
2304,0.2345,21,115,21,581901,94543,76649,49607,0.7488198580661514,0.34413458203260494
2305,0.2346,44,108,44,582009,94435,76693,49563,0.7479644531745026,0.34419228044833955
2306,0.2347,31,98,31,582107,94337,76724,49532,0.747188252439488,0.34428542632533765
2307,0.2348,32,97,32,582204,94240,76756,49500,0.7464199721201369,0.34437178238486155
2308,0.2349,27,104,27,582308,94136,76783,49473,0.7455962488911418,0.3444979075127603
2309,0.235,21,95,21,582403,94041,76804,49452,0.7448438094031175,0.3446300516401497
2310,0.2351,32,79,32,582482,93962,76836,49420,0.7442180965657078,0.3446736689403133
2311,0.2352,30,105,30,582587,93857,76866,49390,0.7433864529210493,0.3447890706262609
2312,0.2353,33,96,33,582683,93761,76899,49357,0.7426260930173616,0.3448692687153258
2313,0.2354,25,87,25,582770,93674,76924,49332,0.7419370168546445,0.34496454694208634
2314,0.2355,24,94,24,582864,93580,76948,49308,0.7411924977822836,0.3450814624041207
2315,0.2356,26,113,26,582977,93467,76974,49282,0.7402974908123179,0.34523534315476817
2316,0.2357,37,111,37,583088,93356,77011,49245,0.7394183246736789,0.3453341841922567
2317,0.2358,18,92,18,583180,93264,77029,49227,0.7386896464326448,0.34547445101795904
2318,0.2359,35,94,35,583274,93170,77064,49192,0.7379451273602838,0.3455416473497141
2319,0.236,27,99,27,583373,93071,77091,49165,0.7371610062096059,0.3456579206389381
2320,0.2361,35,101,35,583474,92970,77126,49130,0.7363610442276011,0.34574243490499645
2321,0.2362,32,103,32,583577,92867,77158,49098,0.7355452414142695,0.3458458070651217
2322,0.2363,31,115,31,583692,92752,77189,49067,0.7346343936129768,0.34598326035298516
2323,0.2364,40,78,40,583770,92674,77229,49027,0.7340166011912305,0.3459890897029661
2324,0.2365,32,111,32,583881,92563,77261,48995,0.7331374350525915,0.3461125475070289
2325,0.2366,24,100,24,583981,92463,77285,48971,0.7323453934862502,0.3462463056973571
2326,0.2367,19,101,19,584082,92362,77304,48952,0.7315454315042453,0.34640587627552827
2327,0.2368,25,99,25,584181,92263,77329,48927,0.7307613103535674,0.34653304058361073
2328,0.2369,32,98,32,584279,92165,77361,48895,0.7299851096185528,0.3466255494115979
2329,0.237,24,93,24,584372,92072,77385,48871,0.7292485109618553,0.34674300958543525
2330,0.2371,41,97,41,584469,91975,77426,48830,0.7284802306425041,0.34679166222790386
2331,0.2372,30,108,30,584577,91867,77456,48800,0.7276248257508554,0.34691860919760853
2332,0.2373,40,95,40,584672,91772,77496,48760,0.7268723862628311,0.34696723877835656
2333,0.2374,25,110,25,584782,91662,77521,48735,0.7260011405398555,0.3471228017692686
2334,0.2375,21,107,21,584889,91555,77542,48714,0.7251536560638703,0.34728985021637
2335,0.2376,33,84,33,584973,91471,77575,48681,0.7244883411481434,0.3473443118899481
2336,0.2377,42,108,42,585081,91363,77617,48639,0.7236329362564947,0.3474164654790646
2337,0.2378,30,97,30,585178,91266,77647,48609,0.7228646559371436,0.34751742627345844
2338,0.2379,27,71,27,585249,91195,77674,48582,0.7223023064250412,0.3475679117451369
2339,0.238,26,97,26,585346,91098,77700,48556,0.7215340261056901,0.3476878571326278
2340,0.2381,40,106,40,585452,90992,77740,48516,0.7206944620453681,0.34776500272385813
2341,0.2382,31,102,31,585554,90890,77771,48485,0.7198865796476999,0.3478744394618834
2342,0.2383,31,84,31,585638,90806,77802,48454,0.7192212647319731,0.3479391067068792
2343,0.2384,33,77,33,585715,90729,77835,48421,0.7186113927258903,0.3479770032339202
2344,0.2385,40,108,40,585823,90621,77875,48381,0.7177559878342415,0.34805974014762375
2345,0.2386,24,94,24,585917,90527,77899,48357,0.7170114687618806,0.3481826560294922
2346,0.2387,29,96,29,586013,90431,77928,48328,0.7162511088581929,0.34828731830007426
2347,0.2388,19,101,19,586114,90330,77947,48309,0.715451146876188,0.34845173436046134
2348,0.2389,19,101,19,586215,90229,77966,48290,0.7146511848941832,0.34861643529046554
2349,0.239,28,94,28,586309,90135,77994,48262,0.7139066658218224,0.34872143182294413
2350,0.2391,20,97,20,586406,90038,78014,48242,0.7131383855024712,0.3488718542088516
2351,0.2392,33,92,33,586498,89946,78047,48209,0.712409707261437,0.34894864463826863
2352,0.2393,35,102,35,586600,89844,78082,48174,0.7116018248637689,0.3490414293787767
2353,0.2394,24,92,24,586692,89752,78106,48150,0.7108731466227347,0.3491609983901611
2354,0.2395,36,100,36,586792,89652,78142,48114,0.7100811050563933,0.3492443708897696
2355,0.2396,23,103,23,586895,89549,78165,48091,0.7092653022430617,0.3493969776227841
2356,0.2397,27,90,27,586985,89459,78192,48064,0.7085524648333544,0.3494979021690917
2357,0.2398,25,106,25,587091,89353,78217,48039,0.7077129007730326,0.3496491789914988
2358,0.2399,12,69,12,587160,89284,78229,48027,0.707166392092257,0.3497680448034025
2359,0.24,28,87,28,587247,89197,78257,47999,0.70647731592954,0.3498571386920902
2360,0.2401,32,90,32,587337,89107,78289,47967,0.7057644785198327,0.3499350715671827
2361,0.2402,33,85,33,587422,89022,78322,47934,0.7050912431884425,0.34999561903092963
2362,0.2403,36,101,36,587523,88921,78358,47898,0.7042912812064377,0.35008295631454694
2363,0.2404,25,92,25,587615,88829,78383,47873,0.7035626029654036,0.3501997044666501
2364,0.2405,24,91,24,587706,88738,78407,47849,0.7028418451400329,0.3503188443995402
2365,0.2406,37,109,37,587815,88629,78444,47812,0.7019785198327209,0.350422526953042
2366,0.2407,21,79,21,587894,88550,78465,47791,0.7013528069953111,0.3505255205697479
2367,0.2408,32,74,32,587968,88476,78497,47759,0.7007666962362185,0.35056336477410355
2368,0.2409,27,84,27,588052,88392,78524,47732,0.7001013813204917,0.3506508771414299
2369,0.241,23,85,23,588137,88307,78547,47709,0.6994281459891015,0.35076020468180213
2370,0.2411,24,96,24,588233,88211,78571,47685,0.6986677860854138,0.3508933301936775
2371,0.2412,31,85,31,588318,88126,78602,47654,0.6979945507540236,0.35096479599351893
2372,0.2413,27,87,27,588405,88039,78629,47627,0.6973054745913065,0.3510606931729394
2373,0.2414,24,99,24,588504,87940,78653,47603,0.6965213534406286,0.3512022015153863
2374,0.2415,30,96,30,588600,87844,78683,47573,0.6957609935369408,0.35130744293552507
2375,0.2416,23,103,23,588703,87741,78706,47550,0.6949451907236092,0.35146462070647716
2376,0.2417,18,90,18,588793,87651,78724,47532,0.6942323533139019,0.3516122589378842
2377,0.2418,28,72,28,588865,87579,78752,47504,0.6936620833861361,0.3516652724621159
2378,0.2419,26,79,26,588944,87500,78778,47478,0.6930363705487264,0.3517462104935619
2379,0.242,26,100,26,589044,87400,78804,47452,0.692244328982385,0.3518820632990241
2380,0.2421,17,107,17,589151,87293,78821,47435,0.6913968445063997,0.35207974585832197
2381,0.2422,24,88,24,589239,87205,78845,47411,0.6906998479280193,0.352194389968503
2382,0.2423,28,95,28,589334,87110,78873,47383,0.6899474084399949,0.35230829857315993
2383,0.2424,32,85,32,589419,87025,78905,47351,0.6892741731086047,0.35237691254390663
2384,0.2425,30,104,30,589523,86921,78935,47321,0.6884504498796097,0.3525051772172643
2385,0.2426,26,93,26,589616,86828,78961,47295,0.6877138512229122,0.3526240838633195
2386,0.2427,32,82,32,589698,86746,78993,47263,0.6870643771385122,0.35268526740741296
2387,0.2428,22,94,22,589792,86652,79015,47241,0.6863198580661514,0.35282651072124754
2388,0.2429,23,78,23,589870,86574,79038,47218,0.6857020656444051,0.3529209519253767
2389,0.243,31,85,31,589955,86489,79069,47187,0.6850288303130149,0.3529953020736707
2390,0.2431,29,99,29,590054,86390,79098,47158,0.6842447091623368,0.3531164824632342
2391,0.2432,29,79,29,590133,86311,79127,47129,0.6836189963249272,0.3531849520383693
2392,0.2433,35,79,35,590212,86232,79162,47094,0.6829932834875174,0.3532244273435039
2393,0.2434,32,77,32,590289,86155,79194,47062,0.6823834114814346,0.35327323089395496
2394,0.2435,31,71,31,590360,86084,79225,47031,0.6818210619693321,0.35331104683919917
2395,0.2436,20,89,20,590449,85995,79245,47011,0.6811161449752883,0.35345022029081397
2396,0.2437,29,83,29,590532,85912,79274,46982,0.680458750475225,0.3535298809577558
2397,0.2438,26,101,26,590633,85811,79300,46956,0.6796587884932201,0.3536722227661994
2398,0.2439,41,93,41,590726,85718,79341,46915,0.6789221898365226,0.3537204164876011
2399,0.244,39,86,39,590812,85632,79380,46876,0.678241034089469,0.3537597729948381
2400,0.2441,30,78,30,590890,85554,79410,46846,0.6776232416677227,0.35382175226586104
2401,0.2442,25,94,25,590984,85460,79435,46821,0.6768787225953619,0.3539510587310347
2402,0.2443,32,84,32,591068,85376,79467,46789,0.676213407679635,0.3540195967162259
2403,0.2444,30,89,30,591157,85287,79497,46759,0.6755084906855912,0.3541114460112385
2404,0.2445,27,85,27,591242,85202,79524,46732,0.674835255354201,0.35420740673366985
2405,0.2446,24,91,24,591333,85111,79548,46708,0.6741144975288303,0.3543343524074678
2406,0.2447,32,95,32,591428,85016,79580,46676,0.673362058040806,0.3544330711053063
2407,0.2448,25,85,25,591513,84931,79605,46651,0.6726888227094158,0.35453937468650726
2408,0.2449,36,102,36,591615,84829,79641,46615,0.6718809403117476,0.3546377164419829
2409,0.245,27,83,27,591698,84746,79668,46588,0.6712235458116842,0.3547291638113512
2410,0.2451,29,91,29,591789,84655,79697,46559,0.6705027879863136,0.3548325635983965
2411,0.2452,23,74,23,591863,84581,79720,46536,0.6699166772272209,0.3549196519139395
2412,0.2453,27,87,27,591950,84494,79747,46509,0.6692276010645039,0.3550224040670824
2413,0.2454,28,68,28,592018,84426,79775,46481,0.6686890127993917,0.35506886568327134
2414,0.2455,23,99,23,592117,84327,79798,46458,0.6679048916487137,0.35522422296134876
2415,0.2456,30,85,30,592202,84242,79828,46428,0.6672316563173235,0.3553072625698324
2416,0.2457,30,84,30,592286,84158,79858,46398,0.6665663414015968,0.35538772633965504
2417,0.2458,18,77,18,592363,84081,79876,46380,0.6659564693955139,0.3555085427829006
2418,0.2459,20,86,20,592449,83995,79896,46360,0.6652753136484603,0.3556442023704499
2419,0.246,33,104,33,592553,83891,79929,46327,0.6644515904194652,0.3557649480102597
2420,0.2461,24,87,24,592640,83804,79953,46303,0.6637625142567481,0.3558840031666244
2421,0.2462,20,80,20,592720,83724,79973,46283,0.6631288810036751,0.3560039074819048
2422,0.2463,28,76,28,592796,83648,80001,46255,0.6625269294132556,0.3560733778280717
2423,0.2464,28,80,28,592876,83568,80029,46227,0.6618932961601824,0.35615393505142723
2424,0.2465,39,86,39,592962,83482,80068,46188,0.6612121404131289,0.356196498804658
2425,0.2466,28,88,28,593050,83394,80096,46160,0.6605151438347484,0.35629930376522534
2426,0.2467,23,82,23,593132,83312,80119,46137,0.6598656697503485,0.3564106327588471
2427,0.2468,32,82,32,593214,83230,80151,46105,0.6592161956659486,0.35647736498241
2428,0.2469,25,88,25,593302,83142,80176,46080,0.6585191990875681,0.3565956261317732
2429,0.247,26,98,26,593400,83044,80202,46054,0.6577429983525536,0.3567367426296302
2430,0.2471,27,97,27,593497,82947,80229,46027,0.6569747180332024,0.3568703769752043
2431,0.2472,28,87,28,593584,82860,80257,45999,0.6562856418704853,0.35697157358042514
2432,0.2473,35,88,35,593672,82772,80292,45964,0.6555886452921049,0.35704076559781256
2433,0.2474,31,89,31,593761,82683,80323,45933,0.6548837282980611,0.35713286060832244
2434,0.2475,24,83,24,593844,82600,80347,45909,0.6542263337979978,0.35724346154744024
2435,0.2476,42,98,42,593942,82502,80389,45867,0.6534501330629832,0.35730589160934495
2436,0.2477,28,99,28,594041,82403,80417,45839,0.6526660119123051,0.3574413998534022
2437,0.2478,40,81,40,594122,82322,80457,45799,0.6520244582435686,0.3574667696942734
2438,0.2479,23,73,23,594195,82249,80480,45776,0.6514462679001394,0.3575551650068346
2439,0.248,18,77,18,594272,82172,80498,45758,0.6508363958940565,0.3576799812397405
2440,0.2481,19,90,19,594362,82082,80517,45739,0.6501235584843492,0.35783634926968183
2441,0.2482,33,91,33,594453,81991,80550,45706,0.6494028006589786,0.3579254015364496
2442,0.2483,27,84,27,594537,81907,80577,45679,0.6487374857432519,0.3580251751759597
2443,0.2484,36,98,36,594635,81809,80613,45643,0.6479612850082372,0.3581191350469196
2444,0.2485,19,96,19,594731,81713,80632,45624,0.6472009251045495,0.35829334757376097
2445,0.2486,27,94,27,594825,81619,80659,45597,0.6464564060321886,0.35842189661677776
2446,0.2487,26,76,26,594901,81543,80685,45571,0.6458544544417691,0.3585049640480199
2447,0.2488,28,80,28,594981,81463,80713,45543,0.645220821188696,0.3585893579830874
2448,0.2489,24,76,24,595057,81387,80737,45519,0.6446188695982765,0.35868280459552737
2449,0.249,31,97,31,595154,81290,80768,45488,0.6438505892789254,0.3588004227862878
2450,0.2491,24,89,24,595243,81201,80792,45464,0.6431456722848815,0.35893103856629693
2451,0.2492,34,103,34,595346,81098,80826,45430,0.6423298694715499,0.35905096105209916
2452,0.2493,23,80,23,595426,81018,80849,45407,0.6416962362184767,0.35916155823610835
2453,0.2494,29,83,29,595509,80935,80878,45378,0.6410388417184134,0.35925043344707197
2454,0.2495,20,73,20,595582,80862,80898,45358,0.6404606513749842,0.35935667881476785
2455,0.2496,30,78,30,595660,80784,80928,45328,0.6398428589532379,0.35942654148693226
2456,0.2497,18,75,18,595735,80709,80946,45310,0.6392488277784818,0.3595489569033241
2457,0.2498,21,74,21,595809,80635,80967,45289,0.6386627170193891,0.359653441758521
2458,0.2499,29,70,29,595879,80565,80996,45260,0.6381082879229502,0.35970594079078083
2459,0.25,32,80,32,595959,80485,81028,45228,0.6374746546698771,0.35977186130312694
2460,0.2501,24,83,24,596042,80402,81052,45204,0.6368172601698137,0.3598872665318536
2461,0.2502,17,96,17,596138,80306,81069,45187,0.6360569002661259,0.36007586080498516
2462,0.2503,33,74,33,596212,80232,81102,45154,0.6354707895070333,0.36011994959564864
2463,0.2504,28,82,28,596294,80150,81130,45126,0.6348213154226334,0.3602126504677672
2464,0.2505,26,87,26,596381,80063,81156,45100,0.6341322392599164,0.3603301295111175
2465,0.2506,20,65,20,596446,79998,81176,45080,0.6336174122417945,0.36041510097699037
2466,0.2507,25,73,25,596519,79925,81201,45055,0.6330392218983653,0.3604976796287406
2467,0.2508,26,88,26,596607,79837,81227,45029,0.6323422253199847,0.36061858312110584
2468,0.2509,27,81,27,596688,79756,81254,45002,0.6317006716512482,0.36071434296798605
2469,0.251,21,78,21,596766,79678,81275,44981,0.631082879229502,0.36083235065258024
2470,0.2511,20,78,20,596844,79600,81295,44961,0.6304650868077557,0.3609556763352895
2471,0.2512,27,81,27,596925,79519,81322,44934,0.6298235331390192,0.3610519633918025
2472,0.2513,26,77,26,597002,79442,81348,44908,0.6292136611329363,0.36114193807800565
2473,0.2514,30,88,30,597090,79354,81378,44878,0.6285166645545558,0.361243479940756
2474,0.2515,24,85,24,597175,79269,81402,44854,0.6278434292231656,0.3613673533511114
2475,0.2516,32,83,32,597258,79186,81434,44822,0.6271860347231023,0.3614444229404555
2476,0.2517,26,94,26,597352,79092,81460,44796,0.6264415156507414,0.36158465710964743
2477,0.2518,35,81,35,597433,79011,81495,44761,0.6257999619820048,0.36164075881459457
2478,0.2519,34,81,34,597514,78930,81529,44727,0.6251584083132683,0.3617021276595745
2479,0.252,25,83,25,597597,78847,81554,44702,0.6245010138132049,0.3618159596597301
2480,0.2521,29,89,29,597686,78758,81583,44673,0.623796096819161,0.3619269065307743
2481,0.2522,37,73,37,597759,78685,81620,44636,0.6232179064757318,0.361949708484362
2482,0.2523,27,84,27,597843,78601,81647,44609,0.6225525915600051,0.3620566512458404
2483,0.2524,27,71,27,597914,78530,81674,44582,0.6219902420479027,0.36212554421989734
2484,0.2525,22,77,22,597991,78453,81696,44560,0.6213803700418198,0.36223813743262906
2485,0.2526,19,84,19,598075,78369,81715,44541,0.620715055126093,0.3623871125213571
2486,0.2527,28,59,28,598134,78310,81743,44513,0.6202477506019516,0.3624158341678676
2487,0.2528,20,88,20,598222,78222,81763,44493,0.6195507540235712,0.36257181273682926
2488,0.2529,23,61,23,598283,78161,81786,44470,0.619067608668103,0.3626326132870155
2489,0.253,28,86,28,598369,78075,81814,44442,0.6183864529210493,0.36274149709836184
2490,0.2531,31,68,31,598437,78007,81845,44411,0.6178478646559371,0.3627816170824552
2491,0.2532,21,72,21,598509,77935,81866,44390,0.6172775947281713,0.36288575516043325
2492,0.2533,19,79,19,598588,77856,81885,44371,0.6166518818907616,0.36302126371423665
2493,0.2534,18,70,18,598658,77786,81903,44353,0.6160974527943226,0.3631354440432622
2494,0.2535,28,84,28,598742,77702,81931,44325,0.6154321378785959,0.3632392831094758
2495,0.2536,24,86,24,598828,77616,81955,44301,0.6147509821315422,0.36337016166736386
2496,0.2537,32,66,32,598894,77550,81987,44269,0.6142282346977569,0.3633997980610578
2497,0.2538,31,84,31,598978,77466,82018,44238,0.6135629197820301,0.3634884638138434
2498,0.2539,31,84,31,599062,77382,82049,44207,0.6128976048663034,0.36357729728840604
2499,0.254,28,76,28,599138,77306,82077,44179,0.6122956532758839,0.3636580647816603
2500,0.2541,34,92,34,599230,77214,82111,44145,0.6115669750348498,0.36375546931006353
2501,0.2542,26,66,26,599296,77148,82137,44119,0.6110442276010645,0.36381703183883496
2502,0.2543,29,93,29,599389,77055,82166,44090,0.610307628944367,0.3639440340088324
2503,0.2544,27,76,27,599465,76979,82193,44063,0.6097056773539475,0.3640306670411923
2504,0.2545,26,66,26,599531,76913,82219,44037,0.6091829299201622,0.36409260024803636
2505,0.2546,20,86,20,599617,76827,82239,44017,0.6085017741731086,0.36424646651881765
2506,0.2547,28,77,28,599694,76750,82267,43989,0.6078919021670257,0.36433132624918213
2507,0.2548,20,90,20,599784,76660,82287,43969,0.6071790647573184,0.3644977575873132
2508,0.2549,25,82,25,599866,76578,82312,43944,0.6065295906729186,0.3646139294070792
2509,0.255,34,88,34,599954,76490,82346,43910,0.605832594094538,0.36470099667774086
2510,0.2551,17,81,17,600035,76409,82363,43893,0.6051910404258015,0.36485677711093745
2511,0.2552,31,82,31,600117,76327,82394,43862,0.6045415663414015,0.3649418832006257
2512,0.2553,23,72,23,600189,76255,82417,43839,0.6039712964136358,0.36503905274201875
2513,0.2554,27,86,27,600275,76169,82444,43812,0.6032901406665822,0.3651578166543036
2514,0.2555,22,75,22,600350,76094,82466,43790,0.6026961094918262,0.3652697607687431
2515,0.2556,21,76,21,600426,76018,82487,43769,0.6020941579014066,0.36539023433260703
2516,0.2557,24,85,24,600511,75933,82511,43745,0.6014209225700164,0.3655224853356507
2517,0.2558,28,74,28,600585,75859,82539,43717,0.6008348118109238,0.36560012042550344
2518,0.2559,31,87,31,600672,75772,82570,43686,0.6001457356482068,0.36570175291734336
2519,0.256,33,79,33,600751,75693,82603,43653,0.5995200228107971,0.3657684379870293
2520,0.2561,19,72,19,600823,75621,82622,43634,0.5989497528830313,0.36588822271602867
2521,0.2562,15,69,15,600892,75552,82637,43619,0.5984032442022558,0.3660202566060535
2522,0.2563,32,70,32,600962,75482,82669,43587,0.5978488151058168,0.36606505471617296
2523,0.2564,26,61,26,601023,75421,82695,43561,0.5973656697503485,0.3661142021482241
2524,0.2565,17,66,17,601089,75355,82712,43544,0.5968429223165632,0.36622679753404147
2525,0.2566,35,77,35,601166,75278,82747,43509,0.5962330503104802,0.36627745460361827
2526,0.2567,20,94,20,601260,75184,82767,43489,0.5954885312381194,0.3664607787786607
2527,0.2568,22,68,22,601328,75116,82789,43467,0.5949499429730072,0.3665533845492187
2528,0.2569,25,64,25,601392,75052,82814,43442,0.5944430363705487,0.3666177190406265
2529,0.257,19,63,19,601455,74989,82833,43423,0.5939440501837536,0.36671114414079653
2530,0.2571,32,62,32,601517,74927,82865,43391,0.593452984412622,0.3667320272486012
2531,0.2572,27,88,27,601605,74839,82892,43364,0.5927559878342415,0.36686040117425106
2532,0.2573,31,73,31,601678,74766,82923,43333,0.5921777974908123,0.36692097308190585
2533,0.2574,28,76,28,601754,74690,82951,43305,0.5915758459003928,0.36700707657104115
2534,0.2575,33,77,33,601831,74613,82984,43272,0.5909659738943099,0.3670696017305001
2535,0.2576,29,84,29,601915,74529,83013,43243,0.5903006589785832,0.3671755595557518
2536,0.2577,30,84,30,601999,74445,83043,43213,0.5896353440628564,0.3672763433000731
2537,0.2578,29,67,29,602066,74378,83072,43184,0.5891046762134077,0.36732957928582366
2538,0.2579,34,79,34,602145,74299,83106,43150,0.5884789633759979,0.36739350696898226
2539,0.258,20,74,20,602219,74225,83126,43130,0.5878928526169054,0.3675173618507946
2540,0.2581,29,78,29,602297,74147,83155,43101,0.5872750601951591,0.36760541757641924
2541,0.2582,15,91,15,602388,74056,83170,43086,0.5865543023697883,0.3678100083659149
2542,0.2583,26,62,26,602450,73994,83196,43060,0.5860632365986567,0.3678644044628975
2543,0.2584,31,68,31,602518,73926,83227,43029,0.5855246483335446,0.3679107348980377
2544,0.2585,26,58,26,602576,73868,83253,43003,0.5850652642250666,0.36795269998545405
2545,0.2586,26,77,26,602653,73791,83279,42977,0.5844553922189837,0.3680546040010962
2546,0.2587,29,78,29,602731,73713,83308,42948,0.5838375997972374,0.3681435955460694
2547,0.2588,32,80,32,602811,73633,83340,42916,0.5832039665441643,0.36822280757449655
2548,0.2589,22,74,22,602885,73559,83362,42894,0.5826178557850716,0.36833744085596765
2549,0.259,28,68,28,602953,73491,83390,42866,0.5820792675199594,0.3684006978522994
2550,0.2591,27,87,27,603040,73404,83417,42839,0.5813901913572425,0.3685297179184983
2551,0.2592,29,70,29,603110,73334,83446,42810,0.5808357622608035,0.3685941589750654
2552,0.2593,31,65,31,603175,73269,83477,42779,0.5803209352426816,0.36863194540190264
2553,0.2594,24,79,24,603254,73190,83501,42755,0.5796952224052718,0.36875242571909095
2554,0.2595,22,65,22,603319,73125,83523,42733,0.5791803953871499,0.3688394413851439
2555,0.2596,24,76,24,603395,73049,83547,42709,0.5785784437967304,0.36895074206534323
2556,0.2597,25,62,25,603457,72987,83572,42684,0.5780873780255987,0.36901211193816946
2557,0.2598,25,72,25,603529,72915,83597,42659,0.577517108097833,0.36910550815927456
2558,0.2599,25,81,25,603610,72834,83622,42634,0.5768755544290964,0.3692278380157273
2559,0.26,26,82,26,603692,72752,83648,42608,0.5762260803446965,0.3693481276005548
2560,0.2601,25,93,25,603785,72659,83673,42583,0.575489481687999,0.3695093802606689
2561,0.2602,25,64,25,603849,72595,83698,42558,0.5749825750855405,0.369577865969623
2562,0.2603,28,75,28,603924,72520,83726,42530,0.5743885439107844,0.36966536288570184
2563,0.2604,27,80,27,604004,72440,83753,42503,0.5737549106577113,0.3697745839242059
2564,0.2605,25,72,25,604076,72368,83778,42478,0.5731846407299455,0.36986921616773766
2565,0.2606,21,86,21,604162,72282,83799,42457,0.5725034849828919,0.37003111409372574
2566,0.2607,26,85,26,604247,72197,83825,42431,0.5718302496515018,0.37016261297414244
2567,0.2608,30,65,30,604312,72132,83855,42401,0.5713154226333798,0.37020771306086453
2568,0.2609,32,79,32,604391,72053,83887,42369,0.5706897097959701,0.37028718253482723
2569,0.261,31,62,31,604453,71991,83918,42338,0.5701986440248384,0.37031724234446206
2570,0.2611,28,74,28,604527,71917,83946,42310,0.5696125332657458,0.37040279443564134
2571,0.2612,22,84,22,604611,71833,83968,42288,0.568947218350019,0.37055406104047456
2572,0.2613,33,64,33,604675,71769,84001,42255,0.5684403117475605,0.3705798779204378
2573,0.2614,30,63,30,604738,71706,84031,42225,0.5679413255607654,0.37061905890407354
2574,0.2615,22,96,22,604834,71610,84053,42203,0.5671809656570777,0.37081001291592347
2575,0.2616,28,60,28,604894,71550,84081,42175,0.5667057407172729,0.370850736425588
2576,0.2617,36,66,36,604960,71484,84117,42139,0.5661829932834875,0.370866813937319
2577,0.2618,26,76,26,605036,71408,84143,42113,0.565581041693068,0.3709710097691176
2578,0.2619,26,63,26,605099,71345,84169,42087,0.565082055506273,0.37103286550532477
2579,0.262,22,83,22,605182,71262,84191,42065,0.5644246610062096,0.37118250725775853
2580,0.2621,26,67,26,605249,71195,84217,42039,0.5638939931567609,0.37125774943921436
2581,0.2622,31,70,31,605319,71125,84248,42008,0.5633395640603219,0.3713151777111895
2582,0.2623,23,54,23,605373,71071,84271,41985,0.5629118616144976,0.3713646334559864
2583,0.2624,22,75,22,605448,70996,84293,41963,0.5623178304397415,0.3714887702617764
2584,0.2625,34,72,34,605520,70924,84327,41929,0.5617475605119757,0.37153642348896354
2585,0.2626,32,58,32,605578,70866,84359,41897,0.5612881764034977,0.3715491783652439
2586,0.2627,23,85,23,605663,70781,84382,41874,0.5606149410721074,0.3717012116639297
2587,0.2628,27,60,27,605723,70721,84409,41847,0.5601397161323026,0.3717486319380286
2588,0.2629,25,75,25,605798,70646,84434,41822,0.5595456849575465,0.3718568837358182
2589,0.263,24,88,24,605886,70558,84458,41798,0.5588486883791661,0.37201395564099826
2590,0.2631,19,81,19,605967,70477,84477,41779,0.5582071347104296,0.37217609749144814
2591,0.2632,29,64,29,606031,70413,84506,41750,0.5577002281079712,0.37222613517826736
2592,0.2633,23,73,23,606104,70340,84529,41727,0.5571220377645418,0.37233976103580896
2593,0.2634,25,55,25,606159,70285,84554,41702,0.5566864149030541,0.37238250868404366
2594,0.2635,22,68,22,606227,70217,84576,41680,0.5561478266379419,0.3724854106901883
2595,0.2636,31,67,31,606294,70150,84607,41649,0.5556171587884933,0.37253463805579656
2596,0.2637,22,65,22,606359,70085,84629,41627,0.5551023317703713,0.37262782870237754
2597,0.2638,22,59,22,606418,70026,84651,41605,0.5546350272462299,0.37270113140615063
2598,0.2639,27,71,27,606489,69955,84678,41578,0.5540726777341275,0.37278652954730884
2599,0.264,28,89,28,606578,69866,84706,41550,0.5533677607400836,0.37292668916493144
2600,0.2641,31,71,31,606649,69795,84737,41519,0.5528054112279812,0.37298992040533985
2601,0.2642,23,80,23,606729,69715,84760,41496,0.5521717779749081,0.37312855742687323
2602,0.2643,25,82,25,606811,69633,84785,41471,0.5515223038905082,0.3732628888248848
2603,0.2644,23,78,23,606889,69555,84808,41448,0.5509045114687618,0.37339531364017187
2604,0.2645,30,68,30,606957,69487,84838,41418,0.5503659232036497,0.37345475857716065
2605,0.2646,27,61,27,607018,69426,84865,41391,0.5498827778481815,0.37350767481523595
2606,0.2647,34,79,34,607097,69347,84899,41357,0.5492570650107718,0.37358180372886257
2607,0.2648,25,49,25,607146,69298,84924,41332,0.5488689646432645,0.3736057127361475
2608,0.2649,28,75,28,607221,69223,84952,41304,0.5482749334685084,0.3737005437585386
2609,0.265,14,80,14,607301,69143,84966,41290,0.5476413002154353,0.37389186203399344
2610,0.2651,20,76,20,607377,69067,84986,41270,0.5470393486250158,0.374035908172236
2611,0.2652,18,71,18,607448,68996,85004,41252,0.5464769991129135,0.3741745882011465
2612,0.2653,24,63,24,607511,68933,85028,41228,0.5459780129261184,0.37425223082579134
2613,0.2654,28,57,28,607568,68876,85056,41200,0.5455265492333038,0.37428685635379194
2614,0.2655,26,74,26,607642,68802,85082,41174,0.5449404384742111,0.374390776169346
2615,0.2656,24,65,24,607707,68737,85106,41150,0.5444256114560893,0.37447559765941374
2616,0.2657,22,61,22,607768,68676,85128,41128,0.5439424661006209,0.3745583038869258
2617,0.2658,21,69,21,607837,68607,85149,41107,0.5433959574198454,0.3746741527972729
2618,0.2659,19,63,19,607900,68544,85168,41088,0.5428969712330504,0.37478108581436076
2619,0.266,27,74,27,607974,68470,85195,41061,0.5423108604739577,0.3748801709105185
2620,0.2661,29,62,29,608036,68408,85224,41032,0.541819794702826,0.37492690058479533
2621,0.2662,30,59,30,608095,68349,85254,41002,0.5413524901786846,0.37495770500498393
2622,0.2663,20,71,20,608166,68278,85274,40982,0.5407901406665822,0.3750869485630606
2623,0.2664,21,52,21,608218,68226,85295,40961,0.5403782790520847,0.37514539276653813
2624,0.2665,25,48,25,608266,68178,85320,40936,0.5399980991002408,0.37516725626409075
2625,0.2666,15,76,15,608342,68102,85335,40921,0.5393961475098213,0.3753428175706044
2626,0.2667,24,79,24,608421,68023,85359,40897,0.5387704346724116,0.3754774146162321
2627,0.2668,29,71,29,608492,67952,85388,40868,0.5382080851603092,0.3755559639772101
2628,0.2669,30,77,30,608569,67875,85418,40838,0.5375982131542263,0.37564964631644787
2629,0.267,27,75,27,608644,67800,85445,40811,0.5370041819794703,0.3757538370883244
2630,0.2671,29,63,29,608707,67737,85474,40782,0.5365051957926752,0.37580515854366514
2631,0.2672,26,52,26,608759,67685,85500,40756,0.5360933341781776,0.3758357078964598
2632,0.2673,27,60,27,608819,67625,85527,40729,0.5356181092383728,0.3758882920796648
2633,0.2674,30,54,30,608873,67571,85557,40699,0.5351904067925485,0.375902835503833
2634,0.2675,21,55,21,608928,67516,85578,40678,0.5347547839310607,0.375972789618648
2635,0.2676,23,57,23,608985,67459,85601,40655,0.5343033202382461,0.37603825591505263
2636,0.2677,24,60,24,609045,67399,85625,40631,0.5338280952984412,0.3761084883828566
2637,0.2678,28,70,28,609115,67329,85653,40603,0.5332736662020022,0.3761905644294556
2638,0.2679,29,75,29,609190,67254,85682,40574,0.5326796350272462,0.376284453017769
2639,0.268,20,61,20,609251,67193,85702,40554,0.532196489671778,0.37638170900349893
2640,0.2681,20,61,20,609312,67132,85722,40534,0.5317133443163097,0.3764791113257667
2641,0.2682,17,72,17,609384,67060,85739,40517,0.5311430743885439,0.3766325515677143
2642,0.2683,31,77,31,609461,66983,85770,40486,0.530533202382461,0.3767225897700732
2643,0.2684,20,68,20,609529,66915,85790,40466,0.5299946141173488,0.37684506570063603
2644,0.2685,24,66,24,609595,66849,85814,40442,0.5294718666835636,0.37693748776691427
2645,0.2686,30,80,30,609675,66769,85844,40412,0.5288382334304904,0.37704443884643735
2646,0.2687,17,67,17,609742,66702,85861,40395,0.5283075655810416,0.37718143365360374
2647,0.2688,24,52,24,609794,66650,85885,40371,0.5278957039665442,0.3772250306014707
2648,0.2689,26,70,26,609864,66580,85911,40345,0.5273412748701052,0.3773205517886369
2649,0.269,18,68,18,609932,66512,85929,40327,0.5268026866049931,0.3774557979763944
2650,0.2691,27,78,27,610010,66434,85956,40300,0.5261848941832468,0.3775741563138269
2651,0.2692,24,55,24,610065,66379,85980,40276,0.525749271321759,0.3776288031503446
2652,0.2693,35,56,35,610121,66323,86015,40241,0.5253057280446077,0.37762283698059385
2653,0.2694,26,87,26,610208,66236,86041,40215,0.5246166518818908,0.3777794478210632
2654,0.2695,20,69,20,610277,66167,86061,40195,0.5240701432011152,0.3779075233636073
2655,0.2696,22,72,22,610349,66095,86083,40173,0.5234998732733493,0.3780347799902134
2656,0.2697,25,62,25,610411,66033,86108,40148,0.5230088075022177,0.378109077895292
2657,0.2698,20,73,20,610484,65960,86128,40128,0.5224306171587885,0.3782520171932735
2658,0.2699,28,61,28,610545,65899,86156,40100,0.5219474718033202,0.3783054557118463
2659,0.27,39,78,39,610623,65821,86195,40061,0.5213296793815739,0.37835515007272247
2660,0.2701,19,55,19,610678,65766,86214,40042,0.5208940565200861,0.37844019355814307
2661,0.2702,28,62,28,610740,65704,86242,40014,0.5204029907489545,0.3784975122495696
2662,0.2703,22,65,22,610805,65639,86264,39992,0.5198881637308326,0.37860097887930627
2663,0.2704,20,57,20,610862,65582,86284,39972,0.519436700038018,0.37868768592379254
2664,0.2705,24,69,24,610931,65513,86308,39948,0.5188901913572425,0.37879405657067544
2665,0.2706,23,66,23,610997,65447,86331,39925,0.5183674439234571,0.37889572182363435
2666,0.2707,33,60,33,611057,65387,86364,39892,0.5178922189836522,0.37891697299556415
2667,0.2708,23,59,23,611116,65328,86387,39869,0.5174249144595109,0.3789936975389032
2668,0.2709,19,58,19,611174,65270,86406,39850,0.5169655303510329,0.3790905631659056
2669,0.271,28,78,28,611252,65192,86434,39822,0.5163477379292866,0.3792065819795456
2670,0.2711,17,56,17,611308,65136,86451,39805,0.5159041946521353,0.3793083732764125
2671,0.2712,22,72,22,611380,65064,86473,39783,0.5153339247243696,0.3794386105467968
2672,0.2713,28,78,28,611458,64986,86501,39755,0.5147161323026233,0.37955528398621363
2673,0.2714,23,80,23,611538,64906,86524,39732,0.5140824990495502,0.3797090922991647
2674,0.2715,23,62,23,611600,64844,86547,39709,0.5135914332784185,0.3797978058974874
2675,0.2716,20,73,20,611673,64771,86567,39689,0.5130132429349892,0.3799444763545855
2676,0.2717,22,58,22,611731,64713,86589,39667,0.5125538588265112,0.38002490898639585
2677,0.2718,28,71,28,611802,64642,86617,39639,0.5119915093144088,0.38011718337952266
2678,0.2719,30,71,30,611873,64571,86647,39609,0.5114291598023064,0.3801977346899597
2679,0.272,23,72,23,611945,64499,86670,39586,0.5108588898745406,0.38032377383868954
2680,0.2721,24,67,24,612012,64432,86694,39562,0.5103282220250919,0.3804257937957959
2681,0.2722,29,65,29,612077,64367,86723,39533,0.50981339500697,0.3804908565928778
2682,0.2723,20,69,20,612146,64298,86743,39513,0.5092668863261944,0.3806244039648978
2683,0.2724,20,78,20,612224,64220,86763,39493,0.5086490939044481,0.38079122192974846
2684,0.2725,27,71,27,612295,64149,86790,39466,0.5080867443923457,0.38089079766443085
2685,0.2726,28,62,28,612357,64087,86818,39438,0.507595678621214,0.3809514609997585
2686,0.2727,27,55,27,612412,64032,86845,39411,0.5071600557597262,0.3809924306139613
2687,0.2728,29,63,29,612475,63969,86874,39382,0.5066610695729312,0.3810509816063705
2688,0.2729,23,61,23,612536,63908,86897,39359,0.5061779242174629,0.3811382145312636
2689,0.273,28,56,28,612592,63852,86925,39331,0.5057343809403118,0.3811771318918814
2690,0.2731,25,55,25,612647,63797,86950,39306,0.505298758078824,0.3812304200653715
2691,0.2732,23,88,23,612735,63709,86973,39283,0.5046017615004436,0.38141797421158924
2692,0.2733,29,83,29,612818,63626,87002,39254,0.5039443670003801,0.38155132192846036
2693,0.2734,23,63,23,612881,63563,87025,39231,0.5034453808135851,0.3816467887230772
2694,0.2735,22,66,22,612947,63497,87047,39209,0.5029226333797998,0.381759585613304
2695,0.2736,20,62,20,613009,63435,87067,39189,0.5024315676086681,0.38186973807296537
2696,0.2737,26,54,26,613063,63381,87093,39163,0.5020038651628438,0.38191410516461227
2697,0.2738,23,47,23,613110,63334,87116,39140,0.5016316056266633,0.3819505435525109
2698,0.2739,22,51,22,613161,63283,87138,39118,0.5012276644278292,0.3820079882032402
2699,0.274,28,46,28,613207,63237,87166,39090,0.5008633253073121,0.3820106130346829
2700,0.2741,30,67,30,613274,63170,87196,39060,0.5003326574578634,0.38207962437640614
2701,0.2742,26,53,26,613327,63117,87222,39034,0.49991287542770246,0.3821205861910309
2702,0.2743,28,67,28,613394,63050,87250,39006,0.4993822075782537,0.38220192835306105
2703,0.2744,17,52,17,613446,62998,87267,38989,0.49897034596375617,0.38229382176159704
2704,0.2745,16,74,16,613520,62924,87283,38973,0.4983842352046635,0.38247445950322384
2705,0.2746,20,56,20,613576,62868,87303,38953,0.49794069192751234,0.38256351833118907
2706,0.2747,31,54,31,613630,62814,87334,38922,0.497512989481688,0.38257843831092236
2707,0.2748,29,62,29,613692,62752,87363,38893,0.4970219237105563,0.382635643661764
2708,0.2749,19,78,19,613770,62674,87382,38874,0.49640413128881006,0.3828140386812148
2709,0.275,27,74,27,613844,62600,87409,38847,0.4958180205297174,0.38292901712224114
2710,0.2751,20,57,20,613901,62543,87429,38827,0.4953665568369028,0.3830225905100128
2711,0.2752,38,58,38,613959,62485,87467,38789,0.49490717272842477,0.3830104469064123
2712,0.2753,22,57,22,614016,62428,87489,38767,0.4944557090356102,0.3830920500024705
2713,0.2754,24,66,24,614082,62362,87513,38743,0.49393296160182487,0.38319568765145146
2714,0.2755,29,60,29,614142,62302,87542,38714,0.49345773666202003,0.3832462184208442
2715,0.2756,28,80,28,614222,62222,87570,38686,0.4928241034089469,0.3833789194117414
2716,0.2757,17,50,17,614272,62172,87587,38669,0.4924280826257762,0.3834650588550292
2717,0.2758,24,66,24,614338,62106,87611,38645,0.49190533519199087,0.3835693938521702
2718,0.2759,24,79,24,614417,62027,87635,38621,0.49127962235458117,0.38372347190207456
2719,0.276,25,75,25,614492,61952,87660,38596,0.49068559117982513,0.38385646656323347
2720,0.2761,27,76,27,614568,61876,87687,38569,0.49008363958940565,0.3839812832893623
2721,0.2762,20,52,20,614620,61824,87707,38549,0.48967177797490813,0.3840574656531139
2722,0.2763,22,67,22,614687,61757,87729,38527,0.4891411101254594,0.3841789318335926
2723,0.2764,18,47,18,614734,61710,87747,38509,0.48876885058927894,0.38424849579421066
2724,0.2765,21,52,21,614786,61658,87768,38488,0.4883569889747814,0.38431889441415534
2725,0.2766,24,71,24,614857,61587,87792,38464,0.487794639462679,0.38444393359386714
2726,0.2767,30,60,30,614917,61527,87822,38434,0.48731941452287414,0.38448995108092154
2727,0.2768,27,52,27,614969,61475,87849,38407,0.4869075529083766,0.3845237380108528
2728,0.2769,19,73,19,615042,61402,87868,38388,0.4863293625649474,0.3846878444733941
2729,0.277,32,56,32,615098,61346,87900,38356,0.48588581928779623,0.38470642514693787
2730,0.2771,24,47,24,615145,61299,87924,38332,0.48551355975161575,0.3847396894540856
2731,0.2772,21,59,21,615204,61240,87945,38311,0.48504625522747435,0.3848379222709968
2732,0.2773,15,67,15,615271,61173,87960,38296,0.4845155873780256,0.3850043732218078
2733,0.2774,20,69,20,615340,61104,87980,38276,0.48396907869725003,0.38514791708593277
2734,0.2775,12,60,12,615400,61044,87992,38264,0.4834938537574452,0.38530631973254925
2735,0.2776,16,58,16,615458,60986,88008,38248,0.4830344696489672,0.38543241227804986
2736,0.2777,27,39,27,615497,60947,88035,38221,0.482725573438094,0.3854166666666667
2737,0.2778,21,66,21,615563,60881,88056,38200,0.4822028260043087,0.3855431414701103
2738,0.2779,22,56,22,615619,60825,88078,38178,0.4817592827271575,0.3856246780400594
2739,0.278,32,58,32,615677,60767,88110,38146,0.4812998986186795,0.3856520376492473
2740,0.2781,27,60,27,615737,60707,88137,38119,0.48082467367887466,0.3857183332321454
2741,0.2782,22,85,22,615822,60622,88159,38097,0.48015143834748447,0.3859135526089203
2742,0.2783,34,56,34,615878,60566,88193,38063,0.4797078950703333,0.3859209765890357
2743,0.2784,29,60,29,615938,60506,88222,38034,0.47923267013052845,0.3859752384818348
2744,0.2785,25,59,25,615997,60447,88247,38009,0.47876536560638705,0.38605062159746484
2745,0.2786,24,73,24,616070,60374,88271,37985,0.4781871752629578,0.38618733415345824
2746,0.2787,17,54,17,616124,60320,88288,37968,0.47775947281713343,0.38629334201530197
2747,0.2788,27,56,27,616180,60264,88315,37941,0.47731592953998225,0.38634489078967466
2748,0.2789,24,69,24,616249,60195,88339,37917,0.4767694208592067,0.38646648727984345
2749,0.279,20,55,20,616304,60140,88359,37897,0.4763337979977189,0.3865581362138784
2750,0.2791,27,54,27,616358,60086,88386,37870,0.47590609555189456,0.3866021479031402
2751,0.2792,23,46,23,616404,60040,88409,37847,0.4755417564313775,0.38663969679324117
2752,0.2793,16,55,16,616459,59985,88425,37831,0.47510613356988973,0.3867567678089474
2753,0.2794,28,56,28,616515,59929,88453,37803,0.47466259029273855,0.3868026848933819
2754,0.2795,23,36,23,616551,59893,88476,37780,0.47437745532885567,0.3868008559171931
2755,0.2796,17,52,17,616603,59841,88493,37763,0.47396559371435815,0.3869001270439736
2756,0.2797,22,65,22,616668,59776,88515,37741,0.4734507666962362,0.38701969912938256
2757,0.2798,25,61,25,616729,59715,88540,37716,0.472967621340768,0.3871047202635711
2758,0.2799,21,74,21,616803,59641,88561,37695,0.4723815105816753,0.3872667872113093
2759,0.28,17,58,17,616861,59583,88578,37678,0.4719221264731973,0.38739062933755564
2760,0.2801,32,46,32,616907,59537,88610,37646,0.4715577873526803,0.387372277044339
2761,0.2802,15,66,15,616973,59471,88625,37631,0.47103503991889495,0.38754093633498793
2762,0.2803,22,50,22,617023,59421,88647,37609,0.47063901913572426,0.38760177264763473
2763,0.2804,28,64,28,617087,59357,88675,37581,0.47013211253326576,0.3876807856568116
2764,0.2805,26,58,26,617145,59299,88701,37555,0.46967272842478774,0.38774857001259627
2765,0.2806,16,55,16,617200,59244,88717,37539,0.46923710556329995,0.38786770403893245
2766,0.2807,20,51,20,617251,59193,88737,37519,0.46883316436446587,0.38794565307304163
2767,0.2808,27,59,27,617310,59134,88764,37492,0.4683658598403244,0.3880115082896943
2768,0.2809,24,51,24,617361,59083,88788,37468,0.4679619186414903,0.3880643390539715
2769,0.281,18,46,18,617407,59037,88806,37450,0.46759757952097325,0.38813518919647205
2770,0.2811,22,69,22,617476,58968,88828,37428,0.4670510708401977,0.3882733723391012
2771,0.2812,16,48,16,617524,58920,88844,37412,0.46667089088835384,0.3883652368890919
2772,0.2813,22,60,22,617584,58860,88866,37390,0.466195665948549,0.38846753246753246
2773,0.2814,24,50,24,617634,58810,88890,37366,0.4657996451653783,0.3885168857095325
2774,0.2815,28,47,28,617681,58763,88918,37338,0.46542738562919783,0.388528735392972
2775,0.2816,18,51,18,617732,58712,88936,37320,0.4650234444303637,0.3886204598467178
2776,0.2817,19,57,19,617789,58655,88955,37301,0.46457198073754913,0.38873025136520906
2777,0.2818,24,49,24,617838,58606,88979,37277,0.4641838803700418,0.38877590396629225
2778,0.2819,24,68,24,617906,58538,89003,37253,0.46364529210492966,0.3888987483166477
2779,0.282,28,60,28,617966,58478,89031,37225,0.4631700671651248,0.38896377334043863
2780,0.2821,20,63,20,618029,58415,89051,37205,0.46267108097832976,0.3890922401171303
2781,0.2822,23,59,23,618088,58356,89074,37182,0.4622037764541883,0.3891854550021981
2782,0.2823,22,55,22,618143,58301,89096,37160,0.46176815359270057,0.3892689161018636
2783,0.2824,21,50,21,618193,58251,89117,37139,0.4613721328095298,0.3893385050843904
2784,0.2825,20,58,20,618251,58193,89137,37119,0.4609127487010518,0.38944728890381064
2785,0.2826,20,54,20,618305,58139,89157,37099,0.46048504625522746,0.38953988953988955
2786,0.2827,17,52,17,618357,58087,89174,37082,0.46007318464072994,0.3896436864945518
2787,0.2828,27,72,27,618429,58015,89201,37055,0.4595029147129641,0.38976543599453034
2788,0.2829,21,47,21,618476,57968,89222,37034,0.4591306551767837,0.3898233721395339
2789,0.283,16,56,16,618532,57912,89238,37018,0.4586871118996325,0.389950489834615
2790,0.2831,24,65,24,618597,57847,89262,36994,0.45817228488151057,0.39006336921795426
2791,0.2832,18,80,18,618677,57767,89280,36976,0.4575386516284375,0.3902768542266975
2792,0.2833,16,52,16,618729,57715,89296,36960,0.4571267900139399,0.39038817005545284
2793,0.2834,23,60,23,618789,57655,89319,36937,0.45665156507413507,0.39048756765899867
2794,0.2835,21,38,21,618827,57617,89340,36916,0.45635058927892536,0.39050913437635537
2795,0.2836,21,62,21,618889,57555,89361,36895,0.4558595235077937,0.3906299629433563
2796,0.2837,26,52,26,618941,57503,89387,36869,0.45544766189329616,0.39067731954393253
2797,0.2838,19,47,19,618988,57456,89406,36850,0.4550754023571157,0.39074926303734653
2798,0.2839,21,51,21,619039,57405,89427,36829,0.4546714611582816,0.3908249676337628
2799,0.284,24,54,24,619093,57351,89451,36805,0.45424375871245726,0.390893835761927
2800,0.2841,14,74,14,619167,57277,89465,36791,0.4536576479533646,0.3911106858868053
2801,0.2842,18,62,18,619229,57215,89483,36773,0.45316658218223294,0.39125207473294465
2802,0.2843,19,72,19,619301,57143,89502,36754,0.4525963122544671,0.3914289061418363
2803,0.2844,20,53,20,619354,57090,89522,36734,0.45217653022430615,0.39152029331514326
2804,0.2845,17,61,17,619415,57029,89539,36717,0.4516933848688379,0.39166471102767053
2805,0.2846,30,59,30,619474,56970,89569,36687,0.45122608034469647,0.3917165828501874
2806,0.2847,29,51,29,619525,56919,89598,36658,0.4508221391458624,0.3917415604261731
2807,0.2848,23,57,23,619582,56862,89621,36635,0.45037067545304776,0.39183075392793354
2808,0.2849,22,45,22,619627,56817,89643,36613,0.4500142567481941,0.39187627100503053
2809,0.285,27,52,27,619679,56765,89670,36586,0.4496023951336966,0.3919186725369841
2810,0.2851,23,55,23,619734,56710,89693,36563,0.44916677227220886,0.39199982846054054
2811,0.2852,20,54,20,619788,56656,89713,36543,0.4487390698263845,0.39209648172190686
2812,0.2853,26,47,26,619835,56609,89739,36517,0.44836681029020403,0.39212464832592403
2813,0.2854,25,61,25,619896,56548,89764,36492,0.44788366493473575,0.39221840068787617
2814,0.2855,22,49,22,619945,56499,89786,36470,0.4474955645672285,0.39228129806709766
2815,0.2856,25,58,25,620003,56441,89811,36445,0.4470361804587505,0.3923626811360162
2816,0.2857,23,53,23,620056,56388,89834,36422,0.4466163984285895,0.3924361598965629
2817,0.2858,24,59,24,620115,56329,89858,36398,0.4461490939044481,0.3925286054762906
2818,0.2859,17,60,17,620175,56269,89875,36381,0.4456738689646433,0.3926713437668645
2819,0.286,26,59,26,620234,56210,89901,36355,0.44520656444050183,0.3927510398098633
2820,0.2861,22,57,22,620291,56153,89923,36333,0.44475510074768726,0.3928486473628441
2821,0.2862,25,54,25,620345,56099,89948,36308,0.4443273983018629,0.3929139567348794
2822,0.2863,18,66,18,620411,56033,89966,36290,0.4438046508680776,0.39307648148348734
2823,0.2864,28,50,28,620461,55983,89994,36262,0.44340863008490683,0.3931053173613746
2824,0.2865,16,56,16,620517,55927,90010,36246,0.44296508680775565,0.39323880095038677
2825,0.2866,25,55,25,620572,55872,90035,36221,0.4425294639462679,0.3933089377042772
2826,0.2867,17,68,17,620640,55804,90052,36204,0.44199087568115575,0.39348752282410226
2827,0.2868,22,53,22,620693,55751,90074,36182,0.4415710936509948,0.39356922976515507
2828,0.2869,21,51,21,620744,55700,90095,36161,0.4411671524521607,0.3936491002710617
2829,0.287,20,63,20,620807,55637,90115,36141,0.4406681662653656,0.3937871821133605
2830,0.2871,23,48,23,620855,55589,90138,36118,0.44028798631352173,0.3938412553022125
2831,0.2872,18,48,18,620903,55541,90156,36100,0.43990780636167787,0.3939284817930839
2832,0.2873,18,68,18,620971,55473,90174,36082,0.4393692180965657,0.39410190595816724
2833,0.2874,25,50,25,621021,55423,90199,36057,0.438973197313395,0.3941517271534762
2834,0.2875,21,59,21,621080,55364,90220,36036,0.43850589278925356,0.39426695842450765
2835,0.2876,21,55,21,621135,55309,90241,36015,0.4380702699277658,0.3943651176032587
2836,0.2877,23,54,23,621189,55255,90264,35992,0.43764256748194147,0.39444584479489736
2837,0.2878,28,47,28,621236,55208,90292,35964,0.437270307945761,0.3944632123897688
2838,0.2879,25,61,25,621297,55147,90317,35939,0.43678716259029277,0.39456118393606043
2839,0.288,19,53,19,621350,55094,90336,35920,0.4363673805601318,0.3946645571011053
2840,0.2881,18,62,18,621412,55032,90354,35902,0.43587631478900013,0.3948138210130424
2841,0.2882,17,53,17,621465,54979,90371,35885,0.43545653275883917,0.3949308857193168
2842,0.2883,24,56,24,621521,54923,90395,35861,0.435012989481688,0.3950145400070497
2843,0.2884,26,46,26,621567,54877,90421,35835,0.43464865036117095,0.39504144986330364
2844,0.2885,16,55,16,621622,54822,90437,35819,0.43421302749968316,0.39517436921481447
2845,0.2886,15,53,15,621675,54769,90452,35804,0.43379324546952225,0.39530544422730834
2846,0.2887,17,46,17,621721,54723,90469,35787,0.4334289063490052,0.3953927742790852
2847,0.2888,24,49,24,621770,54674,90493,35763,0.4330408059814979,0.3954465539546867
2848,0.2889,25,52,25,621822,54622,90518,35738,0.4326289443670004,0.3955068614431164
2849,0.289,15,46,15,621868,54576,90533,35723,0.43226460524648336,0.3956079247832202
2850,0.2891,16,50,16,621918,54526,90549,35707,0.4318685844633126,0.3957199694125209
2851,0.2892,19,52,19,621970,54474,90568,35688,0.4314567228488151,0.3958208557929061
2852,0.2893,28,40,28,622010,54434,90596,35660,0.43113990622227855,0.3958088218971297
2853,0.2894,18,46,18,622056,54388,90614,35642,0.4307755671017615,0.39589025880262135
2854,0.2895,21,46,21,622102,54342,90635,35621,0.4304112279812445,0.3959516690194858
2855,0.2896,28,52,28,622154,54290,90663,35593,0.4299993663667469,0.395992568116329
2856,0.2897,21,49,21,622203,54241,90684,35572,0.42961126599923966,0.3960673844543663
2857,0.2898,21,39,21,622242,54202,90705,35551,0.4293023697883665,0.39609818056220963
2858,0.2899,16,56,16,622298,54146,90721,35535,0.4288588265112153,0.39623777611757227
2859,0.29,21,55,21,622353,54091,90742,35514,0.4284232036497275,0.39633948998381785
2860,0.2901,14,54,14,622407,54037,90756,35500,0.4279955012039032,0.3964841350503144
2861,0.2902,13,49,13,622456,53988,90769,35487,0.42760740083639587,0.3966135792120704
2862,0.2903,21,67,21,622523,53921,90790,35466,0.42707673298694715,0.39676910512714375
2863,0.2904,22,49,22,622572,53872,90812,35444,0.42668863261943984,0.39683819248510904
2864,0.2905,19,53,19,622625,53819,90831,35425,0.42626885058927894,0.3969454529156022
2865,0.2906,25,50,25,622675,53769,90856,35400,0.42587282980610824,0.3969989570366383
2866,0.2907,19,50,19,622725,53719,90875,35381,0.4254768090229375,0.3970931537598204
2867,0.2908,27,40,27,622765,53679,90902,35354,0.42515999239640095,0.3970887199128413
2868,0.2909,21,61,21,622826,53618,90923,35333,0.4246768470409327,0.39721869343796024
2869,0.291,17,49,17,622875,53569,90940,35316,0.4242887466734254,0.39732238285424987
2870,0.2911,26,57,26,622932,53512,90966,35290,0.4238372829806108,0.3974009594378505
2871,0.2912,30,49,30,622981,53463,90996,35260,0.42344918261310355,0.3974166788769541
2872,0.2913,19,53,19,623034,53410,91015,35241,0.4230294005829426,0.3975251266201171
2873,0.2914,23,51,23,623085,53359,91038,35218,0.4226254593841085,0.39759757047540556
2874,0.2915,19,52,19,623137,53307,91057,35199,0.4222135977696109,0.39770185072198494
2875,0.2916,19,46,19,623183,53261,91076,35180,0.4218492586490939,0.39777931050078585
2876,0.2917,23,43,23,623226,53218,91099,35157,0.4215086807755671,0.3978161244695898
2877,0.2918,25,55,25,623281,53163,91124,35132,0.42107305791407934,0.39789342544877965
2878,0.2919,16,50,16,623331,53113,91140,35116,0.42067703713090865,0.39800972469369483
2879,0.292,18,64,18,623395,53049,91158,35098,0.42017013052845015,0.39817577455840814
2880,0.2921,16,51,16,623446,52998,91174,35082,0.419766189329616,0.3982970027247956
2881,0.2922,34,41,34,623487,52957,91208,35048,0.41944145228741603,0.39825009942616896
2882,0.2923,20,47,20,623534,52910,91228,35028,0.4190691927512356,0.39832609338397507
2883,0.2924,22,56,22,623590,52854,91250,35006,0.4186256494740844,0.39842931937172776
2884,0.2925,16,41,16,623631,52813,91266,34990,0.41830091243188444,0.3985057458173411
2885,0.2926,18,60,18,623691,52753,91284,34972,0.4178256874920796,0.3986548874323169
2886,0.2927,17,56,17,623747,52697,91301,34955,0.4173821442149284,0.3987929539542737
2887,0.2928,17,52,17,623799,52645,91318,34938,0.4169702826004309,0.39891303106767295
2888,0.2929,20,46,20,623845,52599,91338,34918,0.4166059434799138,0.39898533999108743
2889,0.293,26,37,26,623882,52562,91364,34892,0.4163128881003675,0.39897546138541407
2890,0.2931,21,56,21,623938,52506,91385,34871,0.4158693448232163,0.3990867161838928
2891,0.2932,27,45,27,623983,52461,91412,34844,0.4155129261183627,0.39910658037913066
2892,0.2933,19,44,19,624027,52417,91431,34825,0.41516442782917246,0.39917700190275324
2893,0.2934,23,42,23,624069,52375,91454,34802,0.4148317703713091,0.39921080101402895
2894,0.2935,19,60,19,624129,52315,91473,34783,0.41435654543150424,0.39935474982203956
2895,0.2936,25,32,25,624161,52283,91498,34758,0.414103092130275,0.3993290518261509
2896,0.2937,14,51,14,624212,52232,91512,34744,0.4136991509314409,0.3994665194996321
2897,0.2938,16,44,16,624256,52188,91528,34728,0.4133506526422507,0.3995581941184592
2898,0.2939,26,60,26,624316,52128,91554,34702,0.41287542770244584,0.3996544972935621
2899,0.294,11,53,11,624369,52075,91565,34691,0.4124556456722849,0.399822511121868
2900,0.2941,17,47,17,624416,52028,91582,34674,0.4120833861361044,0.39992157043666815
2901,0.2942,18,43,18,624459,51985,91600,34656,0.41174280826257764,0.3999953832481158
2902,0.2943,21,50,21,624509,51935,91621,34635,0.4113467874794069,0.40008085942012245
2903,0.2944,16,48,16,624557,51887,91637,34619,0.41096660752756303,0.40019189420387025
2904,0.2945,16,52,16,624609,51835,91653,34603,0.4105547459130655,0.40032161780698305
2905,0.2946,21,49,21,624658,51786,91674,34582,0.4101666455455582,0.4004029270100037
2906,0.2947,24,58,24,624716,51728,91698,34558,0.4097072614370802,0.40050529634007836
2907,0.2948,23,57,23,624773,51671,91721,34535,0.4092557977442656,0.40061016634573
2908,0.2949,24,43,24,624816,51628,91745,34511,0.4089152198707388,0.40064314654221667
2909,0.295,28,52,28,624868,51576,91773,34483,0.4085033582562413,0.40069022414854927
2910,0.2951,27,58,27,624926,51518,91800,34456,0.4080439741477633,0.4007723265173192
2911,0.2952,21,47,21,624973,51471,91821,34435,0.4076717146115828,0.4008451097711452
2912,0.2953,25,56,25,625029,51415,91846,34410,0.4072281713344316,0.4009321293329449
2913,0.2954,16,47,16,625076,51368,91862,34394,0.40685591179825115,0.40104008768452226
2914,0.2955,15,47,15,625123,51321,91877,34379,0.4064836522620707,0.4011551925320887
2915,0.2956,22,41,22,625164,51280,91899,34357,0.40615891521987074,0.4011934093908007
2916,0.2957,17,47,17,625211,51233,91916,34340,0.40578665568369027,0.4012948009301999
2917,0.2958,12,46,12,625257,51187,91928,34328,0.40542231656317324,0.40142665029526986
2918,0.2959,17,50,17,625307,51137,91945,34311,0.40502629578000254,0.40154245857129484
2919,0.296,29,47,29,625354,51090,91974,34282,0.40465403624382207,0.4015602305205454
2920,0.2961,21,57,21,625411,51033,91995,34261,0.4042025725510075,0.4016812436982672
2921,0.2962,26,44,26,625455,50989,92021,34235,0.40385407426181724,0.4017060921806064
2922,0.2963,16,46,16,625501,50943,92037,34219,0.4034897351413002,0.4018106667292924
2923,0.2964,25,44,25,625545,50899,92062,34194,0.40314123685211,0.4018426897629652
2924,0.2965,25,39,25,625584,50860,92087,34169,0.40283234064123685,0.4018511331428101
2925,0.2966,18,55,18,625639,50805,92105,34151,0.40239671777974906,0.4019845567117096
2926,0.2967,20,54,20,625693,50751,92125,34131,0.4019690153339247,0.40209938502862796
2927,0.2968,25,44,25,625737,50707,92150,34106,0.4016205170447345,0.40213174867060475
2928,0.2969,15,45,15,625782,50662,92165,34091,0.40126409833988086,0.40223944875107664
2929,0.297,27,58,27,625840,50604,92192,34064,0.40080471423140285,0.40232437284452216
2930,0.2971,20,49,20,625889,50555,92212,34044,0.4004166138638956,0.4024161042092696
2931,0.2972,22,45,22,625934,50510,92234,34022,0.40006019515904195,0.4024748024416789
2932,0.2973,15,37,15,625971,50473,92249,34007,0.39976713977949563,0.40254498106060604
2933,0.2974,17,51,17,626022,50422,92266,33990,0.3993631985806615,0.4026678671278965
2934,0.2975,15,46,15,626068,50376,92281,33975,0.39899885946014446,0.40278123555144574
2935,0.2976,23,47,23,626115,50329,92304,33952,0.398626599923964,0.40284287087243864
2936,0.2977,19,59,19,626174,50270,92323,33933,0.3981592953998226,0.4029903922663088
2937,0.2978,28,45,28,626219,50225,92351,33905,0.39780287669496894,0.40300725068346605
2938,0.2979,20,41,20,626260,50184,92371,33885,0.39747813965276896,0.40306177068836313
2939,0.298,19,49,19,626309,50135,92390,33866,0.3970900392852617,0.4031618671206295
2940,0.2981,23,48,23,626357,50087,92413,33843,0.3967098593334178,0.4032288812105326
2941,0.2982,25,52,25,626409,50035,92438,33818,0.39629799771892027,0.4033010148712628
2942,0.2983,23,45,23,626454,49990,92461,33795,0.3959415790140667,0.4033538222832249
2943,0.2984,21,51,21,626505,49939,92482,33774,0.39553763781523255,0.4034498823360768
2944,0.2985,18,45,18,626550,49894,92500,33756,0.3951812191103789,0.40353855349671247
2945,0.2986,25,67,25,626617,49827,92525,33731,0.3946505512609302,0.40368366882883744
2946,0.2987,21,52,21,626669,49775,92546,33710,0.39423868964643266,0.403785111097802
2947,0.2988,8,40,8,626709,49735,92554,33702,0.39392187301989606,0.4039215216270959
2948,0.2989,25,34,25,626743,49701,92579,33677,0.39365257888734,0.4039075055770107
2949,0.299,11,38,11,626781,49663,92590,33666,0.3933516030921303,0.4040130086764512
2950,0.2991,15,44,15,626825,49619,92605,33651,0.39300310480294004,0.4041191305392098
2951,0.2992,24,47,24,626872,49572,92629,33627,0.3926308452667596,0.4041755309559009
2952,0.2993,22,54,22,626926,49518,92651,33605,0.39220314282093527,0.40428040373903734
2953,0.2994,24,43,24,626969,49475,92675,33581,0.39186256494740845,0.4043175688691967
2954,0.2995,29,55,29,627024,49420,92704,33552,0.39142694208592066,0.4043773803210722
2955,0.2996,19,47,19,627071,49373,92723,33533,0.3910546825497402,0.40447012278966543
2956,0.2997,27,46,27,627117,49327,92750,33506,0.39069034342922315,0.40450062173288426
2957,0.2998,27,50,27,627167,49277,92777,33479,0.39029432264605246,0.4045507274397023
2958,0.2999,22,48,22,627215,49229,92799,33457,0.3899141426942086,0.40462714365188784
2959,0.3,21,51,21,627266,49178,92820,33436,0.38951020149537446,0.4047255913041373
2960,0.3001,18,44,18,627310,49134,92838,33418,0.38916170320618426,0.40481151274348287
2961,0.3002,24,42,24,627352,49092,92862,33394,0.3888290457483209,0.40484445845355577
2962,0.3003,24,36,24,627388,49056,92886,33370,0.38854391078443795,0.40484798485914636
2963,0.3004,22,47,22,627435,49009,92908,33348,0.38817165124825753,0.404920043226441
2964,0.3005,18,60,18,627495,48949,92926,33330,0.3876964263084527,0.4050851371552887
2965,0.3006,20,49,20,627544,48900,92946,33310,0.3873083259409454,0.4051818513562827
2966,0.3007,25,42,25,627586,48858,92971,33285,0.386975668483082,0.40520799094262444
2967,0.3008,15,38,15,627624,48820,92986,33270,0.38667469268787225,0.40528688025338044
2968,0.3009,20,50,20,627674,48770,93006,33250,0.38627867190470155,0.4053889295293831
2969,0.301,13,37,13,627711,48733,93019,33237,0.38598561652515523,0.4054776137611321
2970,0.3011,9,44,9,627755,48689,93028,33228,0.385637118235965,0.4056300889925168
2971,0.3012,22,47,22,627802,48642,93050,33206,0.38526485869978455,0.4057032548138012
2972,0.3013,21,45,21,627847,48597,93071,33185,0.3849084399949309,0.4057738866743293
2973,0.3014,26,42,26,627889,48555,93097,33159,0.38457578253706753,0.40579337689991923
2974,0.3015,19,51,19,627940,48504,93116,33140,0.38417184133823346,0.40590857870755964
2975,0.3016,16,44,16,627984,48460,93132,33124,0.3838233430490432,0.4060109825455972
2976,0.3017,20,46,20,628030,48414,93152,33104,0.38345900392852617,0.406094359527957
2977,0.3018,11,40,11,628070,48374,93163,33093,0.3831421873019896,0.4062135588643254
2978,0.3019,23,47,23,628117,48327,93186,33070,0.38276992776580915,0.4062803297418824
2979,0.302,28,51,28,628168,48276,93214,33042,0.382365986566975,0.4063307016896628
2980,0.3021,15,42,15,628210,48234,93229,33027,0.38203332910911164,0.40643112932402997
2981,0.3022,21,52,21,628262,48182,93250,33006,0.3816214674946141,0.4065379120067005
2982,0.3023,15,44,15,628306,48138,93265,32991,0.3812729692054239,0.40664867063565435
2983,0.3024,14,54,14,628360,48084,93279,32977,0.38084526675959957,0.40681708836555186
2984,0.3025,18,37,18,628397,48047,93297,32959,0.38055221138005324,0.40687109596819987
2985,0.3026,14,35,14,628432,48012,93311,32945,0.38027499683183374,0.4069444272885606
2986,0.3027,16,53,16,628485,47959,93327,32929,0.3798552148016728,0.4070937592720799
2987,0.3028,18,49,18,628534,47910,93345,32911,0.37946711443416553,0.4072085225374593
2988,0.3029,17,51,17,628585,47859,93362,32894,0.3790631732353314,0.40734090374351417
2989,0.303,25,32,25,628617,47827,93387,32869,0.3788097199341021,0.407318826211956
2990,0.3031,16,57,16,628674,47770,93403,32853,0.37835825624128755,0.40748917802612156
2991,0.3032,23,46,23,628720,47724,93426,32830,0.3779939171207705,0.4075526975693324
2992,0.3033,28,39,28,628759,47685,93454,32802,0.37768502090989736,0.4075440754407544
2993,0.3034,16,44,16,628803,47641,93470,32786,0.37733652262070716,0.4076491725415594
2994,0.3035,22,65,22,628868,47576,93492,32764,0.3768216956025852,0.4078167786905651
2995,0.3036,20,46,20,628914,47530,93512,32744,0.3764573564820682,0.407902932456337
2996,0.3037,21,42,21,628956,47488,93533,32723,0.3761246990242048,0.4079615015396891
2997,0.3038,22,49,22,629005,47439,93555,32701,0.3757365986566975,0.4080484152732718
2998,0.3039,21,48,21,629053,47391,93576,32680,0.37535641870485364,0.4081377777222715
2999,0.304,25,41,25,629094,47350,93601,32655,0.37503168166265366,0.4081619898756328
3000,0.3041,24,43,24,629137,47307,93625,32631,0.37469110378912684,0.4082038579899422
3001,0.3042,19,35,19,629172,47272,93644,32612,0.37441388924090735,0.4082419508287016
3002,0.3043,17,37,17,629209,47235,93661,32595,0.374120833861361,0.4083051484404359
3003,0.3044,19,48,19,629257,47187,93680,32576,0.37374065390951716,0.40840991437132507
3004,0.3045,13,37,13,629294,47150,93693,32563,0.37344759852997084,0.4085030045287469
3005,0.3046,27,44,27,629338,47106,93720,32536,0.37309910024078063,0.4085281635318048
3006,0.3047,19,33,19,629371,47073,93739,32517,0.37283772652388797,0.4085563513004146
3007,0.3048,17,46,17,629417,47027,93756,32500,0.37247338740337094,0.4086662391389088
3008,0.3049,19,45,19,629462,46982,93775,32481,0.3721169686985173,0.40875627650604685
3009,0.305,30,41,30,629503,46941,93805,32451,0.3717922316563173,0.40874395405078595
3010,0.3051,24,40,24,629543,46901,93829,32427,0.37147541502978076,0.4087711778943122
3011,0.3052,15,40,15,629583,46861,93844,32412,0.3711585984032442,0.40886556582947536
3012,0.3053,17,61,17,629644,46800,93861,32395,0.37067545304777594,0.40905360186880485
3013,0.3054,20,46,20,629690,46754,93881,32375,0.3703111139272589,0.40914203389402115
3014,0.3055,17,46,17,629736,46708,93898,32358,0.3699467748067419,0.4092530291149167
3015,0.3056,7,38,7,629774,46670,93905,32351,0.3696457990115321,0.40939750192986674
3016,0.3057,15,45,15,629819,46625,93920,32336,0.3692893803066785,0.4095186231177417
3017,0.3058,18,47,18,629866,46578,93938,32318,0.36891712077049804,0.4096278645305212
3018,0.3059,17,46,17,629912,46532,93955,32301,0.368552781649981,0.40973957606586076
3019,0.306,20,43,20,629955,46489,93975,32281,0.3682122037764542,0.4098133807287038
3020,0.3061,22,43,22,629998,46446,93997,32259,0.3678716259029274,0.40987230798551555
3021,0.3062,21,35,21,630033,46411,94018,32238,0.3675944113547079,0.409897137916566
3022,0.3063,15,38,15,630071,46373,94033,32223,0.36729343555949817,0.40998269632042345
3023,0.3064,17,32,17,630103,46341,94050,32206,0.3670399822582689,0.4100220250296001
3024,0.3065,19,36,19,630139,46305,94069,32187,0.366754847294386,0.4100672680018346
3025,0.3066,16,34,16,630173,46271,94085,32171,0.36648555316182996,0.41012467810611664
3026,0.3067,21,55,21,630228,46216,94106,32150,0.36604993030034216,0.41025444708164255
3027,0.3068,26,37,26,630265,46179,94132,32124,0.36575687492079584,0.4102524807478641
3028,0.3069,24,48,24,630313,46131,94156,32100,0.365376694968952,0.4103232733826744
3029,0.307,17,48,17,630361,46083,94173,32083,0.3649965150171081,0.4104469974157562
3030,0.3071,17,47,17,630408,46036,94190,32066,0.36462425548092764,0.41056567053340504
3031,0.3072,12,39,12,630447,45997,94202,32054,0.3643153592700545,0.4106801962819182
3032,0.3073,16,37,16,630484,45960,94218,32038,0.36402230389050816,0.41075412190056154
3033,0.3074,19,34,19,630518,45926,94237,32019,0.3637530097579521,0.41078965937520046
3034,0.3075,21,47,21,630565,45879,94258,31998,0.36338075022177163,0.410878693324088
3035,0.3076,18,43,18,630608,45836,94276,31980,0.3630401723482448,0.41096946643363835
3036,0.3077,18,43,18,630651,45793,94294,31962,0.36269959447471806,0.4110603819690052
3037,0.3078,19,48,19,630699,45745,94313,31943,0.36231941452287414,0.41117032231490064
3038,0.3079,22,44,22,630743,45701,94335,31921,0.36197091623368394,0.41123650511452936
3039,0.308,17,36,17,630779,45665,94352,31904,0.36168578126980105,0.4112983279402854
3040,0.3081,23,41,23,630820,45624,94375,31881,0.36136104422760107,0.41134120379330363
3041,0.3082,16,31,16,630851,45593,94391,31865,0.36111551134203523,0.4113842340365101
3042,0.3083,18,28,18,630879,45565,94409,31847,0.3608937397034596,0.4113961659691004
3043,0.3084,19,45,19,630924,45520,94428,31828,0.360537320998606,0.4114909241350778
3044,0.3085,21,42,21,630966,45478,94449,31807,0.3602046635407426,0.4115546354402536
3045,0.3086,12,42,12,631008,45436,94461,31795,0.3598720060828792,0.41168701687146353
3046,0.3087,17,53,17,631061,45383,94478,31778,0.35945222405271826,0.4118401783284302
3047,0.3088,35,35,35,631096,45348,94513,31743,0.3591750095044988,0.4117601276413589
3048,0.3089,19,47,19,631143,45301,94532,31724,0.35880274996831835,0.4118662771827329
3049,0.309,21,46,21,631189,45255,94553,31703,0.3584384108478013,0.41195197380389303
3050,0.3091,23,43,23,631232,45212,94576,31680,0.3580978329742745,0.41200645060604485
3051,0.3092,24,36,24,631268,45176,94600,31656,0.35781269801039156,0.4120158267388588
3052,0.3093,23,46,23,631314,45130,94623,31633,0.35744835888987453,0.4120865521149512
3053,0.3094,20,25,20,631339,45105,94643,31613,0.3572503484982892,0.4120675721473448
3054,0.3095,22,56,22,631395,45049,94665,31591,0.356806805221138,0.4121998956158664
3055,0.3096,21,34,21,631429,45015,94686,31570,0.35653751108858195,0.41222171443494154
3056,0.3097,13,32,13,631461,44983,94699,31557,0.35628405778735267,0.41229422524170367
3057,0.3098,15,44,15,631505,44939,94714,31542,0.35593555949816247,0.4124161556465004
3058,0.3099,23,40,23,631545,44899,94737,31519,0.3556187428716259,0.4124551807165851
3059,0.31,20,41,20,631586,44858,94757,31499,0.35529400582942594,0.41252275495370433
3060,0.3101,17,41,17,631627,44817,94774,31482,0.35496926878722596,0.41261353359808123
3061,0.3102,16,37,16,631664,44780,94790,31466,0.35467621340767963,0.41269050179681555
3062,0.3103,18,52,18,631716,44728,94808,31448,0.3542643517931821,0.4128334383532871
3063,0.3104,17,36,17,631752,44692,94825,31431,0.3539792168292992,0.4128975473904076
3064,0.3105,18,35,18,631787,44657,94843,31413,0.35370200228107973,0.4129485999737084
3065,0.3106,17,43,17,631830,44614,94860,31396,0.3533614244075529,0.41305091435337454
3066,0.3107,19,34,19,631864,44580,94879,31377,0.3530921302749968,0.413088984557052
3067,0.3108,16,32,16,631896,44548,94895,31361,0.3528386769737676,0.4131394169334335
3068,0.3109,14,54,14,631950,44494,94909,31347,0.35241097452794323,0.4133252462388418
3069,0.311,17,40,17,631990,44454,94926,31330,0.3520941579014067,0.41341180196347516
3070,0.3111,23,45,23,632035,44409,94949,31307,0.35173773919655305,0.41347931744941624
3071,0.3112,19,40,19,632075,44369,94968,31288,0.35142092257001645,0.41355062981614393
3072,0.3113,17,45,17,632120,44324,94985,31271,0.35106450386516286,0.4136649249288974
3073,0.3114,19,39,19,632159,44285,95004,31252,0.3507556076542897,0.4137310192356064
3074,0.3115,14,39,14,632198,44246,95018,31238,0.35044671144341655,0.41383604472470986
3075,0.3116,22,42,22,632240,44204,95040,31216,0.3501140539855532,0.4138955184301246
3076,0.3117,20,43,20,632283,44161,95060,31196,0.34977347611202636,0.41397614023912843
3077,0.3118,18,51,18,632334,44110,95078,31178,0.3493695349131922,0.41411645946233133
3078,0.3119,21,44,21,632378,44066,95099,31157,0.349021036624002,0.41419512649056806
3079,0.312,18,34,18,632412,44032,95117,31139,0.34875174249144597,0.41424219446329036
3080,0.3121,17,30,17,632442,44002,95134,31122,0.3485141300215435,0.41427506522549384
3081,0.3122,18,46,18,632488,43956,95152,31104,0.3481497909010265,0.4143884892086331
3082,0.3123,16,42,16,632530,43914,95168,31088,0.3478171334431631,0.414495613450308
3083,0.3124,18,43,18,632573,43871,95186,31070,0.3474765555696363,0.41459281301290346
3084,0.3125,17,35,17,632608,43836,95203,31053,0.3471993410214168,0.414653687457437
3085,0.3126,20,53,20,632661,43783,95223,31033,0.34677955899125584,0.41479095380667236
3086,0.3127,14,44,14,632705,43739,95237,31019,0.34643106070206564,0.41492549292383424
3087,0.3128,10,49,10,632754,43690,95247,31009,0.34604296033455834,0.4151193456405039
3088,0.3129,23,41,23,632795,43649,95270,30986,0.3457182232923584,0.41516714678100086
3089,0.313,19,35,19,632830,43614,95289,30967,0.3454410087441389,0.41521298990359473
3090,0.3131,23,44,23,632874,43570,95312,30944,0.34509251045494865,0.41527766594197063
3091,0.3132,20,38,20,632912,43532,95332,30924,0.34479153465973894,0.41533254539593856
3092,0.3133,20,45,20,632957,43487,95352,30904,0.3444351159548853,0.41542659730343723
3093,0.3134,26,40,26,632997,43447,95378,30878,0.34411829932834875,0.41544567776656577
3094,0.3135,13,36,13,633033,43411,95391,30865,0.34383316436446587,0.41554472507943346
3095,0.3136,15,41,15,633074,43370,95406,30850,0.3435084273222659,0.4156561573699811
3096,0.3137,18,37,18,633111,43333,95424,30832,0.34321537194271956,0.41572170161127214
3097,0.3138,19,39,19,633150,43294,95443,30813,0.3429064757318464,0.41579068104227673
3098,0.3139,16,49,16,633199,43245,95459,30797,0.3425183753643391,0.41593960184760004
3099,0.314,22,32,22,633231,43213,95481,30775,0.3422649220631099,0.41594582905336003
3100,0.3141,19,50,19,633281,43163,95500,30756,0.3418689012799392,0.41607705731949834
3101,0.3142,20,37,20,633318,43126,95520,30736,0.34157584590039286,0.41612737266794836
3102,0.3143,16,43,16,633361,43083,95536,30720,0.34123526802686605,0.41624324214462827
3103,0.3144,18,34,18,633395,43049,95554,30702,0.34096597389431,0.41629266043850255
3104,0.3145,11,37,11,633432,43012,95565,30691,0.34067291851476367,0.41641452858092615
3105,0.3146,14,46,14,633478,42966,95579,30677,0.34030857939424664,0.41656369240796814
3106,0.3147,13,39,13,633517,42927,95592,30664,0.3399996831833735,0.4166813876696879
3107,0.3148,21,35,21,633552,42892,95613,30643,0.339722468635154,0.41671312980213504
3108,0.3149,27,38,27,633590,42854,95640,30616,0.3394214928399442,0.4167143051585681
3109,0.315,15,35,15,633625,42819,95655,30601,0.3391442782917248,0.4167937891582675
3110,0.3151,19,34,19,633659,42785,95674,30582,0.33887498415916867,0.4168359071517167
3111,0.3152,22,35,22,633694,42750,95696,30560,0.3385977696109492,0.4168599099713545
3112,0.3153,10,49,10,633743,42701,95706,30550,0.33820966924344187,0.4170591527760713
3113,0.3154,18,35,18,633778,42666,95724,30532,0.33793245469522243,0.4171152217273696
3114,0.3155,13,31,13,633809,42635,95737,30519,0.3376869218096566,0.41718839708013233
3115,0.3156,10,47,10,633856,42588,95747,30509,0.3373146622734761,0.4173769101331108
3116,0.3157,21,46,21,633902,42542,95768,30488,0.3369503231529591,0.41747227166917705
3117,0.3158,15,38,15,633940,42504,95783,30473,0.3366493473577493,0.4175699192896392
3118,0.3159,18,49,18,633989,42455,95801,30455,0.33626124699024207,0.4177067617610753
3119,0.316,21,39,21,634028,42416,95822,30434,0.3359523507793689,0.4177625257378174
3120,0.3161,17,40,17,634068,42376,95839,30417,0.3356355341528323,0.4178561125382935
3121,0.3162,15,45,15,634113,42331,95854,30402,0.3352791154479787,0.4179945829265945
3122,0.3163,9,39,9,634152,42292,95863,30393,0.33497021923710557,0.4181467978262365
3123,0.3164,11,38,11,634190,42254,95874,30382,0.33466924344189586,0.4182774381849221
3124,0.3165,20,54,20,634244,42200,95894,30362,0.33424154099607145,0.41842837849011877
3125,0.3166,14,38,14,634282,42162,95908,30348,0.33394056520086174,0.41853537443111294
3126,0.3167,20,33,20,634315,42129,95928,30328,0.3336791914839691,0.4185654940171412
3127,0.3168,17,35,17,634350,42094,95945,30311,0.3334019769357496,0.41863130999240383
3128,0.3169,9,43,9,634393,42051,95954,30302,0.33306139906222276,0.4188077895871629
3129,0.317,24,43,24,634436,42008,95978,30278,0.332720821188696,0.4188639570594583
3130,0.3171,18,47,18,634483,41961,95996,30260,0.33234856165251553,0.4189917060134864
3131,0.3172,18,36,18,634519,41925,96014,30242,0.33206342668863265,0.4190558011279394
3132,0.3173,18,41,18,634560,41884,96032,30224,0.33173868964643266,0.4191490541964831
3133,0.3174,19,46,19,634606,41838,96051,30205,0.3313743505259156,0.419263495412462
3134,0.3175,16,36,16,634642,41802,96067,30189,0.3310892155620327,0.4193440846772513
3135,0.3176,14,22,14,634664,41780,96081,30175,0.33091496641743756,0.4193593217983462
3136,0.3177,22,37,22,634701,41743,96103,30153,0.3306219110378913,0.41939746300211417
3137,0.3178,20,40,20,634741,41703,96123,30133,0.3303050944113547,0.4194693468455927
3138,0.3179,22,28,22,634769,41675,96145,30111,0.33008332277277913,0.4194550469450868
3139,0.318,22,32,22,634801,41643,96167,30089,0.32982986947154985,0.41946411643339093
3140,0.3181,11,46,11,634847,41597,96178,30078,0.3294655303510328,0.4196442274154168
3141,0.3182,18,40,18,634887,41557,96196,30060,0.3291487137244963,0.41973274501864083
3142,0.3183,14,47,14,634934,41510,96210,30046,0.3287764541883158,0.41989490748504665
3143,0.3184,16,31,16,634965,41479,96226,30030,0.32853092130274997,0.41994713952089946
3144,0.3185,13,36,13,635001,41443,96239,30017,0.3282457863388671,0.42005317660229496
3145,0.3186,16,27,16,635028,41416,96255,30001,0.3280319351159549,0.42008205329263343
3146,0.3187,27,37,27,635065,41379,96282,29974,0.3277388797364086,0.42008044511092735
3147,0.3188,15,37,15,635102,41342,96297,29959,0.32744582435686226,0.42017643511311203
3148,0.3189,10,38,10,635140,41304,96307,29949,0.3271448485616525,0.42031914445707547
3149,0.319,16,39,16,635179,41265,96323,29933,0.3268359523507794,0.4204191128964297
3150,0.3191,19,37,19,635216,41228,96342,29914,0.32654289697123307,0.42048297770655874
3151,0.3192,13,29,13,635245,41199,96355,29901,0.32631320491699406,0.42054852320675107
3152,0.3193,17,31,17,635276,41168,96372,29884,0.3260676720314282,0.4205933682373473
3153,0.3194,14,39,14,635315,41129,96386,29870,0.32575877582055507,0.42071015084719504
3154,0.3195,25,47,25,635362,41082,96411,29845,0.3253865162843746,0.42078475051813835
3155,0.3196,25,38,25,635400,41044,96436,29820,0.3250855404891649,0.42080605102731994
3156,0.3197,10,52,10,635452,40992,96446,29810,0.32467367887466736,0.42103330414395074
3157,0.3198,21,38,21,635490,40954,96467,29789,0.3243727030794576,0.4210875987730235
3158,0.3199,22,38,22,635528,40916,96489,29767,0.3240717272842479,0.4211337945474867
3159,0.32,19,39,19,635567,40877,96508,29748,0.3237628310733747,0.42121061946902655
3160,0.3201,25,44,25,635611,40833,96533,29723,0.3234143327841845,0.4212682124837009
3161,0.3202,19,33,19,635644,40800,96552,29704,0.32315295906729186,0.421309429252241
3162,0.3203,30,40,30,635684,40760,96582,29674,0.3228361424407553,0.42130221199988643
3163,0.3204,18,32,18,635716,40728,96600,29656,0.32258268913952604,0.4213457604000909
3164,0.3205,17,50,17,635766,40678,96617,29639,0.32218666835635534,0.4215054680944864
3165,0.3206,18,49,18,635815,40629,96635,29621,0.32179856798884804,0.42165124555160144
3166,0.3207,19,47,19,635862,40582,96654,29602,0.3214263084526676,0.4217770432007295
3167,0.3208,18,37,18,635899,40545,96672,29584,0.3211332530731213,0.4218511600051334
3168,0.3209,16,43,16,635942,40502,96688,29568,0.3207926751995945,0.421978021978022
3169,0.321,11,35,11,635977,40467,96699,29557,0.320515460651375,0.4220981377813321
3170,0.3211,21,43,21,636020,40424,96720,29536,0.32017488277784817,0.4221841052029731
3171,0.3212,14,37,14,636057,40387,96734,29522,0.31988182739830184,0.4222918365303466
3172,0.3213,13,34,13,636091,40353,96747,29509,0.3196125332657458,0.4223898542841602
3173,0.3214,14,29,14,636120,40324,96761,29495,0.3193828412115068,0.42244947650353054
3174,0.3215,18,34,18,636154,40290,96779,29477,0.3191135470789507,0.42250634254016944
3175,0.3216,22,36,22,636190,40254,96801,29455,0.3188284121150678,0.4225422829189918
3176,0.3217,16,43,16,636233,40211,96817,29439,0.318487834241541,0.4226704953338119
3177,0.3218,20,42,20,636275,40169,96837,29419,0.3181551767836776,0.4227596712076795
3178,0.3219,17,36,17,636311,40133,96854,29402,0.3178700418197947,0.4228374200043144
3179,0.322,13,36,13,636347,40097,96867,29389,0.3175849068559118,0.42294850761304437
3180,0.3221,15,35,15,636382,40062,96882,29374,0.3173076923076923,0.4230370413042226
3181,0.3222,11,42,11,636424,40020,96893,29363,0.3169750348498289,0.42320164881887495
3182,0.3223,18,32,18,636456,39988,96911,29345,0.3167215815485997,0.4232472271501305
3183,0.3224,16,39,16,636495,39949,96927,29329,0.31641268533772654,0.4233522907705188
3184,0.3225,20,33,20,636528,39916,96947,29309,0.3161513116208339,0.4233875045142651
3185,0.3226,21,34,21,636562,39882,96968,29288,0.31588201748827777,0.4234205580453954
3186,0.3227,19,36,19,636598,39846,96987,29269,0.3155968825243949,0.42348260146133254
3187,0.3228,12,23,12,636621,39823,96999,29257,0.31541471296413637,0.42352345107122175
3188,0.3229,18,30,18,636651,39793,97017,29239,0.3151771004942339,0.42355719086800325
3189,0.323,18,36,18,636687,39757,97035,29221,0.31489196553035104,0.42362782336397115
3190,0.3231,16,40,16,636727,39717,97051,29205,0.3145751489038145,0.4237398798641943
3191,0.3232,16,33,16,636760,39684,97067,29189,0.31431377518692183,0.4238090398269278
3192,0.3233,16,33,16,636793,39651,97083,29173,0.31405240147002916,0.423878298268046
3193,0.3234,19,31,19,636824,39620,97102,29154,0.3138068685844633,0.4239101986215721
3194,0.3235,24,46,24,636870,39574,97126,29130,0.3134425294639463,0.4239927806241267
3195,0.3236,25,37,25,636907,39537,97151,29105,0.31314947408439997,0.424011538125346
3196,0.3237,14,36,14,636943,39501,97165,29091,0.31286433912051703,0.42411651504548636
3197,0.3238,19,49,19,636992,39452,97184,29072,0.3124762387530098,0.42426011324499446
3198,0.3239,19,32,19,637024,39420,97203,29053,0.3122227854517805,0.42429862865655077
3199,0.324,14,42,14,637066,39378,97217,29039,0.31189012799391713,0.42444129383048074
3200,0.3241,20,27,20,637093,39351,97237,29019,0.31167627677100496,0.42444054409828874
3201,0.3242,13,36,13,637129,39315,97250,29006,0.311391141807122,0.4245546757219596
3202,0.3243,19,33,19,637162,39282,97269,28987,0.31112976809022935,0.42459974512589904
3203,0.3244,15,37,15,637199,39245,97284,28972,0.3108367127106831,0.424703519650527
3204,0.3245,20,32,20,637231,39213,97304,28952,0.3105832594094538,0.424734101078266
3205,0.3246,15,49,15,637280,39164,97319,28937,0.3101951590419465,0.4249129968722926
3206,0.3247,18,33,18,637313,39131,97337,28919,0.30993378532505383,0.4249669360764144
3207,0.3248,16,24,16,637337,39107,97353,28903,0.30974369534913193,0.4249816203499485
3208,0.3249,20,28,20,637365,39079,97373,28883,0.3095219237105563,0.42498749301080013
3209,0.325,13,37,13,637402,39042,97386,28870,0.30922886833101,0.4251089645423489
3210,0.3251,19,31,19,637433,39011,97405,28851,0.30898333544544415,0.42514220034776457
3211,0.3252,19,39,19,637472,38972,97424,28832,0.30867443923457105,0.4252256504041059
3212,0.3253,18,30,18,637502,38942,97442,28814,0.3084368267646686,0.4252612314776551
3213,0.3254,16,36,16,637538,38906,97458,28798,0.3081516918007857,0.42535153019023986
3214,0.3255,19,37,19,637575,38869,97477,28779,0.3078586364212394,0.4254227767265847
3215,0.3256,28,39,28,637614,38830,97505,28751,0.30754974021036624,0.4254302244713751
3216,0.3257,18,34,18,637648,38796,97523,28733,0.3072804460778102,0.4254912704171541
3217,0.3258,22,30,22,637678,38766,97545,28711,0.30704283360790774,0.42549313099278274
3218,0.3259,12,29,12,637707,38737,97557,28699,0.30681314155366873,0.4255738774541788
3219,0.326,18,27,18,637734,38710,97575,28681,0.30659929033075656,0.425590954281729
3220,0.3261,25,47,25,637781,38663,97600,28656,0.3062270307945761,0.4256747723525305
3221,0.3262,18,31,18,637812,38632,97618,28638,0.30598149790901025,0.4257172588077895
3222,0.3263,22,35,22,637847,38597,97640,28616,0.30570428336079075,0.4257509707943404
3223,0.3264,17,37,17,637884,38560,97657,28599,0.3054112279812445,0.42584017034202415
3224,0.3265,16,42,16,637926,38518,97673,28583,0.30507857052338105,0.42596980670928897
3225,0.3266,18,40,18,637966,38478,97691,28565,0.3047617538968445,0.4260698357770386
3226,0.3267,14,34,14,638000,38444,97705,28551,0.3044924597642884,0.42616613180088064
3227,0.3268,21,50,21,638050,38394,97726,28530,0.3040964389811177,0.42630446476600325
3228,0.3269,19,40,19,638090,38354,97745,28511,0.30377962235458117,0.42639647050026175
3229,0.327,17,44,17,638134,38310,97762,28494,0.30343112406539097,0.4265313454284175
3230,0.3271,16,43,16,638177,38267,97778,28478,0.30309054619186415,0.4266686643194247
3231,0.3272,14,32,14,638209,38235,97792,28464,0.3028370928906349,0.4267530247829803
3232,0.3273,15,40,15,638249,38195,97807,28449,0.30252027626409833,0.4268801392473441
3233,0.3274,15,30,15,638279,38165,97822,28434,0.30228266379419594,0.4269433474977102
3234,0.3275,12,42,12,638321,38123,97834,28422,0.3019500063363325,0.42710947479149447
3235,0.3276,21,19,21,638340,38104,97855,28401,0.30179951843872765,0.4270505976994211
3236,0.3277,13,28,13,638368,38076,97868,28388,0.3015777468001521,0.42711844005777566
3237,0.3278,14,35,14,638403,38041,97882,28374,0.3013005322519326,0.4272227659414289
3238,0.3279,13,29,13,638432,38012,97895,28361,0.3010708401976936,0.42729724436141203
3239,0.328,19,39,19,638471,37973,97914,28342,0.30076194398682043,0.4273844529895197
3240,0.3281,17,27,17,638498,37946,97931,28325,0.30054809276390826,0.42741168837047877
3241,0.3282,12,35,12,638533,37911,97943,28313,0.30027087821568876,0.42753382459531286
3242,0.3283,29,44,29,638577,37867,97972,28284,0.29992237992649856,0.4275672325437257
3243,0.3284,19,39,19,638616,37828,97991,28265,0.2996134837156254,0.42765497102567596
3244,0.3285,16,41,16,638657,37787,98007,28249,0.2992887466734254,0.42778181597916287
3245,0.3286,19,48,19,638705,37739,98026,28230,0.29890856672158156,0.42792826933862876
3246,0.3287,18,35,18,638740,37704,98044,28212,0.29863135217336206,0.4279992718004733
3247,0.3288,24,28,24,638768,37676,98068,28188,0.29840958053478644,0.42797279242074576
3248,0.3289,19,29,19,638797,37647,98087,28169,0.29817988848054744,0.42799623191929015
3249,0.329,20,42,20,638839,37605,98107,28149,0.29784723102268407,0.42809562916324484
3250,0.3291,23,23,23,638862,37582,98130,28126,0.29766506146242555,0.428045291288732
3251,0.3292,12,34,12,638896,37548,98142,28114,0.2973957673298695,0.4281624074807347
3252,0.3293,12,36,12,638932,37512,98154,28102,0.29711063236598656,0.42829274240253606
3253,0.3294,14,25,14,638957,37487,98168,28088,0.2969126219744012,0.42833396873808616
3254,0.3295,15,37,15,638994,37450,98183,28073,0.2966195665948549,0.42844497352074845
3255,0.3296,20,27,20,639021,37423,98203,28053,0.2964057153719427,0.42844706457327875
3256,0.3297,18,45,18,639066,37378,98221,28035,0.29604929666708907,0.4285845321266415
3257,0.3298,19,29,19,639095,37349,98240,28016,0.29581960461285006,0.4286085825747724
3258,0.3299,12,41,12,639136,37308,98252,28004,0.29549486757065013,0.42877266046055856
3259,0.33,15,42,15,639178,37266,98267,27989,0.2951622101127867,0.4289173243429622
3260,0.3301,20,35,20,639213,37231,98287,27969,0.2948849955645672,0.4289723926380368
3261,0.3302,21,35,21,639248,37196,98308,27948,0.2946077810163477,0.4290187891440501
3262,0.3303,18,34,18,639282,37162,98326,27930,0.29433848688379166,0.42908498740244577
3263,0.3304,17,30,17,639312,37132,98343,27913,0.29410087441388927,0.42913367668537167
3264,0.3305,20,31,20,639343,37101,98363,27893,0.29385534152832343,0.42916269194079454
3265,0.3306,19,36,19,639379,37065,98382,27874,0.2935702065644405,0.42923358844454024
3266,0.3307,17,29,17,639408,37036,98399,27857,0.2933405145102015,0.42927588491825003
3267,0.3308,17,32,17,639440,37004,98416,27840,0.29308706120897227,0.4293381037567084
3268,0.3309,17,29,17,639469,36975,98433,27823,0.29285736915473326,0.42938053643630975
3269,0.331,15,41,15,639510,36934,98448,27808,0.2925326321125333,0.42952024960612895
3270,0.3311,21,23,21,639533,36911,98469,27787,0.29235046255227476,0.4294877739651921
3271,0.3312,19,44,19,639577,36867,98488,27768,0.2920019642630845,0.4296124390809933
3272,0.3313,10,30,10,639607,36837,98498,27758,0.2917643517931821,0.42972366282219987
3273,0.3314,18,31,18,639638,36806,98516,27740,0.2915188189076163,0.42977101601958295
3274,0.3315,14,25,14,639663,36781,98530,27726,0.2913208085160309,0.42981381865533974
3275,0.3316,13,31,13,639694,36750,98543,27713,0.2910752756304651,0.42990552720165054
3276,0.3317,15,42,15,639736,36708,98558,27698,0.2907426181726017,0.4300531006427973
3277,0.3318,13,28,13,639764,36680,98571,27685,0.2905208465340261,0.4301250679717238
3278,0.3319,20,29,20,639793,36651,98591,27665,0.2902911544797871,0.4301417998631756
3279,0.332,20,28,20,639821,36623,98611,27645,0.29006938284121153,0.4301518640692102
3280,0.3321,12,33,12,639854,36590,98623,27633,0.28980800912431887,0.4302664154586363
3281,0.3322,13,31,13,639885,36559,98636,27620,0.28956247623875303,0.4303588401190421
3282,0.3323,22,37,22,639922,36522,98658,27598,0.2892694208592067,0.4304117280099813
3283,0.3324,8,34,8,639956,36488,98666,27590,0.2890001267266506,0.43056899403851556
3284,0.3325,22,27,22,639983,36461,98688,27568,0.2887862755037384,0.4305549048087585
3285,0.3326,17,45,17,640028,36416,98705,27551,0.28842985679888483,0.43070645801741525
3286,0.3327,20,33,20,640061,36383,98725,27531,0.28816848308199217,0.4307506962480834
3287,0.3328,17,25,17,640086,36358,98742,27514,0.2879704726904068,0.43076778557114226
3288,0.3329,20,23,20,640109,36335,98762,27494,0.28778830313014825,0.43074464585063216
3289,0.333,20,37,20,640146,36298,98782,27474,0.287495247750602,0.43081603211440755
3290,0.3331,18,41,18,640187,36257,98800,27456,0.287170510708402,0.4309324627627015
3291,0.3332,20,30,20,640217,36227,98820,27436,0.28693289823849955,0.43095675667185024
3292,0.3333,16,28,16,640245,36199,98836,27420,0.286711126599924,0.43100331661924896
3293,0.3334,14,41,14,640286,36158,98850,27406,0.286386389557724,0.4311560002517148
3294,0.3335,7,30,7,640316,36128,98857,27399,0.28614877708782155,0.43129692886489207
3295,0.3336,12,22,12,640338,36106,98869,27387,0.2859745279432265,0.43133888775140566
3296,0.3337,14,36,14,640374,36070,98883,27373,0.28568939297934354,0.43145815929259335
3297,0.3338,10,29,10,640403,36041,98893,27363,0.28545970092510453,0.4315658318087187
3298,0.3339,15,32,15,640435,36009,98908,27348,0.2852062476238753,0.43164922581561627
3299,0.334,15,30,15,640465,35979,98923,27333,0.28496863515397286,0.4317191053828658
3300,0.3341,18,31,18,640496,35948,98941,27315,0.284723102268407,0.4317689644816085
3301,0.3342,24,32,24,640528,35916,98965,27291,0.2844696489671778,0.4317717974275001
3302,0.3343,18,38,18,640566,35878,98983,27273,0.2841686731719681,0.4318696457696632
3303,0.3344,14,35,14,640601,35843,98997,27259,0.2838914586237486,0.4319831384108269
3304,0.3345,18,29,18,640630,35814,99015,27241,0.2836617665695096,0.43201966537150105
3305,0.3346,14,25,14,640655,35789,99029,27227,0.28346375617792424,0.43206487241335534
3306,0.3347,20,34,20,640689,35755,99049,27207,0.28319446204536813,0.43211778533083445
3307,0.3348,18,41,18,640730,35714,99067,27189,0.28286972500316815,0.4322369362351557
3308,0.3349,9,39,9,640769,35675,99076,27180,0.282560828792295,0.43242383263065787
3309,0.335,12,26,12,640795,35649,99088,27168,0.28235489798504626,0.43249438846172217
3310,0.3351,16,23,16,640818,35626,99104,27152,0.28217272842478774,0.432508203510784
3311,0.3352,15,38,15,640856,35588,99119,27137,0.281871752629578,0.432634515743324
3312,0.3353,19,33,19,640889,35555,99138,27118,0.2816103789126853,0.43269031321302637
3313,0.3354,27,29,27,640918,35526,99165,27091,0.2813806868584463,0.43264608652602327
3314,0.3355,14,25,14,640943,35501,99179,27077,0.28118267646686096,0.43269200038352135
3315,0.3356,12,36,12,640979,35465,99191,27065,0.2808975415029781,0.4328322405245482
3316,0.3357,13,34,13,641013,35431,99204,27052,0.280628247370422,0.4329497623353552
3317,0.3358,12,37,12,641050,35394,99216,27040,0.2803351919908757,0.4330973508024474
3318,0.3359,15,29,15,641079,35365,99231,27025,0.2801054999366367,0.4331623657637442
3319,0.336,18,41,18,641120,35324,99249,27007,0.2797807628944367,0.4332835988512939
3320,0.3361,18,34,18,641154,35290,99267,26989,0.2795114687618806,0.4333563480466931
3321,0.3362,16,47,16,641201,35243,99283,26973,0.2791392092257002,0.43353799665680853
3322,0.3363,27,28,27,641229,35215,99310,26946,0.27891743758712456,0.43348723476134554
3323,0.3364,14,33,14,641262,35182,99324,26932,0.2786560638702319,0.43358985091927743
3324,0.3365,16,28,16,641290,35154,99340,26916,0.27843429223165633,0.4336394393426776
3325,0.3366,13,25,13,641315,35129,99353,26903,0.278236281840071,0.4336955119938096
3326,0.3367,15,36,15,641351,35093,99368,26888,0.27795114687618805,0.43381036123973477
3327,0.3368,16,40,16,641391,35053,99384,26872,0.2776343302496515,0.4339442874444893
3328,0.3369,11,25,11,641416,35028,99395,26861,0.27743631985806616,0.4340189694452972
3329,0.337,13,32,13,641448,34996,99408,26848,0.2771828665568369,0.4341245715024901
3330,0.3371,20,33,20,641481,34963,99428,26828,0.2769214928399442,0.4341732614782088
3331,0.3372,11,27,11,641508,34936,99439,26817,0.27670764161703204,0.4342623030460059
3332,0.3373,12,26,12,641534,34910,99451,26805,0.2765017108097833,0.43433525074941265
3333,0.3374,13,33,13,641567,34877,99464,26792,0.27624033709289064,0.4344484262757625
3334,0.3375,17,24,17,641591,34853,99481,26775,0.2760502471169687,0.43446160835983644
3335,0.3376,11,25,11,641616,34828,99492,26764,0.27585223672538334,0.4345369528510196
3336,0.3377,11,32,11,641648,34796,99503,26753,0.2755987834241541,0.43466181416432437
3337,0.3378,14,30,14,641678,34766,99517,26739,0.27536117095425167,0.4347451426713275
3338,0.3379,18,29,18,641707,34737,99535,26721,0.27513147890001266,0.4347847310358293
3339,0.338,25,29,25,641736,34708,99560,26696,0.27490178684577365,0.43475995049182464
3340,0.3381,12,21,12,641757,34687,99572,26684,0.27473545811684197,0.4347981945870199
3341,0.3382,13,28,13,641785,34659,99585,26671,0.2745136864782664,0.4348768954834502
3342,0.3383,19,39,19,641824,34620,99604,26652,0.27420479026739325,0.43497845671758717
3343,0.3384,8,25,8,641849,34595,99612,26644,0.2740067798758079,0.4350822188474665
3344,0.3385,19,32,19,641881,34563,99631,26625,0.2737533265745786,0.4351343400666797
3345,0.3386,16,23,16,641904,34540,99647,26609,0.2735711570143201,0.4351502068717395
3346,0.3387,20,29,20,641933,34511,99667,26589,0.2733414649600811,0.4351718494271686
3347,0.3388,12,35,12,641968,34476,99679,26577,0.2730642504118616,0.43531030416195765
3348,0.3389,14,30,14,641998,34446,99693,26563,0.2728266379419592,0.43539477781966596
3349,0.339,17,37,17,642035,34409,99710,26546,0.2725335825624129,0.4355015995406447
3350,0.3391,17,28,17,642063,34381,99727,26529,0.27231181092383727,0.4355442456082745
3351,0.3392,20,29,20,642092,34352,99747,26509,0.27208211886959827,0.4355662903994348
3352,0.3393,30,34,30,642126,34318,99777,26479,0.2718128247370422,0.4355313584551869
3353,0.3394,9,38,9,642164,34280,99786,26470,0.27151184894183245,0.4357201646090535
3354,0.3395,22,37,22,642201,34243,99808,26448,0.2712187935622862,0.43578125257451683
3355,0.3396,22,28,22,642229,34215,99830,26426,0.27099702192371056,0.4357777741132237
3356,0.3397,18,26,18,642255,34189,99848,26408,0.27079109111646177,0.43579715167417526
3357,0.3398,19,25,19,642280,34164,99867,26389,0.2705930807248764,0.43580004293759184
3358,0.3399,22,25,22,642305,34139,99889,26367,0.2703950703332911,0.4357749644663339
3359,0.34,19,35,19,642340,34104,99908,26348,0.2701178557850716,0.43584993052339044
3360,0.3401,11,36,11,642376,34068,99919,26337,0.2698327208211887,0.4360069530667991
3361,0.3402,14,23,14,642399,34045,99933,26323,0.2696505512609302,0.43604227405247814
3362,0.3403,18,23,18,642422,34022,99951,26305,0.26946838170067167,0.43604024731877933
3363,0.3404,15,28,15,642450,33994,99966,26290,0.26924661006209605,0.43610244841085527
3364,0.3405,24,36,24,642486,33958,99990,26266,0.26896147509821317,0.43613841657810837
3365,0.3406,17,28,17,642514,33930,100007,26249,0.26873970345963755,0.43618205686369
3366,0.3407,13,22,13,642536,33908,100020,26236,0.2685654543150425,0.436219739292365
3367,0.3408,25,33,25,642569,33875,100045,26211,0.2683040805981498,0.4362247445328363
3368,0.3409,16,33,16,642602,33842,100061,26195,0.26804270688125714,0.4363142728650665
3369,0.341,15,29,15,642631,33813,100076,26180,0.26781301482701814,0.4363842448285633
3370,0.3411,18,40,18,642671,33773,100094,26162,0.26749619820048154,0.43650621506632187
3371,0.3412,17,34,17,642705,33739,100111,26145,0.2672269040679255,0.4365940818916572
3372,0.3413,16,31,16,642736,33708,100127,26129,0.26698137118235965,0.4366696191319752
3373,0.3414,20,32,20,642768,33676,100147,26109,0.2667279178811304,0.436714895040562
3374,0.3415,13,29,13,642797,33647,100160,26096,0.2664982258268914,0.4368043118022195
3375,0.3416,17,25,17,642822,33622,100177,26079,0.266300215435306,0.436826853821544
3376,0.3417,18,37,18,642859,33585,100195,26061,0.26600716005575975,0.4369278744593099
3377,0.3418,12,30,12,642889,33555,100207,26049,0.2657695475858573,0.4370344272196497
3378,0.3419,18,34,18,642923,33521,100225,26031,0.26550025345330125,0.4371137829124127
3379,0.342,23,24,23,642947,33497,100248,26008,0.2653101634773793,0.43707251491471305
3380,0.3421,14,32,14,642979,33465,100262,25994,0.26505671017615007,0.43717519635379
3381,0.3422,15,23,15,643002,33442,100277,25979,0.2648745406158915,0.43720233587452245
3382,0.3423,18,28,18,643030,33414,100295,25961,0.26465276897731593,0.4372378947368421
3383,0.3424,16,24,16,643054,33390,100311,25945,0.264462679001394,0.4372629982303868
3384,0.3425,17,37,17,643091,33353,100328,25928,0.26416962362184765,0.4373745382162919
3385,0.3426,18,33,18,643124,33320,100346,25910,0.26390824990495504,0.4374472395745399
3386,0.3427,19,30,19,643154,33290,100365,25891,0.2636706374350526,0.4374883830959261
3387,0.3428,17,31,17,643185,33259,100382,25874,0.26342510454948675,0.4375560177904047
3388,0.3429,13,33,13,643218,33226,100395,25861,0.2631637308325941,0.43767664630121683
3389,0.343,22,27,22,643245,33199,100417,25839,0.2629498796096819,0.43766726515125853
3390,0.3431,19,35,19,643280,33164,100436,25820,0.2626726650614624,0.4377458293774583
3391,0.3432,15,29,15,643309,33135,100451,25805,0.2624429730072234,0.43781812012215815
3392,0.3433,16,35,16,643344,33100,100467,25789,0.2621657584590039,0.4379255888196437
3393,0.3434,17,21,17,643365,33079,100484,25772,0.26199942973007223,0.437919491597424
3394,0.3435,14,33,14,643398,33046,100498,25758,0.26173805601317957,0.43803142643357595
3395,0.3436,18,28,18,643426,33018,100516,25740,0.261516284374604,0.43806800776064536
3396,0.3437,16,28,16,643454,32990,100532,25724,0.2612945127360284,0.4381237864904452
3397,0.3438,8,33,8,643487,32957,100540,25716,0.2610331390191357,0.4382935933052682
3398,0.3439,14,25,14,643512,32932,100554,25702,0.26083512862755037,0.43834635194596994
3399,0.344,24,26,24,643538,32906,100578,25678,0.2606291978203016,0.4383108015840503
3400,0.3441,14,32,14,643570,32874,100592,25664,0.26037574451907236,0.43841607161160273
3401,0.3442,18,27,18,643597,32847,100610,25646,0.2601618932961602,0.43844562597233855
3402,0.3443,18,33,18,643630,32814,100628,25628,0.2599005195792675,0.43852024229150266
3403,0.3444,23,36,23,643666,32778,100651,25605,0.25961538461538464,0.43856944658547864
3404,0.3445,19,37,19,643703,32741,100670,25586,0.2593223292358383,0.4386647693178117
3405,0.3446,15,35,15,643738,32706,100685,25571,0.2590451146876188,0.4387837397257923
3406,0.3447,15,27,15,643765,32679,100700,25556,0.25883126346470664,0.43884262041727484
3407,0.3448,10,29,10,643794,32650,100710,25546,0.25860157141046763,0.4389648773111554
3408,0.3449,9,30,9,643824,32620,100719,25537,0.2583639589405652,0.4391044930102997
3409,0.345,9,33,9,643857,32587,100728,25528,0.2581025852236725,0.4392669706616192
3410,0.3451,18,28,18,643885,32559,100746,25510,0.25788081358509696,0.4393049647832751
3411,0.3452,11,28,11,643913,32531,100757,25499,0.25765904194652134,0.4394106496639669
3412,0.3453,16,31,16,643944,32500,100773,25483,0.2574135090609555,0.4394908852594726
3413,0.3454,14,31,14,643975,32469,100787,25469,0.25716797617538967,0.43959059684490315
3414,0.3455,24,27,24,644002,32442,100811,25445,0.2569541249524775,0.4395632870938207
3415,0.3456,14,28,14,644030,32414,100825,25431,0.25673235331390193,0.43964041835940876
3416,0.3457,10,32,10,644062,32382,100835,25421,0.25647890001267265,0.43978686227358443
3417,0.3458,21,25,21,644087,32357,100856,25400,0.2562808896210873,0.43977353394393753
3418,0.3459,15,30,15,644117,32327,100871,25385,0.2560432771511849,0.4398565289714444
3419,0.346,16,22,16,644139,32305,100887,25369,0.2558690280065898,0.43986891840344
3420,0.3461,18,26,18,644165,32279,100905,25351,0.255663097199341,0.4398924171438487
3421,0.3462,11,29,11,644194,32250,100916,25340,0.255433405145102,0.44000694565028653
3422,0.3463,14,31,14,644225,32219,100930,25326,0.2551878722595362,0.44010774176731254
3423,0.3464,13,24,13,644249,32195,100943,25313,0.25499778228361425,0.4401648466300341
3424,0.3465,22,39,22,644288,32156,100965,25291,0.2546888860727411,0.44024927324316326
3425,0.3466,15,34,15,644322,32122,100980,25276,0.25441959194018504,0.440363775741315
3426,0.3467,16,26,16,644348,32096,100996,25260,0.25421366113293625,0.4404072808424576
3427,0.3468,18,25,18,644373,32071,101014,25242,0.2540156507413509,0.4404236386160208
3428,0.3469,14,31,14,644404,32040,101028,25228,0.25377011785578507,0.4405252497031501
3429,0.347,19,32,19,644436,32008,101047,25209,0.25351666455455585,0.44058583987276506
3430,0.3471,13,37,13,644473,31971,101060,25196,0.2532236091750095,0.4407437857505204
3431,0.3472,16,26,16,644499,31945,101076,25180,0.25301767836776073,0.44078774617067834
3432,0.3473,11,25,11,644524,31920,101087,25169,0.2528196679761754,0.44087302282401164
3433,0.3474,8,24,8,644548,31896,101095,25161,0.25262957800025343,0.44098007255901994
3434,0.3475,14,43,14,644591,31853,101109,25147,0.25228900012672667,0.4411754385964912
3435,0.3476,15,17,15,644608,31836,101124,25132,0.2521543530604486,0.4411599494453026
3436,0.3477,10,23,10,644631,31813,101134,25122,0.2519721835001901,0.44124001053833317
3437,0.3478,16,21,16,644652,31792,101150,25106,0.2518058547712584,0.44124573798727545
3438,0.3479,17,31,17,644683,31761,101167,25089,0.25156032188569255,0.44131926121372034
3439,0.348,17,18,17,644701,31743,101184,25072,0.2514177544037511,0.4412919123470914
3440,0.3481,11,27,11,644728,31716,101195,25061,0.2512039031808389,0.44139352202476356
3441,0.3482,20,32,20,644760,31684,101215,25041,0.2509504498796097,0.44144557073600704
3442,0.3483,13,36,13,644796,31648,101228,25028,0.2506653149157268,0.4415978544710283
3443,0.3484,15,33,15,644829,31615,101243,25013,0.25040394119883413,0.44170728261637354
3444,0.3485,17,36,17,644865,31579,101260,24996,0.2501188062349512,0.44182059213433494
3445,0.3486,22,28,22,644893,31551,101282,24974,0.2498970345963756,0.44182220256523663
3446,0.3487,22,30,22,644923,31521,101304,24952,0.24965942212647318,0.44183946310626315
3447,0.3488,18,40,18,644963,31481,101322,24934,0.24934260549993664,0.4419746521315253
3448,0.3489,12,34,12,644997,31447,101334,24922,0.24907331136738056,0.442122443186858
3449,0.349,18,24,18,645021,31423,101352,24904,0.24888322139145863,0.4421325474461626
3450,0.3491,10,31,10,645052,31392,101362,24894,0.2486376885058928,0.44227694275663576
3451,0.3492,23,32,23,645084,31360,101385,24871,0.24838423520466354,0.4423005103946222
3452,0.3493,10,28,10,645112,31332,101395,24861,0.24816246356608795,0.4424216539426619
3453,0.3494,19,28,19,645140,31304,101414,24842,0.24794069192751236,0.4424536031061874
3454,0.3495,18,33,18,645173,31271,101432,24824,0.2476793182106197,0.4425349852928068
3455,0.3496,8,25,8,645198,31246,101440,24816,0.24748130781903435,0.44265277728229463
3456,0.3497,17,33,17,645231,31213,101457,24799,0.2472199341021417,0.4427444119117332
3457,0.3498,9,22,9,645253,31191,101466,24790,0.24704568495754659,0.44282881692002646
3458,0.3499,15,28,15,645281,31163,101481,24775,0.24682391331897097,0.4429010690407237
3459,0.35,8,31,8,645312,31132,101489,24767,0.24657838043340516,0.44306696005295265
3460,0.3501,15,31,15,645343,31101,101504,24752,0.24633284754783932,0.44316330367213935
3461,0.3502,8,32,8,645375,31069,101512,24744,0.24607939424661007,0.4433375736835504
3462,0.3503,16,29,16,645404,31040,101528,24728,0.24584970219237107,0.44340840625448286
3463,0.3504,8,23,8,645427,31017,101536,24720,0.24566753263211252,0.4435114914688627
3464,0.3505,12,31,12,645458,30986,101548,24708,0.2454219997465467,0.44363845297518584
3465,0.3506,19,24,19,645482,30962,101567,24689,0.24523190977062476,0.4436398267775961
3466,0.3507,14,34,14,645516,30928,101581,24675,0.24496261563806868,0.44377101954930487
3467,0.3508,13,25,13,645541,30903,101594,24662,0.24476460524648333,0.44384054710699183
3468,0.3509,7,35,7,645576,30868,101601,24655,0.24448739069826383,0.44405021342506706
3469,0.351,18,29,18,645605,30839,101619,24637,0.24425769864402483,0.4441019539981253
3470,0.3511,13,29,13,645634,30810,101632,24624,0.24402800658978582,0.44420391817296245
3471,0.3512,20,25,20,645659,30785,101652,24604,0.24382999619820048,0.44420372276083697
3472,0.3513,21,33,21,645692,30752,101673,24583,0.2435686224813078,0.44425770308123247
3473,0.3514,18,35,18,645727,30717,101691,24565,0.24329140793308832,0.4443580188849897
3474,0.3515,11,22,11,645749,30695,101702,24554,0.24311715878849322,0.44442433347209903
3475,0.3516,11,28,11,645777,30667,101713,24543,0.24289538714991762,0.44453903278391593
3476,0.3517,13,32,13,645809,30635,101726,24530,0.24264193384868837,0.44466600199401796
3477,0.3518,17,33,17,645842,30602,101743,24513,0.2423805601317957,0.44476095436813934
3478,0.3519,15,44,15,645886,30558,101758,24498,0.2420320618426055,0.4449651264167393
3479,0.352,15,20,15,645906,30538,101773,24483,0.2418736535293372,0.4449755547881718
3480,0.3521,18,34,18,645940,30504,101791,24465,0.24160435939678115,0.4450690389128418
3481,0.3522,17,23,17,645963,30481,101808,24448,0.2414221898365226,0.4450836534435362
3482,0.3523,16,28,16,645991,30453,101824,24432,0.24120041819794702,0.44514894779994535
3483,0.3524,10,25,10,646016,30428,101834,24422,0.24100240780636167,0.4452506836827712
3484,0.3525,16,27,16,646043,30401,101850,24406,0.2407885565834495,0.445308081084533
3485,0.3526,8,30,8,646073,30371,101858,24398,0.24055094411354708,0.4454709781080538
3486,0.3527,10,26,10,646099,30345,101868,24388,0.24034501330629832,0.44558127637805345
3487,0.3528,15,28,15,646127,30317,101883,24373,0.24012324166772273,0.44565734137867985
3488,0.3529,10,27,10,646154,30290,101893,24363,0.23990939044481055,0.44577607816588294
3489,0.353,10,20,10,646174,30270,101903,24353,0.23975098213154225,0.4458378338795013
3490,0.3531,13,25,13,646199,30245,101916,24340,0.2395529717399569,0.44591004854813593
3491,0.3532,14,30,14,646229,30215,101930,24326,0.23931535927005448,0.446013091069104
3492,0.3533,21,18,21,646247,30197,101951,24305,0.23917279178811304,0.4459469377270559
3493,0.3534,12,28,12,646275,30169,101963,24293,0.23895102014953745,0.44605412948477835
3494,0.3535,18,22,18,646297,30147,101981,24275,0.23877677100494235,0.44605122928227553
3495,0.3536,14,31,14,646328,30116,101995,24261,0.23853123811937652,0.4461628997554113
3496,0.3537,19,27,19,646355,30089,102014,24242,0.23831738689646434,0.44619094071524545
3497,0.3538,13,20,13,646375,30069,102027,24229,0.23815897858319604,0.4462226969685808
3498,0.3539,18,24,18,646399,30045,102045,24211,0.2379688886072741,0.44623636095547037
3499,0.354,17,20,17,646419,30025,102062,24194,0.23781048029400584,0.4462273372802892
3500,0.3541,21,27,21,646446,29998,102083,24173,0.23759662907109366,0.4462350704251352
3501,0.3542,23,28,23,646474,29970,102106,24150,0.23737485743251807,0.44623059866962306
3502,0.3543,11,26,11,646500,29944,102117,24139,0.23716892662526928,0.4463324889521661
3503,0.3544,20,22,20,646522,29922,102137,24119,0.23699467748067418,0.4463092836920116
3504,0.3545,16,29,16,646551,29893,102153,24103,0.23676498542643518,0.446384917401289
3505,0.3546,14,32,14,646583,29861,102167,24089,0.23651153212520593,0.44650602409638557
3506,0.3547,18,21,18,646604,29840,102185,24071,0.23634520339627424,0.4464951494129213
3507,0.3548,5,30,5,646634,29810,102190,24066,0.23610759092637182,0.44669240478134975
3508,0.3549,16,20,16,646654,29790,102206,24050,0.23594918261310355,0.44669390787518576
3509,0.355,16,25,16,646679,29765,102222,24034,0.23575117222151817,0.4467369281956914
3510,0.3551,11,35,11,646714,29730,102233,24023,0.2354739576732987,0.44691459081353596
3511,0.3552,9,28,9,646742,29702,102242,24014,0.23525218603472312,0.4470548812271949
3512,0.3553,11,30,11,646772,29672,102253,24003,0.2350145735648207,0.4471914299021891
3513,0.3554,16,24,16,646796,29648,102269,23987,0.23482448358889874,0.4472266244057052
3514,0.3555,11,18,11,646814,29630,102280,23976,0.2346819161069573,0.4472633660411148
3515,0.3556,11,21,11,646835,29609,102291,23965,0.2345155873780256,0.4473251950573039
3516,0.3557,7,22,7,646857,29587,102298,23958,0.23434133823343048,0.44743673545615836
3517,0.3558,23,22,23,646879,29565,102321,23935,0.23416708908883538,0.44738317757009344
3518,0.3559,17,33,17,646912,29532,102338,23918,0.2339057153719427,0.44748362956033677
3519,0.356,10,30,10,646942,29502,102348,23908,0.2336681029020403,0.4476315296760906
3520,0.3561,16,25,16,646967,29477,102364,23892,0.23347009251045495,0.4476756169311773
3521,0.3562,8,25,8,646992,29452,102372,23884,0.2332720821188696,0.44780260986950654
3522,0.3563,18,25,18,647017,29427,102390,23866,0.23307407172728425,0.4478261685399583
3523,0.3564,15,14,15,647031,29413,102405,23851,0.23296318590799645,0.44778837488735357
3524,0.3565,14,29,14,647060,29384,102419,23837,0.23273349385375744,0.4478871122301347
3525,0.3566,20,29,20,647089,29355,102439,23817,0.23250380179951843,0.4479237192507335
3526,0.3567,19,24,19,647113,29331,102458,23798,0.2323137118235965,0.4479286265504715
3527,0.3568,20,22,20,647135,29309,102478,23778,0.2321394626790014,0.4479062670710343
3528,0.3569,21,31,21,647166,29278,102499,23757,0.23189392979343557,0.44794946733289337
3529,0.357,17,22,17,647188,29256,102516,23740,0.23171968064884046,0.44795833647822475
3530,0.3571,7,26,7,647214,29230,102523,23733,0.23151374984159168,0.448105281045258
3531,0.3572,15,26,15,647240,29204,102538,23718,0.23130781903434292,0.4481690034390235
3532,0.3573,17,20,17,647260,29184,102555,23701,0.23114941072107464,0.4481611042828779
3533,0.3574,23,30,23,647290,29154,102578,23678,0.23091179825117222,0.4481753482737735
3534,0.3575,17,27,17,647317,29127,102595,23661,0.23069794702826005,0.4482268697431234
3535,0.3576,23,25,23,647342,29102,102618,23638,0.2304999366366747,0.44819871065604855
3536,0.3577,17,29,17,647371,29073,102635,23621,0.2302702445824357,0.4482673549170684
3537,0.3578,11,17,11,647388,29056,102646,23610,0.23013559751615764,0.44829681388372006
3538,0.3579,11,33,11,647421,29023,102657,23599,0.22987422379926498,0.4484626201968758
3539,0.358,15,25,15,647446,28998,102672,23584,0.22967621340767963,0.4485185044311742
3540,0.3581,8,41,8,647487,28957,102680,23576,0.22935147636547967,0.44878457350617706
3541,0.3582,19,23,19,647510,28934,102699,23557,0.22916930680522113,0.448781695909775
3542,0.3583,11,31,11,647541,28903,102710,23546,0.2289237739196553,0.4489313428282713
3543,0.3584,13,23,13,647564,28880,102723,23533,0.22874160435939678,0.44899166237383853
3544,0.3585,11,22,11,647586,28858,102734,23522,0.22856735521480168,0.4490645284459717
3545,0.3586,15,27,15,647613,28831,102749,23507,0.2283535039918895,0.4491382934005885
3546,0.3587,12,23,12,647636,28808,102761,23495,0.22817133443163098,0.44920941437393647
3547,0.3588,14,25,14,647661,28783,102775,23481,0.2279733240400456,0.449276748813715
3548,0.3589,17,27,17,647688,28756,102792,23464,0.22775947281713343,0.44932975871313674
3549,0.359,16,17,16,647705,28739,102808,23448,0.2276248257508554,0.4493072987525629
3550,0.3591,16,29,16,647734,28710,102824,23432,0.2273951336966164,0.44938820912124583
3551,0.3592,10,23,10,647757,28687,102834,23422,0.2272129641363579,0.4494808958145426
3552,0.3593,16,21,16,647778,28666,102850,23406,0.22704663540742617,0.44949300967890615
3553,0.3594,17,27,17,647805,28639,102867,23389,0.226832784184514,0.44954639809333435
3554,0.3595,9,30,9,647835,28609,102876,23380,0.22659517171461158,0.4497105156860105
3555,0.3596,17,25,17,647860,28584,102893,23363,0.22639716132302623,0.44974685737386183
3556,0.3597,19,19,19,647879,28565,102912,23344,0.22624667342542137,0.44971006954478027
3557,0.3598,11,20,11,647899,28545,102923,23333,0.22608826511215308,0.44976676047650255
3558,0.3599,12,33,12,647932,28512,102935,23321,0.2258268913952604,0.44992572299500316
3559,0.36,18,24,18,647956,28488,102953,23303,0.22563680141933848,0.4499430402965766
3560,0.3601,14,25,14,647981,28463,102967,23289,0.22543879102775313,0.45001159375483074
3561,0.3602,16,37,16,648018,28426,102983,23273,0.2251457356482068,0.45016344610147196
3562,0.3603,16,28,16,648046,28398,102999,23257,0.22492396400963122,0.45023715032426675
3563,0.3604,12,27,12,648073,28371,103011,23245,0.22471011278671904,0.4503448543087415
3564,0.3605,16,30,16,648103,28341,103027,23229,0.22447250031681662,0.4504363001745201
3565,0.3606,9,22,9,648125,28319,103036,23220,0.22429825117222152,0.45053260637575426
3566,0.3607,15,29,15,648154,28290,103051,23205,0.2240685591179825,0.4506262743955724
3567,0.3608,18,28,18,648182,28262,103069,23187,0.22384678747940692,0.4506793134949173
3568,0.3609,13,26,13,648208,28236,103082,23174,0.22364085667215816,0.4507683330091422
3569,0.361,20,29,20,648237,28207,103102,23154,0.22341116461791916,0.45080897957594285
3570,0.3611,12,24,12,648261,28183,103114,23142,0.22322107464199722,0.45089137847053096
3571,0.3612,10,23,10,648284,28160,103124,23132,0.22303890508173868,0.45098650861732825
3572,0.3613,13,25,13,648309,28135,103137,23119,0.22284089469015333,0.45106723377687596
3573,0.3614,16,24,16,648333,28111,103153,23103,0.2226508047142314,0.4511071191471082
3574,0.3615,11,28,11,648361,28083,103164,23092,0.2224290330756558,0.45123595505617975
3575,0.3616,24,29,24,648390,28054,103188,23068,0.2221993410214168,0.4512343022573452
3576,0.3617,11,22,11,648412,28032,103199,23057,0.2220250918768217,0.45131045821996907
3577,0.3618,9,30,9,648442,28002,103208,23048,0.22178747940691929,0.45147894221351614
3578,0.3619,18,22,18,648464,27980,103226,23030,0.22161323026232416,0.4514801019407959
3579,0.362,11,26,11,648490,27954,103237,23019,0.2214072994550754,0.45159201930433757
3580,0.3621,13,28,13,648518,27926,103250,23006,0.2211855278164998,0.4517003062907406
3581,0.3622,21,27,21,648545,27899,103271,22985,0.22097167659358763,0.45171370175300685
3582,0.3623,8,24,8,648569,27875,103279,22977,0.2207815866176657,0.45184063556988907
3583,0.3624,9,27,9,648596,27848,103288,22968,0.22056773539475352,0.45198362720403024
3584,0.3625,14,35,14,648631,27813,103302,22954,0.22029052084653403,0.4521441093623811
3585,0.3626,15,24,15,648655,27789,103317,22939,0.2201004308706121,0.4521960258634285
3586,0.3627,9,17,9,648672,27772,103326,22930,0.21996578380433404,0.4522504043233009
3587,0.3628,10,27,10,648699,27745,103336,22920,0.21975193258142187,0.4523833020823053
3588,0.3629,9,25,9,648724,27720,103345,22911,0.21955392218983652,0.45250933222729156
3589,0.363,19,31,19,648755,27689,103364,22892,0.21930838930427068,0.4525810086791483
3590,0.3631,11,25,11,648780,27664,103375,22881,0.21911037891268534,0.45268572559105746
3591,0.3632,15,13,15,648793,27651,103390,22866,0.21900741350906094,0.45263970544569154
3592,0.3633,6,31,6,648824,27620,103396,22860,0.2187618806234951,0.4528526148969889
3593,0.3634,15,16,15,648840,27604,103411,22845,0.2186351539728805,0.45283355467898273
3594,0.3635,14,35,14,648875,27569,103425,22831,0.218357939424661,0.45299603174603176
3595,0.3636,15,19,15,648894,27550,103440,22816,0.21820745152705615,0.45300401064209983
3596,0.3637,16,26,16,648920,27524,103456,22800,0.21800152071980738,0.4530641443446467
3597,0.3638,11,22,11,648942,27502,103467,22789,0.21782727157521226,0.45314270943111096
3598,0.3639,12,31,12,648973,27471,103479,22777,0.21758173868964642,0.45329167330042985
3599,0.364,17,36,17,649009,27435,103496,22760,0.21729660372576354,0.4534316166948899
3600,0.3641,16,16,16,649025,27419,103512,22744,0.2171698770751489,0.4534019097741363
3601,0.3642,13,28,13,649053,27391,103525,22731,0.2169481054365733,0.4535134272375404
3602,0.3643,13,26,13,649079,27365,103538,22718,0.21674217462932455,0.45360701235948325
3603,0.3644,12,28,12,649107,27337,103550,22706,0.21652040299074896,0.45372979237855443
3604,0.3645,8,20,8,649127,27317,103558,22698,0.21636199467748068,0.4538238528441468
3605,0.3646,18,36,18,649163,27281,103576,22680,0.21607685971359777,0.4539540841856648
3606,0.3647,13,27,13,649190,27254,103589,22667,0.2158630084906856,0.4540574107089201
3607,0.3648,8,26,8,649216,27228,103597,22659,0.21565707768343684,0.45420650670515367
3608,0.3649,19,16,19,649232,27212,103616,22640,0.2155303510328222,0.45414426703041
3609,0.365,6,26,6,649258,27186,103622,22634,0.21532442022557344,0.45431553592934565
3610,0.3651,17,29,17,649287,27157,103639,22617,0.21509472817133443,0.4543938602483224
3611,0.3652,22,21,22,649308,27136,103661,22595,0.21492839944240275,0.4543443727252619
3612,0.3653,19,15,19,649323,27121,103680,22576,0.21480959320745152,0.4542728937360404
3613,0.3654,17,19,17,649342,27102,103697,22559,0.21465910530984667,0.4542598819999597
3614,0.3655,18,23,18,649365,27079,103715,22541,0.21447693574958815,0.4542724707779121
3615,0.3656,15,19,15,649384,27060,103730,22526,0.21432644785198326,0.4542814504093897
3616,0.3657,6,29,6,649413,27031,103736,22520,0.21409675579774426,0.454481241549111
3617,0.3658,14,19,14,649432,27012,103750,22506,0.2139462679001394,0.45450139343269114
3618,0.3659,12,22,12,649454,26990,103762,22494,0.2137720187555443,0.45457117452105733
3619,0.366,15,16,15,649470,26974,103777,22479,0.21364529210492966,0.4545528077164176
3620,0.3661,15,29,15,649499,26945,103792,22464,0.21341560005069066,0.45465401040296305
3621,0.3662,15,22,15,649521,26923,103807,22449,0.21324135090609556,0.45469091792919064
3622,0.3663,6,23,6,649544,26900,103813,22443,0.21305918134583704,0.454836552297185
3623,0.3664,14,22,14,649566,26878,103827,22429,0.2128849322012419,0.4548847019692944
3624,0.3665,7,25,7,649591,26853,103834,22422,0.21268692180965657,0.45503805175038053
3625,0.3666,18,20,18,649611,26833,103852,22404,0.2125285134963883,0.4550236610678961
3626,0.3667,13,37,13,649648,26796,103865,22391,0.21223545811684197,0.45522190822778374
3627,0.3668,10,31,10,649679,26765,103875,22381,0.21198992523127613,0.45539820127782527
3628,0.3669,9,19,9,649698,26746,103884,22372,0.21183943733367128,0.4554745714402052
3629,0.367,15,31,15,649729,26715,103899,22357,0.21159390444810544,0.455595859145745
3630,0.3671,14,34,14,649763,26681,103913,22343,0.21132461031554936,0.455756364229765
3631,0.3672,12,27,12,649790,26654,103925,22331,0.21111075909263718,0.4558742472185363
3632,0.3673,17,18,17,649808,26636,103942,22314,0.21096819161069572,0.45585291113381
3633,0.3674,15,16,15,649824,26620,103957,22299,0.2108414649600811,0.45583515607432695
3634,0.3675,12,19,12,649843,26601,103969,22287,0.21069097706247625,0.45587874324987726
3635,0.3676,9,21,9,649864,26580,103978,22278,0.21052464833354453,0.4559744565884809
3636,0.3677,12,19,12,649883,26561,103990,22266,0.21037416043593968,0.4560181866590206
3637,0.3678,13,24,13,649907,26537,104003,22253,0.21018407046001775,0.4560975609756098
3638,0.3679,24,21,24,649928,26516,104027,22229,0.21001774173108606,0.4560262591034978
3639,0.368,16,28,16,649956,26488,104043,22213,0.20979597009251044,0.4561097308063489
3640,0.3681,12,22,12,649978,26466,104055,22201,0.20962172094791534,0.45618180697392485
3641,0.3682,20,27,20,650005,26439,104075,22181,0.20940786972500317,0.4562114356232003
3642,0.3683,11,21,11,650026,26418,104086,22170,0.20924154099607148,0.4562855025932329
3643,0.3684,10,26,10,650052,26392,104096,22160,0.20903561018882272,0.45641786126215195
3644,0.3685,12,33,12,650085,26359,104108,22148,0.20877423647193005,0.4565938936648319
3645,0.3686,12,35,12,650120,26324,104120,22136,0.20849702192371056,0.4567891044160132
3646,0.3687,12,24,12,650144,26300,104132,22124,0.20830693194778863,0.4568808855113167
3647,0.3688,17,27,17,650171,26273,104149,22107,0.20809308072487645,0.4569450186027284
3648,0.3689,14,11,14,650182,26262,104163,22093,0.20800595615257889,0.4568917381863303
3649,0.369,21,32,21,650214,26230,104184,22072,0.20775250285134964,0.45695830400397497
3650,0.3691,11,22,11,650236,26208,104195,22061,0.20757825370675453,0.4570428225154861
3651,0.3692,14,15,14,650251,26193,104209,22047,0.2074594474718033,0.4570273631840796
3652,0.3693,18,23,18,650274,26170,104227,22029,0.2072772779115448,0.4570426772339675
3653,0.3694,13,14,13,650288,26156,104240,22016,0.207166392092257,0.45702897949016025
3654,0.3695,12,20,12,650308,26136,104252,22004,0.2070079837789887,0.4570835064395513
3655,0.3696,4,24,4,650332,26112,104256,22000,0.20681789380306678,0.4572663784502827
3656,0.3697,11,18,11,650350,26094,104267,21989,0.20667532632112534,0.45731339558679784
3657,0.3698,12,15,12,650365,26079,104279,21977,0.20655652008617412,0.45732062593640754
3658,0.3699,15,14,15,650379,26065,104294,21962,0.20644563426688634,0.45728444416682285
3659,0.37,15,27,15,650406,26038,104309,21947,0.20623178304397416,0.4573720954464937
3660,0.3701,10,29,10,650435,26009,104319,21937,0.20600209098973515,0.45753556083927754
3661,0.3702,21,26,21,650461,25983,104340,21916,0.20579616018248637,0.45754608655713064
3662,0.3703,12,23,12,650484,25960,104352,21904,0.20561399062222785,0.4576299515293331
3663,0.3704,8,23,8,650507,25937,104360,21896,0.20543182106196933,0.4577592875211674
3664,0.3705,12,27,12,650534,25910,104372,21884,0.20521796983905716,0.45788174247813535
3665,0.3706,12,20,12,650554,25890,104384,21872,0.20505956152578889,0.4579372723085298
3666,0.3707,10,19,10,650573,25871,104394,21862,0.204909073628184,0.45800599166195294
3667,0.3708,15,17,15,650590,25854,104409,21847,0.20477442656190598,0.45799878409257666
3668,0.3709,16,22,16,650612,25832,104425,21831,0.20460017741731085,0.4580282399345404
3669,0.371,17,22,17,650634,25810,104442,21814,0.20442592827271575,0.45804636317822944
3670,0.3711,14,26,14,650660,25784,104456,21800,0.20421999746546698,0.45813718897108274
3671,0.3712,14,25,14,650685,25759,104470,21786,0.20402198707388164,0.4582185298138606
3672,0.3713,18,20,18,650705,25739,104488,21768,0.20386357876061337,0.4582061590923443
3673,0.3714,9,24,9,650729,25715,104497,21759,0.2036734887846914,0.45833508868011963
3674,0.3715,14,14,14,650743,25701,104511,21745,0.20356260296540363,0.45831050035830206
3675,0.3716,12,23,12,650766,25678,104523,21733,0.2033804334051451,0.45839573094851405
3676,0.3717,15,23,15,650789,25655,104538,21718,0.20319826384488657,0.4584467945876343
3677,0.3718,12,34,12,650823,25621,104550,21706,0.20292896971233051,0.45863883195638855
3678,0.3719,13,18,13,650841,25603,104563,21693,0.20278640223038905,0.4586645805142084
3679,0.372,10,22,10,650863,25581,104573,21683,0.20261215308579394,0.45876354096140826
3680,0.3721,6,18,6,650881,25563,104579,21677,0.2024695856038525,0.45886960203217614
3681,0.3722,14,28,14,650909,25535,104593,21663,0.20224781396527688,0.45898131276749016
3682,0.3723,20,20,20,650929,25515,104613,21643,0.2020894056520086,0.4589465202086602
3683,0.3724,19,20,19,650949,25495,104632,21624,0.20193099733874034,0.45892315201935524
3684,0.3725,15,18,15,650967,25477,104647,21609,0.20178842985679887,0.4589262201078877
3685,0.3726,13,18,13,650985,25459,104660,21596,0.20164586237485743,0.45895228987355224
3686,0.3727,13,26,13,651011,25433,104673,21583,0.20143993156760867,0.4590564914071805
3687,0.3728,20,24,20,651035,25409,104693,21563,0.20124984159168674,0.45906071702290724
3688,0.3729,19,27,19,651062,25382,104712,21544,0.20103599036877456,0.4591058261944338
3689,0.373,12,19,12,651081,25363,104724,21532,0.20088550247116968,0.4591534278707751
3690,0.3731,11,18,11,651099,25345,104735,21521,0.20074293498922824,0.45920283361071995
3691,0.3732,12,21,12,651120,25324,104747,21509,0.20057660626029655,0.459270172741443
3692,0.3733,16,20,16,651140,25304,104763,21493,0.20041819794702825,0.4592815778789239
3693,0.3734,12,27,12,651167,25277,104775,21481,0.20020434672411608,0.4594080157406219
3694,0.3735,16,23,16,651190,25254,104791,21465,0.20002217716385756,0.4594490464265074
3695,0.3736,13,21,13,651211,25233,104804,21452,0.19985584843492588,0.45950519438791904
3696,0.3737,15,13,15,651224,25220,104819,21437,0.19975288303130148,0.4594594594594595
3697,0.3738,17,21,17,651245,25199,104836,21420,0.1995865543023698,0.4594693150861237
3698,0.3739,13,25,13,651270,25174,104849,21407,0.19938854391078445,0.4595650587149267
3699,0.374,14,25,14,651295,25149,104863,21393,0.19919053351919908,0.4596493489751192
3700,0.3741,14,28,14,651323,25121,104877,21379,0.19896876188062348,0.45976344086021503
3701,0.3742,9,19,9,651342,25102,104886,21370,0.19881827398301863,0.4598467894646239
3702,0.3743,7,19,7,651361,25083,104893,21363,0.19866778608541377,0.459953494380571
3703,0.3744,10,26,10,651387,25057,104903,21353,0.198461855278165,0.46009480715363066
3704,0.3745,16,19,16,651406,25038,104919,21337,0.19831136738056013,0.46009703504043126
3705,0.3746,7,20,7,651426,25018,104926,21330,0.19815295906729186,0.46021403296798136
3706,0.3747,12,26,12,651452,24992,104938,21318,0.1979470282600431,0.460332541567696
3707,0.3748,14,15,14,651467,24977,104952,21304,0.19782822202509187,0.4603184892288412
3708,0.3749,16,24,16,651491,24953,104968,21288,0.19763813204916994,0.4603706667243355
3709,0.375,15,29,15,651520,24924,104983,21273,0.19740843999493093,0.4604844470420157
3710,0.3751,11,25,11,651545,24899,104994,21262,0.1972104296033456,0.460605272849375
3711,0.3752,8,23,8,651568,24876,105002,21254,0.19702826004308707,0.46074138304790807
3712,0.3753,19,29,19,651597,24847,105021,21235,0.19679856798884807,0.4608089926652489
3713,0.3754,9,22,9,651619,24825,105030,21226,0.19662431884425294,0.46092375844172767
3714,0.3755,16,21,16,651640,24804,105046,21210,0.19645799011532125,0.460946668405268
3715,0.3756,16,28,16,651668,24776,105062,21194,0.19623621847674566,0.46103980857080706
3716,0.3757,10,26,10,651694,24750,105072,21184,0.1960302876694969,0.4611834371054121
3717,0.3758,7,24,7,651718,24726,105079,21177,0.19584019769357497,0.4613423959218352
3718,0.3759,8,23,8,651741,24703,105087,21169,0.19565802813331643,0.46147976979420996
3719,0.376,9,22,9,651763,24681,105096,21160,0.19548377898872132,0.46159551493204776
3720,0.3761,10,23,10,651786,24658,105106,21150,0.1953016094284628,0.46170974502270345
3721,0.3762,22,27,22,651813,24631,105128,21128,0.19508775820555063,0.46172337682204595
3722,0.3763,14,22,14,651835,24609,105142,21114,0.19491350906095553,0.46178072304966866
3723,0.3764,11,22,11,651857,24587,105153,21103,0.1947392599163604,0.46187349529437516
3724,0.3765,10,22,10,651879,24565,105163,21093,0.1945650107717653,0.46197818564107057
3725,0.3766,15,24,15,651903,24541,105178,21078,0.19437492079584337,0.46204432363708103
3726,0.3767,14,24,14,651927,24517,105192,21064,0.19418483081992144,0.4621223755512165
3727,0.3768,11,17,11,651944,24500,105203,21053,0.19405018375364338,0.4621649507167475
3728,0.3769,16,21,16,651965,24479,105219,21037,0.1938838550247117,0.4621891203093418
3729,0.377,18,22,18,651987,24457,105237,21019,0.1937096058801166,0.46219984167472955
3730,0.3771,11,23,11,652010,24434,105248,21008,0.19352743631985805,0.46230359579243874
3731,0.3772,21,25,21,652035,24409,105269,20987,0.1933294259282727,0.46230945457749584
3732,0.3773,10,26,10,652061,24383,105279,20977,0.19312349512102395,0.4624559082892416
3733,0.3774,11,22,11,652083,24361,105290,20966,0.19294924597642885,0.46254991506166304
3734,0.3775,8,20,8,652103,24341,105298,20958,0.19279083766316057,0.4626592198503278
3735,0.3776,18,17,18,652120,24324,105316,20940,0.19265619059688252,0.4626193001060445
3736,0.3777,7,25,7,652145,24299,105323,20933,0.19245818020529717,0.46279182879377434
3737,0.3778,15,25,15,652170,24274,105338,20918,0.19226016981371183,0.4628695344308727
3738,0.3779,14,18,14,652188,24256,105352,20904,0.19211760233177036,0.4628875110717449
3739,0.378,8,22,8,652210,24234,105360,20896,0.19194335318717526,0.46301794814978947
3740,0.3781,8,20,8,652230,24214,105368,20888,0.191784944873907,0.46312802093033567
3741,0.3782,5,21,5,652251,24193,105373,20883,0.1916186161449753,0.4632842310764043
3742,0.3783,9,17,9,652268,24176,105382,20874,0.19148396907869725,0.46335183129855717
3743,0.3784,11,20,11,652288,24156,105393,20863,0.19132556076542898,0.46342655323307935
3744,0.3785,18,19,18,652307,24137,105411,20845,0.1911750728678241,0.46340758525632475
3745,0.3786,12,25,12,652332,24112,105423,20833,0.19097706247623875,0.46352208254533317
3746,0.3787,21,29,21,652361,24083,105444,20812,0.19074737042199974,0.4635705535137543
3747,0.3788,9,19,9,652380,24064,105453,20803,0.19059688252439488,0.46365925958945325
3748,0.3789,16,23,16,652403,24041,105469,20787,0.19041471296413637,0.463705719639511
3749,0.379,18,26,18,652429,24015,105487,20769,0.1902087821568876,0.4637593783494105
3750,0.3791,18,19,18,652448,23996,105505,20751,0.19005829425928272,0.46374058596107004
3751,0.3792,14,22,14,652470,23974,105519,20737,0.18988404511468762,0.46380085437588064
3752,0.3793,10,9,10,652479,23965,105529,20727,0.1898127613737169,0.463774277275575
3753,0.3794,9,33,9,652512,23932,105538,20718,0.18955138765682422,0.4640089585666293
3754,0.3795,9,24,9,652536,23908,105547,20709,0.1893612976809023,0.4641504359324921
3755,0.3796,14,15,14,652551,23893,105561,20695,0.1892424914459511,0.46413833318381625
3756,0.3797,17,18,17,652569,23875,105578,20678,0.18909992396400963,0.46412138352075055
3757,0.3798,10,17,10,652586,23858,105588,20668,0.1889652768977316,0.4641782329425504
3758,0.3799,7,14,7,652600,23844,105595,20661,0.1888543910784438,0.4642399730367374
3759,0.38,12,20,12,652620,23824,105607,20649,0.18869598276517552,0.4643041845614193
3760,0.3801,17,24,17,652644,23800,105624,20632,0.1885058927892536,0.4643500180050414
3761,0.3802,14,16,14,652660,23784,105638,20618,0.18837916613863895,0.4643484527723976
3762,0.3803,15,16,15,652676,23768,105653,20603,0.18825243948802434,0.46433481327894344
3763,0.3804,11,16,11,652692,23752,105664,20592,0.1881257128374097,0.4643694750135306
3764,0.3805,18,14,18,652706,23738,105682,20574,0.18801482701812192,0.464298609857375
3765,0.3806,14,12,14,652718,23726,105696,20560,0.18791978203016094,0.4642550693221334
3766,0.3807,15,25,15,652743,23701,105711,20545,0.1877217716385756,0.46433575916467024
3767,0.3808,17,34,17,652777,23667,105728,20528,0.1874524775060195,0.46448693291096277
3768,0.3809,13,19,13,652796,23648,105741,20515,0.18730198960841465,0.46452913072028623
3769,0.381,22,29,22,652825,23619,105763,20493,0.18707229755417565,0.4645674646354733
3770,0.3811,15,20,15,652845,23599,105778,20478,0.18691388924090735,0.4645960478253965
3771,0.3812,12,21,12,652866,23578,105790,20466,0.18674756051197566,0.4646716919444192
3772,0.3813,21,15,21,652881,23563,105811,20445,0.18662875427702447,0.4645746227958553
3773,0.3814,12,26,12,652907,23537,105823,20433,0.1864228234697757,0.46470320673186266
3774,0.3815,14,22,14,652929,23515,105837,20419,0.18624857432518058,0.4647653298129012
3775,0.3816,20,19,20,652948,23496,105857,20399,0.18609808642757572,0.46472263355735277
3776,0.3817,10,13,10,652961,23483,105867,20389,0.18599512102395133,0.4647383296863603
3777,0.3818,20,19,20,652980,23464,105887,20369,0.18584463312634647,0.46469554901558185
3778,0.3819,9,22,9,653002,23442,105896,20360,0.18567038398175137,0.46481895803844575
3779,0.382,12,15,12,653017,23427,105908,20348,0.18555157774680014,0.4648315248429469
3780,0.3821,5,20,5,653037,23407,105913,20343,0.18539316943353187,0.46498285714285714
3781,0.3822,14,29,14,653066,23378,105927,20329,0.18516347737929287,0.46512000366074086
3782,0.3823,14,19,14,653085,23359,105941,20315,0.185012989481688,0.4651508906901131
3783,0.3824,13,21,13,653106,23338,105954,20302,0.1848466607527563,0.4652153987167736
3784,0.3825,10,30,10,653136,23308,105964,20292,0.18460904828285388,0.46541284403669725
3785,0.3826,22,12,22,653148,23296,105986,20270,0.18451400329489293,0.4652710829545976
3786,0.3827,15,19,15,653167,23277,106001,20255,0.18436351539728804,0.4652899016815216
3787,0.3828,8,19,8,653186,23258,106009,20247,0.18421302749968319,0.4653947822089415
3788,0.3829,17,31,17,653217,23227,106026,20230,0.18396749461411735,0.46551763812504315
3789,0.383,15,18,15,653235,23209,106041,20215,0.1838249271321759,0.46552597641857035
3790,0.3831,9,24,9,653259,23185,106050,20206,0.18363483715625395,0.46567260491807055
3791,0.3832,8,26,8,653285,23159,106058,20198,0.1834289063490052,0.46585326475540284
3792,0.3833,8,25,8,653310,23134,106066,20190,0.18323089595741984,0.4660234512048749
3793,0.3834,9,17,9,653327,23117,106075,20181,0.18309624889114182,0.46609543165966094
3794,0.3835,22,20,22,653347,23097,106097,20159,0.18293784057787352,0.4660393933789532
3795,0.3836,14,15,14,653362,23082,106111,20145,0.18281903434292232,0.4660281768339232
3796,0.3837,17,18,17,653380,23064,106128,20128,0.18267646686098085,0.4660122244860159
3797,0.3838,6,19,6,653399,23045,106134,20122,0.182525978963376,0.46614311858595686
3798,0.3839,14,15,14,653414,23030,106148,20108,0.1824071727284248,0.4661319486299782
3799,0.384,11,20,11,653434,23010,106159,20097,0.1822487644151565,0.4662119841325075
3800,0.3841,5,20,5,653454,22990,106164,20092,0.18209035610188823,0.46636646395246273
3801,0.3842,15,14,15,653468,22976,106179,20077,0.18197947028260042,0.46633219520126357
3802,0.3843,10,17,10,653485,22959,106189,20067,0.1818448232163224,0.46639241388927627
3803,0.3844,8,16,8,653501,22943,106197,20059,0.18171809656570778,0.4664666759685596
3804,0.3845,11,22,11,653523,22921,106208,20048,0.18154384742111265,0.4665689217808187
3805,0.3846,13,21,13,653544,22900,106221,20035,0.18137751869218097,0.46663561197158493
3806,0.3847,9,28,9,653572,22872,106230,20026,0.18115574705360538,0.46682829036318707
3807,0.3848,7,12,7,653584,22860,106237,20019,0.1810607020656444,0.46687189533337997
3808,0.3849,11,19,11,653603,22841,106248,20008,0.18091021416803954,0.46694205232327474
3809,0.385,6,13,6,653616,22828,106254,20002,0.18080724876441515,0.46700910576698573
3810,0.3851,17,21,17,653637,22807,106271,19985,0.18064092003548346,0.46702654701813423
3811,0.3852,14,14,14,653651,22793,106285,19971,0.18053003421619568,0.4670049574408381
3812,0.3853,7,24,7,653675,22769,106292,19964,0.18033994424027372,0.4671799312007114
3813,0.3854,15,19,15,653694,22750,106307,19949,0.18018945634266886,0.46720063701726033
3814,0.3855,20,18,20,653712,22732,106327,19929,0.18004688886072742,0.46714798059117224
3815,0.3856,18,22,18,653734,22710,106345,19911,0.1798726397161323,0.46716407404800453
3816,0.3857,17,28,17,653762,22682,106362,19894,0.1796508680775567,0.4672585494175122
3817,0.3858,18,22,18,653784,22660,106380,19876,0.1794766189329616,0.46727477901072034
3818,0.3859,8,18,8,653802,22642,106388,19868,0.17933405145102016,0.46737238296871325
3819,0.386,23,19,23,653821,22623,106411,19845,0.17918356355341528,0.46729302062729583
3820,0.3861,10,25,10,653846,22598,106421,19835,0.17898555316182993,0.4674427921664742
3821,0.3862,7,18,7,653864,22580,106428,19828,0.1788429856798885,0.4675532918317299
3822,0.3863,11,19,11,653883,22561,106439,19817,0.1786924977822836,0.4676247109349191
3823,0.3864,14,22,14,653905,22539,106453,19803,0.1785182486376885,0.46769165367719995
3824,0.3865,14,15,14,653920,22524,106467,19789,0.1783994424027373,0.46768132725167205
3825,0.3866,17,17,17,653937,22507,106484,19772,0.17826479533645925,0.46765533716502283
3826,0.3867,14,23,14,653960,22484,106498,19758,0.17808262577620074,0.46773353534397044
3827,0.3868,19,15,19,653975,22469,106517,19739,0.1779638195412495,0.4676601592115239
3828,0.3869,6,22,6,653997,22447,106523,19733,0.1777895703966544,0.4678283546704599
3829,0.387,23,21,23,654018,22426,106546,19710,0.17762324166772273,0.4677710271501804
3830,0.3871,14,20,14,654038,22406,106560,19696,0.17746483335445445,0.4678162557598214
3831,0.3872,13,24,13,654062,22382,106573,19683,0.1772747433785325,0.4679186972542494
3832,0.3873,19,18,19,654080,22364,106592,19664,0.17713217589659105,0.4678785571523746
3833,0.3874,10,26,10,654106,22338,106602,19654,0.1769262450893423,0.4680415317203277
3834,0.3875,12,16,12,654122,22322,106614,19642,0.17679951843872765,0.46806786769612047
3835,0.3876,14,20,14,654142,22302,106628,19628,0.17664111012545938,0.4681135225375626
3836,0.3877,11,25,11,654167,22277,106639,19617,0.17644309973387404,0.46825321048360147
3837,0.3878,14,20,14,654187,22257,106653,19603,0.17628469142060577,0.46829909221213567
3838,0.3879,14,23,14,654210,22234,106667,19589,0.17610252186034722,0.468378643330225
3839,0.388,11,22,11,654232,22212,106678,19578,0.17592827271575212,0.46848528356066044
3840,0.3881,15,21,15,654253,22191,106693,19563,0.17576194398682043,0.468529961201322
3841,0.3882,15,17,15,654270,22174,106708,19548,0.17562729692054238,0.46852979243564546
3842,0.3883,11,17,11,654287,22157,106719,19537,0.17549264985426435,0.46858061111910587
3843,0.3884,14,13,14,654300,22144,106733,19523,0.17538968445063996,0.4685482516139871
3844,0.3885,12,20,12,654320,22124,106745,19511,0.1752312761373717,0.4686201513149994
3845,0.3886,15,25,15,654345,22099,106760,19496,0.17503326574578634,0.468710181512201
3846,0.3887,9,18,9,654363,22081,106769,19487,0.17489069826384487,0.4687981139337952
3847,0.3888,13,20,13,654383,22061,106782,19474,0.1747322899505766,0.46885758998435056
3848,0.3889,15,13,15,654396,22048,106797,19459,0.17462932454695224,0.46881248945960924
3849,0.389,11,22,11,654418,22026,106808,19448,0.1744550754023571,0.4689202874089791
3850,0.3891,11,24,11,654442,22002,106819,19437,0.17426498542643518,0.469050894085282
3851,0.3892,20,14,20,654456,21988,106839,19417,0.1741540996071474,0.46895302499698105
3852,0.3893,9,14,9,654470,21974,106848,19408,0.17404321378785959,0.4689961819148422
3853,0.3894,10,20,10,654490,21954,106858,19398,0.17388480547459131,0.4690946024376088
3854,0.3895,10,7,10,654497,21947,106868,19388,0.1738293625649474,0.469045602999879
3855,0.3896,15,18,15,654515,21929,106883,19373,0.17368679508300597,0.4690571885138734
3856,0.3897,7,13,7,654528,21916,106890,19366,0.17358382967938157,0.46911486846567513
3857,0.3898,8,13,8,654541,21903,106898,19358,0.17348086427575718,0.4691597392210562
3858,0.3899,12,20,12,654561,21883,106910,19346,0.1733224559624889,0.46923282155764146
3859,0.39,8,17,8,654578,21866,106918,19338,0.17318780889621088,0.4693233666634307
3860,0.3901,9,18,9,654596,21848,106927,19329,0.1730452414142694,0.46941253612453554
3861,0.3902,11,17,11,654613,21831,106938,19318,0.1729105943479914,0.4694646285450436
3862,0.3903,18,21,18,654634,21810,106956,19300,0.1727442656190597,0.4694721478958891
3863,0.3904,15,16,15,654650,21794,106971,19285,0.17261753896844506,0.46946128192020253
3864,0.3905,15,13,15,654663,21781,106986,19270,0.1725145735648207,0.46941609217802244
3865,0.3906,14,25,14,654688,21756,107000,19256,0.17231656317323532,0.46952111577099387
3866,0.3907,14,20,14,654708,21736,107014,19242,0.17215815485996705,0.46956903704426767
3867,0.3908,23,19,23,654727,21717,107037,19219,0.1720076669623622,0.4694889583740473
3868,0.3909,18,14,18,654741,21703,107055,19201,0.17189678114307438,0.46941619401525525
3869,0.391,18,19,18,654760,21684,107073,19183,0.17174629324546953,0.46940073898255313
3870,0.3911,10,23,10,654783,21661,107083,19173,0.171564123685211,0.46953519126218346
3871,0.3912,13,15,13,654798,21646,107096,19160,0.1714453174502598,0.4695387933147086
3872,0.3913,12,12,12,654810,21634,107108,19148,0.1713502724622988,0.4695208670491884
3873,0.3914,14,17,14,654827,21617,107122,19134,0.17121562539602078,0.46953448995116687
3874,0.3915,8,18,8,654845,21599,107130,19126,0.17107305791407934,0.4696378146101903
3875,0.3916,14,19,14,654864,21580,107144,19112,0.17092257001647446,0.46967462891968936
3876,0.3917,19,17,19,654881,21563,107163,19093,0.17078792295019643,0.4696231798504526
3877,0.3918,19,22,19,654903,21541,107182,19074,0.17061367380560133,0.4696294472485535
3878,0.3919,14,15,14,654918,21526,107196,19060,0.1704948675706501,0.4696200660326221
3879,0.392,9,20,9,654938,21506,107205,19051,0.17033645925738183,0.46973395468106616
3880,0.3921,17,18,17,654956,21488,107222,19034,0.17019389177544036,0.4697201520161887
3881,0.3922,9,20,9,654976,21468,107231,19025,0.1700354834621721,0.4698342923468254
3882,0.3923,11,13,11,654989,21455,107242,19014,0.1699325180585477,0.46984111295065356
3883,0.3924,15,14,15,655003,21441,107257,18999,0.16982163223925992,0.46980712166172106
3884,0.3925,14,13,14,655016,21428,107271,18985,0.16971866683563552,0.46977457748744217
3885,0.3926,10,23,10,655039,21405,107281,18975,0.169536497275377,0.4699108469539376
3886,0.3927,13,17,13,655056,21388,107294,18962,0.16940185020909898,0.4699380421313507
3887,0.3928,15,20,15,655076,21368,107309,18947,0.16924344189583068,0.4699739551035595
3888,0.3929,13,12,13,655088,21356,107322,18934,0.16914839690786973,0.4699429138744105
3889,0.393,13,20,13,655108,21336,107335,18921,0.16898998859460143,0.4700052164840897
3890,0.3931,12,15,12,655123,21321,107347,18909,0.16887118235965023,0.47002237136465325
3891,0.3932,10,24,10,655147,21297,107357,18899,0.1686810923837283,0.47017116130958303
3892,0.3933,13,20,13,655167,21277,107370,18886,0.16852268407046,0.4702337972760999
3893,0.3934,14,14,14,655181,21263,107384,18872,0.16841179825117222,0.4702130310203065
3894,0.3935,14,17,14,655198,21246,107398,18858,0.1682771511848942,0.4702274087372831
3895,0.3936,15,21,15,655219,21225,107413,18843,0.16811082245596248,0.4702755315962863
3896,0.3937,14,20,14,655239,21205,107427,18829,0.1679524141426942,0.470325223559974
3897,0.3938,5,16,5,655255,21189,107432,18824,0.16782568749207957,0.47044710469097545
3898,0.3939,16,17,16,655272,21172,107448,18808,0.16769104042580155,0.4704352176088044
3899,0.394,12,17,12,655289,21155,107460,18796,0.16755639335952352,0.47047633350854795
3900,0.3941,21,17,21,655306,21138,107481,18775,0.16742174629324547,0.470398115902087
3901,0.3942,9,27,9,655333,21111,107490,18766,0.1672078950703333,0.4705970860395717
3902,0.3943,9,15,9,655348,21096,107499,18757,0.1670890888353821,0.47065465586028654
3903,0.3944,8,13,8,655361,21083,107507,18749,0.1669861234317577,0.47070194818236594
3904,0.3945,13,21,13,655382,21062,107520,18736,0.166819794702826,0.4707774260013066
3905,0.3946,15,18,15,655400,21044,107535,18721,0.16667722722088454,0.4707908965170376
3906,0.3947,13,22,13,655422,21022,107548,18708,0.16650297807628944,0.4708784293984395
3907,0.3948,8,22,8,655444,21000,107556,18700,0.16632872893169434,0.47103274559193953
3908,0.3949,13,13,13,655457,20987,107569,18687,0.16622576352806995,0.47101376216161717
3909,0.395,19,17,19,655474,20970,107588,18668,0.16609111646179192,0.47096220798223926
3910,0.3951,10,20,10,655494,20950,107598,18658,0.16593270814852362,0.4710664512219754
3911,0.3952,19,29,19,655523,20921,107617,18639,0.16570301609428462,0.4711577350859454
3912,0.3953,17,12,17,655535,20909,107634,18622,0.16560797110632366,0.4710733348511295
3913,0.3954,11,31,11,655566,20878,107645,18611,0.16536243822075783,0.4712958038947555
3914,0.3955,8,17,8,655583,20861,107653,18603,0.16522779115447978,0.47139164808433004
3915,0.3956,9,19,9,655602,20842,107662,18594,0.16507730325687492,0.47149812354194137
3916,0.3957,20,19,20,655621,20823,107682,18574,0.16492681535927006,0.47145721755463615
3917,0.3958,18,12,18,655633,20811,107700,18556,0.16483177037130908,0.471359260294155
3918,0.3959,13,24,13,655657,20787,107713,18543,0.16464168039538715,0.47147215865751335
3919,0.396,10,15,10,655672,20772,107723,18533,0.16452287416043593,0.47151761862358477
3920,0.3961,16,18,16,655690,20754,107739,18517,0.1643803066784945,0.47151842326398613
3921,0.3962,17,21,17,655711,20733,107756,18500,0.1642139779495628,0.4715418142889914
3922,0.3963,17,13,17,655724,20720,107773,18483,0.1641110125459384,0.47146902022804377
3923,0.3964,18,23,18,655747,20697,107791,18465,0.1639288429856799,0.47150298759001075
3924,0.3965,16,18,16,655765,20679,107807,18449,0.16378627550373845,0.4715037824575751
3925,0.3966,14,27,14,655792,20652,107821,18435,0.16357242428082625,0.47164018727454143
3926,0.3967,12,18,12,655810,20634,107833,18423,0.1634298567988848,0.4716952146862278
3927,0.3968,13,20,13,655830,20614,107846,18410,0.16327144848561653,0.4717609676096761
3928,0.3969,12,21,12,655851,20593,107858,18398,0.16310511975668482,0.4718524787771537
3929,0.397,13,11,13,655862,20582,107871,18385,0.16301799518438728,0.47180947981625476
3930,0.3971,6,25,6,655887,20557,107877,18379,0.16281998479280194,0.4720310252722416
3931,0.3972,15,20,15,655907,20537,107892,18364,0.16266157647953364,0.47207012673196064
3932,0.3973,14,20,14,655927,20517,107906,18350,0.16250316816626537,0.4721228805927908
3933,0.3974,21,17,21,655944,20500,107927,18329,0.16236852109998734,0.4720440907569085
3934,0.3975,12,19,12,655963,20481,107939,18317,0.16221803320238246,0.47211196453425436
3935,0.3976,9,12,9,655975,20469,107948,18308,0.1621229882144215,0.47213554426593085
3936,0.3977,8,10,8,655985,20459,107956,18300,0.16204378405778735,0.4721484042415955
3937,0.3978,14,23,14,656008,20436,107970,18286,0.16186161449752884,0.4722380042353184
3938,0.3979,10,12,10,656020,20424,107980,18276,0.16176656950956786,0.4722480620155039
3939,0.398,16,24,16,656044,20400,107996,18260,0.16157647953364593,0.47232281427832384
3940,0.3981,9,16,9,656060,20384,108005,18251,0.1614497528830313,0.4723954963116345
3941,0.3982,12,20,12,656080,20364,108017,18239,0.16129134456976302,0.47247623241716963
3942,0.3983,15,22,15,656102,20342,108032,18224,0.16111709542516792,0.4725405797853031
3943,0.3984,9,17,9,656119,20325,108041,18215,0.16098244835888986,0.4726258432797094
3944,0.3985,6,15,6,656134,20310,108047,18209,0.16086364212393867,0.4727277447493445
3945,0.3986,11,16,11,656150,20294,108058,18198,0.16073691547332403,0.47277356333783643
3946,0.3987,18,17,18,656167,20277,108076,18180,0.160602268407046,0.47273578282237305
3947,0.3988,6,11,6,656178,20266,108082,18174,0.16051514383474844,0.47278876170655565
3948,0.3989,9,13,9,656191,20253,108091,18165,0.16041217843112407,0.472825238169608
3949,0.399,12,20,12,656211,20233,108103,18153,0.1602537701178558,0.4729067889334653
3950,0.3991,11,26,11,656237,20207,108114,18142,0.160047839310607,0.47307622102271246
3951,0.3992,16,21,16,656258,20186,108130,18126,0.15988151058167532,0.4731154729588641
3952,0.3993,4,16,4,656274,20170,108134,18122,0.1597547839310607,0.4732581218008984
3953,0.3994,10,20,10,656294,20150,108144,18112,0.1595963756177924,0.4733678323140453
3954,0.3995,12,27,12,656321,20123,108156,18100,0.15938252439488024,0.4735368757031107
3955,0.3996,14,21,14,656342,20102,108170,18086,0.15921619566594855,0.4736042735937991
3956,0.3997,14,11,14,656353,20091,108184,18072,0.159129071093651,0.4735476770694128
3957,0.3998,17,18,17,656371,20073,108201,18055,0.15898650361170955,0.47353650860260177
3958,0.3999,10,16,10,656387,20057,108211,18045,0.1588597769610949,0.47359718649939636
3959,0.4,6,18,6,656405,20039,108217,18039,0.15871720947915346,0.4737381164977152
3960,0.4001,6,20,6,656425,20019,108223,18033,0.1585588011658852,0.4739041311888994
3961,0.4002,13,23,13,656448,19996,108236,18020,0.15837663160562665,0.47401094276094274
3962,0.4003,13,20,13,656468,19976,108249,18007,0.15821822329235838,0.4740805097017087
3963,0.4004,11,16,11,656484,19960,108260,17996,0.15809149664174377,0.47412793761197175
3964,0.4005,8,19,8,656503,19941,108268,17988,0.15794100874413888,0.4742545281974215
3965,0.4006,9,19,9,656522,19922,108277,17979,0.15779052084653403,0.47436743093849765
3966,0.4007,12,21,12,656543,19901,108289,17967,0.15762419211760234,0.4744639273265026
3967,0.4008,13,18,13,656561,19883,108302,17954,0.15748162463566087,0.47450907841530776
3968,0.4009,14,19,14,656580,19864,108316,17940,0.15733113673805602,0.47455295735900965
3969,0.401,17,17,17,656597,19847,108333,17923,0.15719648967177796,0.4745300503044744
3970,0.4011,2,19,2,656616,19828,108335,17921,0.1570460017741731,0.474741052743119
3971,0.4012,10,15,10,656631,19813,108345,17911,0.1569271955392219,0.47479058424345244
3972,0.4013,13,21,13,656652,19792,108358,17898,0.1567608668102902,0.47487397187582914
3973,0.4014,11,17,11,656669,19775,108369,17887,0.15662621974401217,0.4749349476926345
3974,0.4015,14,12,14,656681,19763,108383,17873,0.1565311747560512,0.4748910617493889
3975,0.4016,15,16,15,656697,19747,108398,17858,0.15640444810543658,0.47488365908788727
3976,0.4017,9,20,9,656717,19727,108407,17849,0.1562460397921683,0.4750106450926123
3977,0.4018,15,20,15,656737,19707,108422,17834,0.1560876314789,0.4750539410244799
3978,0.4019,9,21,9,656758,19686,108431,17825,0.15592130274996832,0.47519394311002106
3979,0.402,9,24,9,656782,19662,108440,17816,0.1557312127740464,0.4753722183681093
3980,0.4021,9,19,9,656801,19643,108449,17807,0.1555807248764415,0.47548731642189584
3981,0.4022,8,16,8,656817,19627,108457,17799,0.1554539982258269,0.47557847485705124
3982,0.4023,11,15,11,656832,19612,108468,17788,0.15533519199087567,0.47561497326203206
3983,0.4024,11,15,11,656847,19597,108479,17777,0.15521638575592447,0.4756515224487612
3984,0.4025,6,14,6,656861,19583,108485,17771,0.15510549993663666,0.4757455694169299
3985,0.4026,11,26,11,656887,19557,108496,17760,0.1548995691293879,0.47592250180882706
3986,0.4027,15,18,15,656905,19539,108511,17745,0.15475700164744646,0.47594142259414224
3987,0.4028,15,13,15,656918,19526,108526,17730,0.15465403624382207,0.4758964998926347
3988,0.4029,14,15,14,656933,19511,108540,17716,0.15453523000887087,0.4758911542697504
3989,0.403,16,24,16,656957,19487,108556,17700,0.15434514003294894,0.47597278618872185
3990,0.4031,11,18,11,656975,19469,108567,17689,0.15420257255100747,0.47604822649227624
3991,0.4032,9,14,9,656989,19455,108576,17680,0.1540916867317197,0.47610071361249495
3992,0.4033,10,18,10,657007,19437,108586,17670,0.15394911924977822,0.47619047619047616
3993,0.4034,11,22,11,657029,19415,108597,17659,0.15377487010518312,0.47631763500026975
3994,0.4035,15,17,15,657046,19398,108612,17644,0.1536402230389051,0.47632417256087684
3995,0.4036,15,11,15,657057,19387,108627,17629,0.15355309846660753,0.47625351199481303
3996,0.4037,18,20,18,657077,19367,108645,17611,0.15339469015333926,0.476256152306777
3997,0.4038,8,17,8,657094,19350,108653,17603,0.1532600430870612,0.476361865071848
3998,0.4039,17,23,17,657117,19327,108670,17586,0.1530778735268027,0.4764175222821228
3999,0.404,13,28,13,657145,19299,108683,17573,0.1528561018882271,0.4765947060099805
4000,0.4041,9,32,9,657177,19267,108692,17564,0.15260264858699785,0.47688088838206943
4001,0.4042,14,20,14,657197,19247,108706,17550,0.15244424027372958,0.47694105497730793
4002,0.4043,23,20,23,657217,19227,108729,17527,0.15228583196046128,0.4768732654949121
4003,0.4044,20,15,20,657232,19212,108749,17507,0.15216702572551008,0.47678313679566436
4004,0.4045,6,14,6,657246,19198,108755,17501,0.15205613990622227,0.47687947900487754
4005,0.4046,13,23,13,657269,19175,108768,17488,0.15187397034596375,0.4769931538608406
4006,0.4047,17,17,17,657286,19158,108785,17471,0.15173932327968573,0.47697179830189196
4007,0.4048,12,14,12,657300,19144,108797,17459,0.15162843746039792,0.4769827609758763
4008,0.4049,12,22,12,657322,19122,108809,17447,0.15145418831580282,0.47709808854494246
4009,0.405,9,14,9,657336,19108,108818,17438,0.151343302496515,0.4771520823072292
4010,0.4051,8,16,8,657352,19092,108826,17430,0.1512165758459004,0.4772465910957779
4011,0.4052,7,22,7,657374,19070,108833,17423,0.1510423267013053,0.47743402844381116
4012,0.4053,18,17,18,657391,19053,108851,17405,0.15090767963502724,0.47739865050194746
4013,0.4054,15,11,15,657402,19042,108866,17390,0.1508205550627297,0.4773276240667545
4014,0.4055,8,18,8,657420,19024,108874,17382,0.15067798758078824,0.4774487721804098
4015,0.4056,5,22,5,657442,19002,108879,17377,0.15050373843619314,0.4776656862475604
4016,0.4057,8,14,8,657456,18988,108887,17369,0.15039285261690533,0.4777346865803009
4017,0.4058,15,20,15,657476,18968,108902,17354,0.15023444430363705,0.47778206045922583
4018,0.4059,8,18,8,657494,18950,108910,17346,0.1500918768216956,0.4779039012563368
4019,0.406,9,21,9,657515,18929,108919,17337,0.1499255480927639,0.47805106711520434
4020,0.4061,12,23,12,657538,18906,108931,17325,0.14974337853250538,0.4781816676326902
4021,0.4062,12,17,12,657555,18889,108943,17313,0.14960873146622736,0.47823324678194573
4022,0.4063,9,17,9,657572,18872,108952,17304,0.1494740843999493,0.47832817337461303
4023,0.4064,15,20,15,657592,18852,108967,17289,0.14931567608668103,0.4783763592595667
4024,0.4065,7,18,7,657610,18834,108974,17282,0.1491731086047396,0.4785136781481892
4025,0.4066,13,24,13,657634,18810,108987,17269,0.14898301862881763,0.47864408658776575
4026,0.4067,10,17,10,657651,18793,108997,17259,0.1488483715625396,0.4787251747475868
4027,0.4068,18,14,18,657665,18779,109015,17241,0.1487374857432518,0.4786507495835647
4028,0.4069,6,12,6,657677,18767,109021,17235,0.14864244075529084,0.4787234042553192
4029,0.407,7,24,7,657701,18743,109028,17228,0.1484523507793689,0.4789413694364905
4030,0.4071,11,14,11,657715,18729,109039,17217,0.1483414649600811,0.47896845267901855
4031,0.4072,8,23,8,657738,18706,109047,17209,0.1481592953998226,0.4791591257134902
4032,0.4073,8,15,8,657753,18691,109055,17201,0.14804048916487136,0.47924328541179095
4033,0.4074,15,17,15,657770,18674,109070,17186,0.14790584209859334,0.4792526491912995
4034,0.4075,9,18,9,657788,18656,109079,17177,0.14776327461665187,0.47936259872184855
4035,0.4076,12,10,12,657798,18646,109091,17165,0.14768407046001775,0.4793219960347379
4036,0.4077,11,14,11,657812,18632,109102,17154,0.14757318464072994,0.47934946627172637
4037,0.4078,13,16,13,657828,18616,109115,17141,0.14744645799011533,0.47937466789719496
4038,0.4079,16,16,16,657844,18600,109131,17125,0.1473197313395007,0.4793561931420574
4039,0.408,8,12,8,657856,18588,109139,17117,0.14722468635153974,0.47940064416748357
4040,0.4081,13,23,13,657879,18565,109152,17104,0.14704251679128122,0.47952003139981497
4041,0.4082,9,13,9,657892,18552,109161,17095,0.14693955138765682,0.47956349762953404
4042,0.4083,5,19,5,657911,18533,109166,17090,0.14678906349005197,0.479746231367375
4043,0.4084,17,17,17,657928,18516,109183,17073,0.14665441642377391,0.4797268819017112
4044,0.4085,9,17,9,657945,18499,109192,17064,0.1465197693574959,0.47982453673762054
4045,0.4086,12,18,12,657963,18481,109204,17052,0.14637720187555442,0.47989193144400977
4046,0.4087,12,21,12,657984,18460,109216,17040,0.14621087314662273,0.48
4047,0.4088,12,16,12,658000,18444,109228,17028,0.14608414649600812,0.4800405953991881
4048,0.4089,9,15,9,658015,18429,109237,17019,0.1459653402610569,0.48011171293161814
4049,0.409,8,15,8,658030,18414,109245,17011,0.1458465340261057,0.48019760056457306
4050,0.4091,9,18,9,658048,18396,109254,17002,0.14570396654416423,0.48030962201254307
4051,0.4092,19,14,19,658062,18382,109273,16983,0.14559308072487645,0.48022055704792876
4052,0.4093,12,14,12,658076,18368,109285,16971,0.14548219490558864,0.4802343020458983
4053,0.4094,13,12,13,658088,18356,109298,16958,0.1453871499176277,0.4802061505351985
4054,0.4095,8,16,8,658104,18340,109306,16950,0.14526042326701305,0.48030603570416547
4055,0.4096,6,22,6,658126,18318,109312,16944,0.14508617412241795,0.48051727071635186
4056,0.4097,9,13,9,658139,18305,109321,16935,0.14498320871879355,0.4805618615209989
4057,0.4098,10,21,10,658160,18284,109331,16925,0.14481687998986187,0.4807009571416399
4058,0.4099,10,22,10,658182,18262,109341,16915,0.14464263084526677,0.480853967080763
4059,0.41,11,13,11,658195,18249,109352,16904,0.14453966544164237,0.4808693425881148
4060,0.4101,10,13,10,658208,18236,109362,16894,0.144436700038018,0.4808995160831198
4061,0.4102,5,20,5,658228,18216,109367,16889,0.1442782917247497,0.4810995584674548
4062,0.4103,19,21,19,658249,18195,109386,16870,0.14411196299581802,0.48110651646941394
4063,0.4104,11,17,11,658266,18178,109397,16859,0.14397731592954,0.48117704141336304
4064,0.4105,9,11,9,658277,18167,109406,16850,0.14389019135724243,0.48119484821658054
4065,0.4106,8,17,8,658294,18150,109414,16842,0.14375554429096438,0.4813100137174211
4066,0.4107,8,12,8,658306,18138,109422,16834,0.14366049930300342,0.48135651378245453
4067,0.4108,9,14,9,658320,18124,109431,16825,0.14354961348371562,0.48141577727545853
4068,0.4109,14,23,14,658343,18101,109445,16811,0.1433674439234571,0.4815249770852429
4069,0.411,15,17,15,658360,18084,109460,16796,0.14323279685717907,0.4815366972477064
4070,0.4111,12,14,12,658374,18070,109472,16784,0.14312191103789126,0.4815516153095771
4071,0.4112,7,11,7,658385,18059,109479,16777,0.14303478646559373,0.48159949477551955
4072,0.4113,13,13,13,658398,18046,109492,16764,0.14293182106196933,0.4815857512209135
4073,0.4114,15,25,15,658423,18021,109507,16749,0.142733810670384,0.4817083692838654
4074,0.4115,12,17,12,658440,18004,109519,16737,0.14259916360410593,0.4817650614547653
4075,0.4116,8,19,8,658459,17985,109527,16729,0.14244867570650108,0.48190931612605864
4076,0.4117,15,20,15,658479,17965,109542,16714,0.1422902673932328,0.4819631477262897
4077,0.4118,6,17,6,658496,17948,109548,16708,0.14215562032695475,0.48210987996306554
4078,0.4119,3,21,3,658517,17927,109551,16705,0.14198929159802307,0.48235735735735735
4079,0.412,7,18,7,658535,17909,109558,16698,0.14184672411608162,0.4825035397462941
4080,0.4121,6,19,6,658554,17890,109564,16692,0.14169623621847674,0.48267885026892604
4081,0.4122,12,16,12,658570,17874,109576,16680,0.14156950956786213,0.4827226949123112
4082,0.4123,9,26,9,658596,17848,109585,16671,0.14136357876061337,0.48295141805961933
4083,0.4124,11,21,11,658617,17827,109596,16660,0.14119725003168165,0.4830805810885261
4084,0.4125,5,14,5,658631,17813,109601,16655,0.14108636421239387,0.48320181037484045
4085,0.4126,9,28,9,658659,17785,109610,16646,0.14086459257381828,0.4834596729691267
4086,0.4127,13,18,13,658677,17767,109623,16633,0.1407220250918768,0.48351744186046514
4087,0.4128,8,18,8,658695,17749,109631,16625,0.14057945760993537,0.4836504334671554
4088,0.4129,20,16,20,658711,17733,109651,16605,0.14045273095932073,0.48357504805172113
4089,0.413,17,12,17,658723,17721,109668,16588,0.14035768597135978,0.48348829753126
4090,0.4131,12,16,12,658739,17705,109680,16576,0.14023095932074514,0.483533152475132
4091,0.4132,9,11,9,658750,17694,109689,16567,0.1401438347484476,0.4835527275911386
4092,0.4133,5,14,5,658764,17680,109694,16562,0.1400329489291598,0.48367501898253606
4093,0.4134,11,19,11,658783,17661,109705,16551,0.13988246103155494,0.4837776218870572
4094,0.4135,6,12,6,658795,17649,109711,16545,0.13978741604359396,0.48385681698543603
4095,0.4136,17,11,17,658806,17638,109728,16528,0.13970029147129642,0.4837557806005971
4096,0.4137,8,18,8,658824,17620,109736,16520,0.13955772398935495,0.4838898652606913
4097,0.4138,11,14,11,658838,17606,109747,16509,0.13944683817006717,0.4839220284332405
4098,0.4139,7,11,7,658849,17595,109754,16502,0.1393597135977696,0.4839721969674751
4099,0.414,10,22,10,658871,17573,109764,16492,0.1391854644531745,0.4841332746220461
4100,0.4141,8,18,8,658889,17555,109772,16484,0.13904289697123304,0.48426804547724667
4101,0.4142,8,26,8,658915,17529,109780,16476,0.13883696616398428,0.48451698279664757
4102,0.4143,15,15,15,658930,17514,109795,16461,0.13871815992903308,0.48450331125827817
4103,0.4144,18,11,18,658941,17503,109813,16443,0.13863103535673552,0.48438696753667587
4104,0.4145,9,18,9,658959,17485,109822,16434,0.13848846787479407,0.4845072083493028
4105,0.4146,6,17,6,658976,17468,109828,16428,0.13835382080851602,0.484658956809063
4106,0.4147,11,14,11,658990,17454,109839,16417,0.13824293498922824,0.4846919193410292
4107,0.4148,12,14,12,659004,17440,109851,16405,0.13813204916994043,0.48470970601270497
4108,0.4149,15,15,15,659019,17425,109866,16390,0.13801324293498923,0.48469614076593226
4109,0.415,10,15,10,659034,17410,109876,16380,0.137894436700038,0.4847588043799941
4110,0.4151,11,18,11,659052,17392,109887,16369,0.13775186921809657,0.4848493824235064
4111,0.4152,12,15,12,659067,17377,109899,16357,0.13763306298314534,0.48488172170510463
4112,0.4153,7,21,7,659088,17356,109906,16350,0.13746673425421366,0.4850768409185308
4113,0.4154,11,21,11,659109,17335,109917,16339,0.13730040552528197,0.48521114212745736
4114,0.4155,12,20,12,659129,17315,109929,16327,0.1371419972120137,0.48531597408001903
4115,0.4156,7,14,7,659143,17301,109936,16320,0.1370311113927259,0.4854109038993486
4116,0.4157,9,13,9,659156,17288,109945,16311,0.1369281459891015,0.4854608768118099
4117,0.4158,7,12,7,659168,17276,109952,16304,0.13683310100114054,0.48552709946396666
4118,0.4159,13,11,13,659179,17265,109965,16291,0.13674597642884298,0.4854869471927524
4119,0.416,12,24,12,659203,17241,109977,16279,0.13655588645292105,0.4856503579952267
4120,0.4161,12,26,12,659229,17215,109989,16267,0.1363499556456723,0.4858431395973956
4121,0.4162,9,14,9,659243,17201,109998,16258,0.13623906982638448,0.4859081263636092
4122,0.4163,7,18,7,659261,17183,110005,16251,0.13609650234444304,0.48606209248070825
4123,0.4164,9,18,9,659279,17165,110014,16242,0.1359539348625016,0.486185529978747
4124,0.4165,15,17,15,659296,17148,110029,16227,0.13581928779622354,0.48620224719101124
4125,0.4166,12,8,12,659304,17140,110041,16215,0.13575592447091622,0.48613401289162045
4126,0.4167,16,19,16,659323,17121,110057,16199,0.13560543657331137,0.4861644657863145
4127,0.4168,15,13,15,659336,17108,110072,16184,0.13550247116968697,0.4861227922624054
4128,0.4169,15,13,15,659349,17095,110087,16169,0.1353995057660626,0.48608104858104856
4129,0.417,15,19,15,659368,17076,110102,16154,0.13524901786845775,0.4861269936804093
4130,0.4171,6,11,6,659379,17065,110108,16148,0.13516189329616018,0.48619516454400385
4131,0.4172,4,15,4,659394,17050,110112,16144,0.13504308706120896,0.48635295535337714
4132,0.4173,11,24,11,659418,17026,110123,16133,0.13485299708528703,0.48653457583159926
4133,0.4174,12,14,12,659432,17012,110135,16121,0.13474211126599925,0.486554190686023
4134,0.4175,9,14,9,659446,16998,110144,16112,0.13463122544671144,0.48662035638779827
4135,0.4176,9,12,9,659458,16986,110153,16103,0.1345361804587505,0.48665719725588563
4136,0.4177,7,9,7,659467,16977,110160,16096,0.13446489671777975,0.4866809784416291
4137,0.4178,13,12,13,659479,16965,110173,16083,0.13436985172981877,0.4866557734204793
4138,0.4179,8,16,8,659495,16949,110181,16075,0.13424312507920416,0.4867671996124031
4139,0.418,20,14,20,659509,16935,110201,16055,0.13413223925991635,0.48666262503789026
4140,0.4181,14,17,14,659526,16918,110215,16041,0.13399759219363833,0.48669559149246033
4141,0.4182,6,17,6,659543,16901,110221,16035,0.13386294512736027,0.48685329123147925
4142,0.4183,12,10,12,659553,16891,110233,16023,0.13378374097072615,0.48681412165036153
4143,0.4184,8,14,8,659567,16877,110241,16015,0.13367285515143834,0.4868965097896145
4144,0.4185,11,14,11,659581,16863,110252,16004,0.13356196933215056,0.48693218121520065
4145,0.4186,9,14,9,659595,16849,110261,15995,0.13345108351286275,0.486999147485081
4146,0.4187,12,21,12,659616,16828,110273,15983,0.13328475478393106,0.48712322087104937
4147,0.4188,6,17,6,659633,16811,110279,15977,0.133150107717653,0.4872819324142979
4148,0.4189,15,28,15,659661,16783,110294,15962,0.13292833607907742,0.487463734921362
4149,0.419,11,13,11,659674,16770,110305,15951,0.13282537067545305,0.48748510131108463
4150,0.4191,17,16,17,659690,16754,110322,15934,0.1326986440248384,0.4874571708272149
4151,0.4192,11,15,11,659705,16739,110333,15923,0.13257983778988722,0.4875084195701427
4152,0.4193,8,17,8,659722,16722,110341,15915,0.13244519072360916,0.48763673131721663
4153,0.4194,9,23,9,659745,16699,110350,15906,0.13226302116335065,0.4878392884526913
4154,0.4195,7,19,7,659764,16680,110357,15899,0.1321125332657458,0.4880137511894165
4155,0.4196,8,23,8,659787,16657,110365,15891,0.13193036370548727,0.4882327639179059
4156,0.4197,5,17,5,659804,16640,110370,15886,0.13179571663920922,0.48840927258193445
4157,0.4198,14,8,14,659812,16632,110384,15872,0.1317323533139019,0.4883091311838543
4158,0.4199,8,10,8,659822,16622,110392,15864,0.13165314915726778,0.4883334359416364
4159,0.42,13,14,13,659836,16608,110405,15851,0.13154226333797997,0.48833913552481595
4160,0.4201,7,16,7,659852,16592,110412,15844,0.13141553668736536,0.48846960167714887
4161,0.4202,15,20,15,659872,16572,110427,15829,0.13125712837409706,0.4885343044967748
4162,0.4203,12,12,12,659884,16560,110439,15817,0.1311620833861361,0.4885258053556537
4163,0.4204,10,19,10,659903,16541,110449,15807,0.13101159548853125,0.48865463088908123
4164,0.4205,10,19,10,659922,16522,110459,15797,0.13086110759092637,0.48878368761409696
4165,0.4206,12,20,12,659942,16502,110471,15785,0.1307026992776581,0.4888964598754917
4166,0.4207,10,16,10,659958,16486,110481,15775,0.13057597262704346,0.48898050277424754
4167,0.4208,8,15,8,659973,16471,110489,15767,0.13045716639209226,0.4890812085116943
4168,0.4209,7,10,7,659983,16461,110496,15760,0.1303779622354581,0.48912200117935506
4169,0.421,7,15,7,659998,16446,110503,15753,0.13025915600050691,0.48923879623590794
4170,0.4211,8,18,8,660016,16428,110511,15745,0.13011658851856545,0.4893855095887856
4171,0.4212,16,18,16,660034,16410,110527,15729,0.129974021036624,0.4894053953141044
4172,0.4213,8,10,8,660044,16400,110535,15721,0.12989481687998986,0.48943059057937177
4173,0.4214,12,17,12,660061,16383,110547,15709,0.12976016981371183,0.48949894054593046
4174,0.4215,10,10,10,660071,16373,110557,15699,0.12968096565707768,0.4894923921177351
4175,0.4216,11,13,11,660084,16360,110568,15688,0.1295780002534533,0.48951572641038443
4176,0.4217,13,11,13,660095,16349,110581,15675,0.12949087568115575,0.4894766425181114
4177,0.4218,13,18,13,660113,16331,110594,15662,0.1293483081992143,0.48954458787859845
4178,0.4219,13,18,13,660131,16313,110607,15649,0.12920574071727284,0.48961266503973466
4179,0.422,10,13,10,660144,16300,110617,15639,0.12910277531364847,0.48965214940981244
4180,0.4221,8,13,8,660157,16287,110625,15631,0.12899980991002408,0.4897236668964221
4181,0.4222,11,13,11,660170,16274,110636,15620,0.12889684450639968,0.4897472878911394
4182,0.4223,10,16,10,660186,16258,110646,15610,0.12877011785578507,0.489833061378185
4183,0.4224,8,15,8,660201,16243,110654,15602,0.12865131162083387,0.489935625686921
4184,0.4225,13,17,13,660218,16226,110667,15589,0.12851666455455582,0.48998899889989
4185,0.4226,9,8,9,660226,16218,110676,15580,0.1284533012292485,0.48996792251084975
4186,0.4227,14,11,14,660237,16207,110690,15566,0.12836617665695096,0.48991281906020834
4187,0.4228,13,20,13,660257,16187,110703,15553,0.12820776834368267,0.49001260239445493
4188,0.4229,12,13,12,660270,16174,110715,15541,0.1281048029400583,0.4900204950338956
4189,0.423,10,24,10,660294,16150,110725,15531,0.12791471296413637,0.49023073766610903
4190,0.4231,20,22,20,660316,16128,110745,15511,0.12774046381954124,0.49024937577040995
4191,0.4232,9,12,9,660328,16116,110754,15502,0.1276454188315803,0.4902903409450313
4192,0.4233,13,20,13,660348,16096,110767,15489,0.127487010518312,0.49039100839005856
4193,0.4234,7,16,7,660364,16080,110774,15482,0.12736028386769738,0.4905265825993283
4194,0.4235,10,17,10,660381,16063,110784,15472,0.12722563680141935,0.4906294593309022
4195,0.4236,13,14,13,660395,16049,110797,15459,0.12711475098213154,0.4906372984638822
4196,0.4237,8,15,8,660410,16034,110805,15451,0.12699594474718034,0.490741622995077
4197,0.4238,8,20,8,660430,16014,110813,15443,0.12683753643391205,0.49092411863814095
4198,0.4239,12,22,12,660452,15992,110825,15431,0.12666328728931694,0.4910734175603857
4199,0.424,10,15,10,660467,15977,110835,15421,0.12654448105436572,0.49114593286196573
4200,0.4241,13,26,13,660493,15951,110848,15408,0.12633855024711696,0.49134219841193916
4201,0.4242,14,14,14,660507,15937,110862,15394,0.12622766442782918,0.4913344610768887
4202,0.4243,9,16,9,660523,15921,110871,15385,0.12610093777721454,0.491439340701463
4203,0.4244,9,17,9,660540,15904,110880,15376,0.1259662907109365,0.49156010230179026
4204,0.4245,5,13,5,660553,15891,110885,15371,0.12586332530731212,0.491683193653637
4205,0.4246,11,14,11,660567,15877,110896,15360,0.12575243948802434,0.491724557415885
4206,0.4247,7,15,7,660582,15862,110903,15353,0.1256336332530731,0.49184686849271186
4207,0.4248,10,14,10,660596,15848,110913,15343,0.12552274743378533,0.4919047161040044
4208,0.4249,11,17,11,660613,15831,110924,15332,0.12538810036750728,0.4919937104900042
4209,0.425,23,11,23,660624,15820,110947,15309,0.12530097579520974,0.4917922194738026
4210,0.4251,14,17,14,660641,15803,110961,15295,0.1251663287289317,0.49183227217184383
4211,0.4252,6,13,6,660654,15790,110967,15289,0.12506336332530732,0.49193989510602015
4212,0.4253,7,10,7,660664,15780,110974,15282,0.12498415916867317,0.4919837743867104
4213,0.4254,11,10,11,660674,15770,110985,15271,0.12490495501203903,0.4919622434844238
4214,0.4255,5,17,5,660691,15753,110990,15266,0.124770307945761,0.49214997259744026
4215,0.4256,9,17,9,660708,15736,110999,15257,0.12463566087948295,0.49227244861742975
4216,0.4257,13,16,13,660724,15720,111012,15244,0.12450893422886833,0.4923136545665935
4217,0.4258,17,14,17,660738,15706,111029,15227,0.12439804840958053,0.4922574596709016
4218,0.4259,13,9,13,660747,15697,111042,15214,0.12432676466860981,0.4921872472582576
4219,0.426,11,13,11,660760,15684,111053,15203,0.12422379926498543,0.4922135526273189
4220,0.4261,9,18,9,660778,15666,111062,15194,0.12408123178304398,0.49235255994815297
4221,0.4262,11,14,11,660792,15652,111073,15183,0.12397034596375618,0.4923950056753689
4222,0.4263,14,9,14,660801,15643,111087,15169,0.12389906222278545,0.492308191613657
4223,0.4264,18,20,18,660821,15623,111105,15151,0.12374065390951718,0.4923311886657568
4224,0.4265,16,10,16,660831,15613,111121,15135,0.12366144975288303,0.4922271367243398
4225,0.4266,18,13,18,660844,15600,111139,15117,0.12355848434925865,0.4921379040921965
4226,0.4267,11,22,11,660866,15578,111150,15106,0.12338423520466354,0.4923086950853865
4227,0.4268,6,15,6,660881,15563,111156,15100,0.12326542896971233,0.49245018426116166
4228,0.4269,9,15,9,660896,15548,111165,15091,0.12314662273476112,0.49254218479715395
4229,0.427,6,12,6,660908,15536,111171,15085,0.12305157774680016,0.4926357728356357
4230,0.4271,11,22,11,660930,15514,111182,15074,0.12287732860220504,0.49280763698182295
4231,0.4272,13,17,13,660947,15497,111195,15061,0.122742681535927,0.4928660252634335
4232,0.4273,12,20,12,660967,15477,111207,15049,0.12258427322265872,0.492989582650855
4233,0.4274,8,16,8,660983,15461,111215,15041,0.12245754657204411,0.49311520556029115
4234,0.4275,8,10,8,660993,15451,111223,15033,0.12237834241540996,0.4931439443642567
4235,0.4276,9,5,9,660998,15446,111232,15024,0.1223387403370929,0.4930751558910404
4236,0.4277,4,13,4,661011,15433,111236,15020,0.1222357749334685,0.4932190588776147
4237,0.4278,12,14,12,661025,15419,111248,15008,0.1221248891141807,0.4932461300818352
4238,0.4279,13,8,13,661033,15411,111261,14995,0.1220615257888734,0.4931592448858778
4239,0.428,15,11,15,661044,15400,111276,14980,0.12197440121657585,0.4930875576036866
4240,0.4281,10,13,10,661057,15387,111286,14970,0.12187143581295147,0.493131732384623
4241,0.4282,11,9,11,661066,15378,111297,14959,0.12180015207198074,0.49309424135544055
4242,0.4283,9,20,9,661086,15358,111306,14950,0.12164174375871245,0.4932691038669658
4243,0.4284,10,8,10,661094,15350,111316,14940,0.12157838043340514,0.4932320897986134
4244,0.4285,6,12,6,661106,15338,111322,14934,0.12148333544544418,0.49332716701902746
4245,0.4286,10,22,10,661128,15316,111332,14924,0.12130908630084906,0.4935185185185185
4246,0.4287,16,13,16,661141,15303,111348,14908,0.12120612089722468,0.4934626460560723
4247,0.4288,7,19,7,661160,15284,111355,14901,0.12105563299961981,0.49365578929932086
4248,0.4289,14,15,14,661175,15269,111369,14887,0.1209368267646686,0.49366626873590663
4249,0.429,7,10,7,661185,15259,111376,14880,0.12085762260803447,0.4937124655761638
4250,0.4291,7,16,7,661201,15243,111383,14873,0.12073089595741984,0.49385708593438704
4251,0.4292,9,13,9,661214,15230,111392,14864,0.12062793055379546,0.4939190536319532
4252,0.4293,15,12,15,661226,15218,111407,14849,0.1205328855658345,0.4938637043935211
4253,0.4294,4,14,4,661240,15204,111411,14845,0.1204219997465467,0.4940264235082698
4254,0.4295,10,12,10,661252,15192,111421,14835,0.12032695475858574,0.49405535018483365
4255,0.4296,12,15,12,661267,15177,111433,14823,0.12020814852363453,0.4941
4256,0.4297,11,23,11,661290,15154,111444,14812,0.120025978963376,0.49429353267035975
4257,0.4298,13,16,13,661306,15138,111457,14799,0.11989925231276137,0.49433811003106526
4258,0.4299,12,11,12,661317,15127,111469,14787,0.11981212774046382,0.49431704218760447
4259,0.43,11,12,11,661329,15115,111480,14776,0.11971708275250285,0.4943293968084039
4260,0.4301,16,18,16,661347,15097,111496,14760,0.1195745152705614,0.49435643232742743
4261,0.4302,7,12,7,661359,15085,111503,14753,0.11947947028260043,0.4944366244386353
4262,0.4303,9,21,9,661380,15064,111512,14744,0.11931314155366873,0.49463231347289316
4263,0.4304,6,11,6,661391,15053,111518,14738,0.11922601698137118,0.49471316840656576
4264,0.4305,6,16,6,661407,15037,111524,14732,0.11909929033075656,0.49487722127044914
4265,0.4306,9,11,9,661418,15026,111533,14723,0.11901216575845901,0.494907391845104
4266,0.4307,8,6,8,661424,15020,111541,14715,0.11896464326447852,0.4948713637127964
4267,0.4308,14,10,14,661434,15010,111555,14701,0.11888543910784438,0.4947999057588099
4268,0.4309,11,22,11,661456,14988,111566,14690,0.11871118996324927,0.4949794460543163
4269,0.431,9,12,9,661468,14976,111575,14681,0.1186161449752883,0.4950264692989851
4270,0.4311,10,12,10,661480,14964,111585,14671,0.11852109998732734,0.49505652100556774
4271,0.4312,12,12,12,661492,14952,111597,14659,0.11842605499936637,0.49505251426834623
4272,0.4313,8,21,8,661513,14931,111605,14651,0.11825972627043467,0.49526739233317557
4273,0.4314,11,14,11,661527,14917,111616,14640,0.11814884045114687,0.4953141387826911
4274,0.4315,10,15,10,661542,14902,111626,14630,0.11803003421619566,0.49539482595151024
4275,0.4316,12,11,12,661553,14891,111638,14618,0.11794290964389811,0.49537429258870175
4276,0.4317,10,11,10,661564,14880,111648,14608,0.11785578507160056,0.49538795442213784
4277,0.4318,11,18,11,661582,14862,111659,14597,0.11771321758965911,0.4955022234291728
4278,0.4319,4,21,4,661603,14841,111663,14593,0.11754688886072741,0.4957871848882245
4279,0.432,5,8,5,661611,14833,111668,14588,0.1174835255354201,0.49583630739947654
4280,0.4321,9,14,9,661625,14819,111677,14579,0.11737263971613231,0.4959180896659637
4281,0.4322,9,20,9,661645,14799,111686,14570,0.11721423140286402,0.4961013313357622
4282,0.4323,11,14,11,661659,14785,111697,14559,0.11710334558357623,0.49614912758996726
4283,0.4324,8,14,8,661673,14771,111705,14551,0.11699245976428843,0.496248550576359
4284,0.4325,13,10,13,661683,14761,111718,14538,0.1169132556076543,0.49619440936550735
4285,0.4326,10,9,10,661692,14752,111728,14528,0.11684197186668356,0.4961748633879781
4286,0.4327,9,19,9,661711,14733,111737,14519,0.11669148396907869,0.4963421304526186
4287,0.4328,15,19,15,661730,14714,111752,14504,0.11654099607147383,0.4964063248682319
4288,0.4329,9,15,9,661745,14699,111761,14495,0.11642218983652262,0.4965061313968624
4289,0.433,7,13,7,661758,14686,111768,14488,0.11631922443289824,0.4966065674916021
4290,0.4331,10,13,10,661771,14673,111778,14478,0.11621625902927385,0.49665534630029845
4291,0.4332,9,16,9,661787,14657,111787,14469,0.11608953237865924,0.496772642999382
4292,0.4333,20,21,20,661808,14636,111807,14449,0.11592320364972754,0.4967852845109163
4293,0.4334,9,10,9,661818,14626,111816,14440,0.1158439994930934,0.49680038532993875
4294,0.4335,7,14,7,661832,14612,111823,14433,0.11573311367380561,0.496918574625581
4295,0.4336,4,11,4,661843,14601,111827,14429,0.11564598910150804,0.49703754736479505
4296,0.4337,9,12,9,661855,14589,111836,14420,0.11555094411354708,0.4970871108966183
4297,0.4338,12,14,12,661869,14575,111848,14408,0.11544005829425928,0.49711900079356863
4298,0.4339,3,13,3,661882,14562,111851,14405,0.1153370928906349,0.49729001967756414
4299,0.434,10,16,10,661898,14546,111861,14395,0.11521036624002028,0.4973912442555544
4300,0.4341,8,10,8,661908,14536,111869,14387,0.11513116208338614,0.4974241952771151
4301,0.4342,10,17,10,661925,14519,111879,14377,0.1149965150171081,0.49754291251384275
4302,0.4343,13,14,13,661939,14505,111892,14364,0.1148856291978203,0.49755793411618
4303,0.4344,8,17,8,661956,14488,111900,14356,0.11475098213154226,0.49771182914990986
4304,0.4345,9,17,9,661973,14471,111909,14347,0.11461633506526422,0.4978485668679298
4305,0.4346,12,21,12,661994,14450,111921,14335,0.11445000633633252,0.49800243182212955
4306,0.4347,13,14,13,662008,14436,111934,14322,0.11433912051704473,0.4980179428332986
4307,0.4348,8,13,8,662021,14423,111942,14314,0.11423615511342035,0.49810349027386297
4308,0.4349,11,13,11,662034,14410,111953,14303,0.11413318970979597,0.49813673249050955
4309,0.435,13,14,13,662048,14396,111966,14290,0.11402230389050817,0.4981524088405494
4310,0.4351,9,13,9,662061,14383,111975,14281,0.11391933848688379,0.49822076472229976
4311,0.4352,9,16,9,662077,14367,111984,14272,0.11379261183626917,0.49834142253570307
4312,0.4353,11,11,11,662088,14356,111995,14261,0.11370548726397162,0.49834014746479366
4313,0.4354,4,15,4,662103,14341,111999,14257,0.1135866810290204,0.4985313658297783
4314,0.4355,13,12,13,662115,14329,112012,14244,0.11349163604105944,0.49851258180800057
4315,0.4356,6,14,6,662129,14315,112018,14238,0.11338075022177165,0.4986516303015445
4316,0.4357,7,12,7,662141,14303,112025,14231,0.11328570523381067,0.4987383472348777
4317,0.4358,11,14,11,662155,14289,112036,14220,0.11317481941452287,0.49878985583499946
4318,0.4359,4,15,4,662170,14274,112040,14216,0.11305601317957166,0.498982098982099
4319,0.436,18,15,18,662185,14259,112058,14198,0.11293720694462045,0.49892820747092104
4320,0.4361,11,10,11,662195,14249,112069,14187,0.11285800278798631,0.4989098326065551
4321,0.4362,9,16,9,662211,14233,112078,14178,0.11273127613737169,0.49903206504522896
4322,0.4363,8,12,8,662223,14221,112086,14170,0.11263623114941072,0.49910182804409847
4323,0.4364,17,14,17,662237,14207,112103,14153,0.11252534533012293,0.49904795486600845
4324,0.4365,15,14,15,662251,14193,112118,14138,0.11241445951083513,0.49902933182732695
4325,0.4366,12,17,12,662268,14176,112130,14126,0.11227981244455709,0.49911667019998585
4326,0.4367,14,17,14,662285,14159,112144,14112,0.11214516537827905,0.49916875950620776
4327,0.4368,6,14,6,662299,14145,112150,14106,0.11203427955899126,0.49930975894658597
4328,0.4369,9,8,9,662307,14137,112159,14097,0.11197091623368394,0.4992916341999008
4329,0.437,15,8,15,662315,14129,112174,14082,0.11190755290837663,0.49916699159902167
4330,0.4371,6,11,6,662326,14118,112180,14076,0.11182042833607908,0.4992551606724835
4331,0.4372,8,15,8,662341,14103,112188,14068,0.11170162210112787,0.49937879379503747
4332,0.4373,14,14,14,662355,14089,112202,14054,0.11159073628184007,0.4993781757453008
4333,0.4374,8,24,8,662379,14065,112210,14046,0.11140064630591813,0.49966205400021346
4334,0.4375,8,15,8,662394,14050,112218,14038,0.11128184007096692,0.49978638564511535
4335,0.4376,11,10,11,662404,14040,112229,14027,0.11120263591433278,0.4997684113015285
4336,0.4377,14,22,14,662426,14018,112243,14013,0.11102838676973767,0.4999108130284328
4337,0.4378,11,10,11,662436,14008,112254,14002,0.11094918261310353,0.499892895394502
4338,0.4379,8,17,8,662453,13991,112262,13994,0.1108145355468255,0.5000536001429338
4339,0.438,8,14,8,662467,13977,112270,13986,0.1107036497275377,0.5001609269391696
4340,0.4381,9,9,9,662476,13968,112279,13977,0.11063236598656698,0.5001610305958132
4341,0.4382,7,9,7,662485,13959,112286,13970,0.11056108224559624,0.5001969279243796
4342,0.4383,10,20,10,662505,13939,112296,13960,0.11040267393232797,0.5003763575755403
4343,0.4384,11,11,11,662516,13928,112307,13949,0.11031554936003042,0.5003766545898052
4344,0.4385,6,18,6,662534,13910,112313,13943,0.11017298187808897,0.5005923957921947
4345,0.4386,12,10,12,662544,13900,112325,13931,0.11009377772145482,0.5005569329165319
4346,0.4387,9,14,9,662558,13886,112334,13922,0.10998289190216702,0.5006472957422324
4347,0.4388,6,12,6,662570,13874,112340,13916,0.10988784691420606,0.5007556675062972
4348,0.4389,14,15,14,662585,13859,112354,13902,0.10976904067925485,0.5007744677785383
4349,0.439,16,13,16,662598,13846,112370,13886,0.10966607527563046,0.5007211885186788
4350,0.4391,13,9,13,662607,13837,112383,13873,0.10959479153465974,0.5006495849873692
4351,0.4392,13,9,13,662616,13828,112396,13860,0.10952350779368901,0.5005778676683039
4352,0.4393,13,19,13,662635,13809,112409,13847,0.10937301989608415,0.5006870118599942
4353,0.4394,13,19,13,662654,13790,112422,13834,0.10922253199847928,0.50079640891978
4354,0.4395,13,16,13,662670,13774,112435,13821,0.10909580534786466,0.500851603551368
4355,0.4396,8,13,8,662683,13761,112443,13813,0.10899283994424028,0.5009429172408791
4356,0.4397,10,13,10,662696,13748,112453,13803,0.1088898745406159,0.5009981488875177
4357,0.4398,10,13,10,662709,13735,112463,13793,0.1087869091369915,0.5010534728276663
4358,0.4399,15,15,15,662724,13720,112478,13778,0.10866810290204029,0.5010546221543385
4359,0.44,12,14,12,662738,13706,112490,13766,0.1085572170827525,0.5010920209668026
4360,0.4401,11,19,11,662757,13687,112501,13755,0.10840672918514764,0.5012389767509656
4361,0.4402,8,11,8,662768,13676,112509,13747,0.10831960461285008,0.5012945337855085
4362,0.4403,8,12,8,662780,13664,112517,13739,0.10822455962488911,0.5013684633069372
4363,0.4404,16,15,16,662795,13649,112533,13723,0.1081057533899379,0.5013517463100979
4364,0.4405,14,13,14,662808,13636,112547,13709,0.10800278798631352,0.5013347961236058
4365,0.4406,11,11,11,662819,13625,112558,13698,0.10791566341401597,0.5013358708780149
4366,0.4407,12,11,12,662830,13614,112570,13686,0.10782853884171842,0.5013186813186813
4367,0.4408,14,28,14,662858,13586,112584,13672,0.10760676720314281,0.5015775185266711
4368,0.4409,9,16,9,662874,13570,112593,13663,0.1074800405525282,0.5017074872397459
4369,0.441,7,12,7,662886,13558,112600,13656,0.10738499556456722,0.5018005438377305
4370,0.4411,14,11,14,662897,13547,112614,13642,0.10729787099226967,0.5017470300489169
4371,0.4412,11,10,11,662907,13537,112625,13631,0.10721866683563554,0.501729976442874
4372,0.4413,5,7,5,662914,13530,112630,13626,0.10716322392599163,0.5017675651789659
4373,0.4414,10,10,10,662924,13520,112640,13616,0.1070840197693575,0.5017688679245284
4374,0.4415,8,18,8,662942,13502,112648,13608,0.10694145228741604,0.5019549981556621
4375,0.4416,15,9,15,662951,13493,112663,13593,0.10687016854644532,0.501845972088902
4376,0.4417,7,21,7,662972,13472,112670,13586,0.10670383981751362,0.5021065858526129
4377,0.4418,11,17,11,662989,13455,112681,13575,0.10656919275123558,0.5022197558268591
4378,0.4419,10,13,10,663002,13442,112691,13565,0.1064662273476112,0.5022771873958604
4379,0.442,7,17,7,663019,13425,112698,13558,0.10633158028133316,0.5024645146944372
4380,0.4421,14,13,14,663032,13412,112712,13544,0.10622861487770878,0.5024484344858288
4381,0.4422,5,17,5,663049,13395,112717,13539,0.10609396781143074,0.5026732011583872
4382,0.4423,7,12,7,663061,13383,112724,13532,0.10599892282346977,0.5027679732491176
4383,0.4424,7,13,7,663074,13370,112731,13525,0.1058959574198454,0.5028815765012083
4384,0.4425,11,13,11,663087,13357,112742,13514,0.10579299201622101,0.5029213650403781
4385,0.4426,9,14,9,663101,13343,112751,13505,0.10568210619693322,0.5030169845053635
4386,0.4427,10,18,10,663119,13325,112761,13495,0.10553953871499176,0.5031692766592095
4387,0.4428,16,16,16,663135,13309,112777,13479,0.10541281206437714,0.5031730625653278
4388,0.4429,4,14,4,663149,13295,112781,13475,0.10530192624508934,0.5033619723571162
4389,0.443,12,9,12,663158,13286,112793,13463,0.10523064250411862,0.5033085348985009
4390,0.4431,12,11,12,663169,13275,112805,13451,0.10514351793182106,0.5032926738007932
4391,0.4432,12,17,12,663186,13258,112817,13439,0.10500887086554303,0.50338989399558
4392,0.4433,13,16,13,663202,13242,112830,13426,0.1048821442149284,0.5034498275086245
4393,0.4434,9,14,9,663216,13228,112839,13417,0.10477125839564061,0.503546631638206
4394,0.4435,10,8,10,663224,13220,112849,13407,0.10470789507033329,0.5035114733165584
4395,0.4436,10,14,10,663238,13206,112859,13397,0.1045970092510455,0.5035898206969139
4396,0.4437,17,11,17,663249,13195,112876,13380,0.10450988467874794,0.503480714957667
4397,0.4438,10,12,10,663261,13183,112886,13370,0.10441483969078698,0.5035212593680564
4398,0.4439,7,16,7,663277,13167,112893,13363,0.10428811304017235,0.5036939313984169
4399,0.444,8,16,8,663293,13151,112901,13355,0.10416138638955773,0.5038481853165321
4400,0.4441,13,10,13,663303,13141,112914,13342,0.10408218223292358,0.5037948872861836
4401,0.4442,8,18,8,663321,13123,112922,13334,0.10393961475098214,0.5039876025248516
4402,0.4443,15,12,15,663333,13111,112937,13319,0.10384456976302116,0.5039349224366251
4403,0.4444,10,8,10,663341,13103,112947,13309,0.10378120643771385,0.5038997425412691
4404,0.4445,11,12,11,663353,13091,112958,13298,0.10368616144975289,0.5039220887491
4405,0.4446,12,8,12,663361,13083,112970,13286,0.10362279812444557,0.5038492168834616
4406,0.4447,7,13,7,663374,13070,112977,13279,0.10351983272082119,0.503965994914418
4407,0.4448,11,11,11,663385,13059,112988,13268,0.10343270814852364,0.5039693090743343
4408,0.4449,9,14,9,663399,13045,112997,13259,0.10332182232923584,0.5040678223844283
4409,0.445,4,4,4,663403,13041,113001,13255,0.10329014066658218,0.5040690599330697
4410,0.4451,8,21,8,663424,13020,113009,13247,0.1031238119376505,0.5043210111546808
4411,0.4452,7,13,7,663437,13007,113016,13240,0.1030208465340261,0.5044386025069532
4412,0.4453,14,14,14,663451,12993,113030,13226,0.1029099607147383,0.5044433426141348
4413,0.4454,13,9,13,663460,12984,113043,13213,0.10283867697376758,0.5043707294728405
4414,0.4455,6,11,6,663471,12973,113049,13207,0.10275155240147003,0.5044690603514133
4415,0.4456,8,19,8,663490,12954,113057,13199,0.10260106450386516,0.5046839750697817
4416,0.4457,12,11,12,663501,12943,113069,13187,0.10251393993156761,0.5046689628779181
4417,0.4458,17,10,17,663511,12933,113086,13170,0.10243473577493346,0.5045397080795311
4418,0.4459,13,18,13,663529,12915,113099,13157,0.10229216829299202,0.5046409941699908
4419,0.446,10,15,10,663544,12900,113109,13147,0.10217336205804081,0.5047414289553499
4420,0.4461,10,10,10,663554,12890,113119,13137,0.10209415790140666,0.5047450724247896
4421,0.4462,6,12,6,663566,12878,113125,13131,0.1019991129134457,0.5048637010265677
4422,0.4463,11,7,11,663573,12871,113136,13120,0.1019436700038018,0.5047901196568043
4423,0.4464,12,16,12,663589,12855,113148,13108,0.10181694335318718,0.5048723182991179
4424,0.4465,13,9,13,663598,12846,113161,13095,0.10174565961221645,0.5047993523765468
4425,0.4466,8,10,8,663608,12836,113169,13087,0.10166645545558231,0.5048412606565598
4426,0.4467,5,10,5,663618,12826,113174,13082,0.10158725129894818,0.5049405589007256
4427,0.4468,20,13,20,663631,12813,113194,13062,0.10148428589532378,0.5048115942028986
4428,0.4469,10,18,10,663649,12795,113204,13052,0.10134171841338234,0.5049715634309591
4429,0.447,11,13,11,663662,12782,113215,13041,0.10123875300975795,0.5050149091894822
4430,0.4471,10,15,10,663677,12767,113225,13031,0.10111994677480675,0.5051166757112955
4431,0.4472,11,21,11,663698,12746,113236,13020,0.10095361804587505,0.5053170845300008
4432,0.4473,9,11,9,663709,12735,113245,13011,0.1008664934735775,0.5053600559310184
4433,0.4474,7,20,7,663729,12715,113252,13004,0.10070808516030921,0.5056184144018041
4434,0.4475,8,10,8,663739,12705,113260,12996,0.10062888100367508,0.505661258316797
4435,0.4476,12,16,12,663755,12689,113272,12984,0.10050215435306045,0.5057453355665485
4436,0.4477,7,5,7,663760,12684,113279,12977,0.10046255227474338,0.5057090526479873
4437,0.4478,7,14,7,663774,12670,113286,12970,0.10035166645545558,0.5058502340093604
4438,0.4479,13,12,13,663786,12658,113299,12957,0.10025662146749462,0.5058364239703299
4439,0.448,11,6,11,663792,12652,113310,12946,0.10020909897351413,0.5057426361434487
4440,0.4481,9,16,9,663808,12636,113319,12937,0.1000823723228995,0.5058851132053338
4441,0.4482,7,12,7,663820,12624,113326,12930,0.09998732733493854,0.5059873209673632
4442,0.4483,11,17,11,663837,12607,113337,12919,0.0998526802686605,0.5061114158113297
4443,0.4484,12,14,12,663851,12593,113349,12907,0.0997417944493727,0.5061568627450981
4444,0.4485,12,11,12,663862,12582,113361,12895,0.09965466987707515,0.5061427954625741
4445,0.4486,12,16,12,663878,12566,113373,12883,0.09952794322646052,0.5062281425596291
4446,0.4487,10,9,10,663887,12557,113383,12873,0.0994566594854898,0.5062131340935903
4447,0.4488,9,13,9,663900,12544,113392,12864,0.09935369408186541,0.5062972292191436
4448,0.4489,11,16,11,663916,12528,113403,12853,0.0992269674312508,0.5064024270123321
4449,0.449,12,14,12,663930,12514,113415,12841,0.09911608161196299,0.5064484322618813
4450,0.4491,16,14,16,663944,12500,113431,12825,0.0990051957926752,0.506416584402764
4451,0.4492,8,14,8,663958,12486,113439,12817,0.0988943099733874,0.5065407263960795
4452,0.4493,6,18,6,663976,12468,113445,12811,0.09875174249144596,0.506784287353139
4453,0.4494,14,8,14,663984,12460,113459,12797,0.09868837916613864,0.5066714178247614
4454,0.4495,15,12,15,663996,12448,113474,12782,0.09859333417817767,0.506619104240983
4455,0.4496,8,12,8,664008,12436,113482,12774,0.0984982891902167,0.5067036890122967
4456,0.4497,10,12,10,664020,12424,113492,12764,0.09840324420225574,0.5067492456725424
4457,0.4498,6,16,6,664036,12408,113498,12758,0.09827651755164112,0.5069538265914328
4458,0.4499,14,20,14,664056,12388,113512,12744,0.09811810923837283,0.5070826038516633
4459,0.45,10,9,10,664065,12379,113522,12734,0.09804682549740211,0.5070680524031378
4460,0.4501,10,11,10,664076,12368,113532,12724,0.09795970092510455,0.5070938944683564
4461,0.4502,6,7,6,664083,12361,113538,12718,0.09790425801546065,0.5071175086725946
4462,0.4503,11,8,11,664091,12353,113549,12707,0.09784089469015333,0.5070630486831604
4463,0.4504,12,13,12,664104,12340,113561,12695,0.09773792928652895,0.5070900738965448
4464,0.4505,7,8,7,664112,12332,113568,12688,0.09767456596122165,0.5071143085531574
4465,0.4506,16,11,16,664123,12321,113584,12672,0.09758744138892408,0.5070219661505222
4466,0.4507,7,7,7,664130,12314,113591,12665,0.0975319984792802,0.5070259017574763
4467,0.4508,11,20,11,664150,12294,113602,12654,0.09737359016601191,0.5072150072150072
4468,0.4509,11,16,11,664166,12278,113613,12643,0.09724686351539728,0.507323141125958
4469,0.451,7,8,7,664174,12270,113620,12636,0.09718350019008998,0.5073476270778126
4470,0.4511,11,8,11,664182,12262,113631,12625,0.09712013686478266,0.5072929641981757
4471,0.4512,10,15,10,664197,12247,113641,12615,0.09700133062983145,0.5074008527069424
4472,0.4513,11,18,11,664215,12229,113652,12604,0.09685876314789,0.5075504369186163
4473,0.4514,9,13,9,664228,12216,113661,12595,0.09675579774426563,0.5076377413244125
4474,0.4515,7,19,7,664247,12197,113668,12588,0.09660530984666076,0.507887835384305
4475,0.4516,7,12,7,664259,12185,113675,12581,0.09651026485869979,0.5079948316240006
4476,0.4517,11,17,11,664276,12168,113686,12570,0.09637561779242175,0.508125151588649
4477,0.4518,8,8,8,664284,12160,113694,12562,0.09631225446711443,0.5081304101609903
4478,0.4519,12,15,12,664299,12145,113706,12550,0.09619344823216322,0.5082000404940271
4479,0.452,8,10,8,664309,12135,113714,12542,0.09611424407552908,0.5082465453661305
4480,0.4521,10,13,10,664322,12122,113724,12532,0.0960112786719047,0.5083150807171251
4481,0.4522,12,9,12,664331,12113,113736,12520,0.09593999493093397,0.5082612755247027
4482,0.4523,3,9,3,664340,12104,113739,12517,0.09586871118996325,0.508387149181593
4483,0.4524,5,14,5,664354,12090,113744,12512,0.09575782537067545,0.5085765384928055
4484,0.4525,13,11,13,664365,12079,113757,12499,0.0956707007983779,0.5085442265440638
4485,0.4526,18,12,18,664377,12067,113775,12481,0.09557565581041694,0.5084324588561187
4486,0.4527,5,8,5,664385,12059,113780,12476,0.09551229248510962,0.508498063990218
4487,0.4528,19,13,19,664398,12046,113799,12457,0.09540932708148524,0.508386728155736
4488,0.4529,7,11,7,664409,12035,113806,12450,0.09532220250918769,0.5084745762711864
4489,0.453,9,10,9,664419,12025,113815,12441,0.09524299835255354,0.5085015940488842
4490,0.4531,13,16,13,664435,12009,113828,12428,0.09511627170193891,0.5085730654335638
4491,0.4532,9,16,9,664451,11993,113837,12419,0.09498954505132429,0.5087252171063411
4492,0.4533,7,17,7,664468,11976,113844,12412,0.09485489798504626,0.5089388223716582
4493,0.4534,8,9,8,664477,11967,113852,12404,0.09478361424407553,0.508965573837758
4494,0.4535,16,16,16,664493,11951,113868,12388,0.0946568875934609,0.5089773614363778
4495,0.4536,13,12,13,664505,11939,113881,12375,0.09456184260549994,0.5089660278029119
4496,0.4537,13,13,13,664518,11926,113894,12362,0.09445887720187555,0.5089756258234519
4497,0.4538,8,6,8,664524,11920,113902,12354,0.09441135470789506,0.5089396061629727
4498,0.4539,7,8,7,664532,11912,113909,12347,0.09434799138258776,0.5089657446720804
4499,0.454,16,10,16,664542,11902,113925,12331,0.09426878722595362,0.5088515660463006
4500,0.4541,12,10,12,664552,11892,113937,12319,0.09418958306931947,0.5088183057288009
4501,0.4542,3,16,3,664568,11876,113940,12316,0.09406285641870485,0.5090939153439153
4502,0.4543,11,8,11,664576,11868,113951,12305,0.09399949309339754,0.5090390104662227
4503,0.4544,4,8,4,664584,11860,113955,12301,0.09393612976809022,0.5091262778858491
4504,0.4545,9,8,9,664592,11852,113964,12292,0.09387276644278292,0.5091119946984758
4505,0.4546,3,12,3,664604,11840,113967,12289,0.09377772145482195,0.5093041568237391
4506,0.4547,9,16,9,664620,11824,113976,12280,0.09365099480420733,0.509459010952539
4507,0.4548,8,13,8,664633,11811,113984,12272,0.09354802940058295,0.5095710667275671
4508,0.4549,7,10,7,664643,11801,113991,12265,0.0934688252439488,0.5096401562370149
4509,0.455,9,14,9,664657,11787,114000,12256,0.093357939424661,0.5097533585659028
4510,0.4551,10,8,10,664665,11779,114010,12246,0.0932945760993537,0.5097190426638918
4511,0.4552,10,17,10,664682,11762,114020,12236,0.09315992903307566,0.5098758229852488
4512,0.4553,12,10,12,664692,11752,114032,12224,0.09308072487644152,0.5098431765098431
4513,0.4554,9,11,9,664703,11741,114041,12215,0.09299360030414396,0.5098931374186008
4514,0.4555,10,6,10,664709,11735,114051,12205,0.09294607781016348,0.5098162071846283
4515,0.4556,9,8,9,664717,11727,114060,12196,0.09288271448485616,0.5098022823224512
4516,0.4557,8,16,8,664733,11711,114068,12188,0.09275598783424154,0.5099794970500858
4517,0.4558,9,11,9,664744,11700,114077,12179,0.09266886326194398,0.5100297332384103
4518,0.4559,8,14,8,664758,11686,114085,12171,0.09255797744265619,0.5101647315253385
4519,0.456,5,11,5,664769,11675,114090,12166,0.09247085287035864,0.5102973868545783
4520,0.4561,13,5,13,664774,11670,114103,12153,0.09243125079204156,0.5101372623095328
4521,0.4562,8,13,8,664787,11657,114111,12145,0.09232828538841718,0.5102512393916477
4522,0.4563,11,9,11,664796,11648,114122,12134,0.09225700164744646,0.5102178117904297
4523,0.4564,6,11,6,664807,11637,114128,12128,0.0921698770751489,0.510330317694088
4524,0.4565,8,9,8,664816,11628,114136,12120,0.09209859333417818,0.5103587670540677
4525,0.4566,7,10,7,664826,11618,114143,12113,0.09201938917754404,0.5104293961484977
4526,0.4567,11,11,11,664837,11607,114154,12102,0.09193226460524648,0.5104390737694546
4527,0.4568,7,15,7,664852,11592,114161,12095,0.09181345837029527,0.5106176383670368
4528,0.4569,5,15,5,664867,11577,114166,12090,0.09169465213534406,0.51083787552288
4529,0.457,7,21,7,664888,11556,114173,12083,0.09152832340641237,0.5111468336224037
4530,0.4571,9,10,9,664898,11546,114182,12074,0.09144911924977824,0.5111769686706181
4531,0.4572,7,8,7,664906,11538,114189,12067,0.09138575592447092,0.5112052531243381
4532,0.4573,6,14,6,664920,11524,114195,12061,0.09127487010518312,0.5113843544625821
4533,0.4574,7,14,7,664934,11510,114202,12054,0.09116398428589532,0.5115430317433373
4534,0.4575,9,10,9,664944,11500,114211,12045,0.09108478012926119,0.5115735825015927
4535,0.4576,6,10,6,664954,11490,114217,12039,0.09100557597262704,0.5116664541629479
4536,0.4577,11,11,11,664965,11479,114228,12028,0.09091845140032949,0.5116773726974944
4537,0.4578,9,12,9,664977,11467,114237,12019,0.09082340641236852,0.5117516818530188
4538,0.4579,7,14,7,664991,11453,114244,12012,0.09071252059308073,0.5119113573407202
4539,0.458,13,12,13,665003,11441,114257,11999,0.09061747560511976,0.5119027303754267
4540,0.4581,8,8,8,665011,11433,114265,11991,0.09055411227981244,0.5119108606557377
4541,0.4582,11,9,11,665020,11424,114276,11980,0.09048282853884172,0.5118783113997607
4542,0.4583,15,11,15,665031,11413,114291,11965,0.09039570396654416,0.5118059714261272
4543,0.4584,13,15,13,665046,11398,114304,11952,0.09027689773159295,0.5118629550321199
4544,0.4585,11,8,11,665054,11390,114315,11941,0.09021353440628564,0.5118083236895118
4545,0.4586,14,15,14,665069,11375,114329,11927,0.09009472817133443,0.5118444768689383
4546,0.4587,10,14,10,665083,11361,114339,11917,0.08998384235204664,0.5119426067531575
4547,0.4588,5,16,5,665099,11345,114344,11912,0.08985711570143201,0.5121898783162059
4548,0.4589,12,17,12,665116,11328,114356,11900,0.08972246863515397,0.5123127260203203
4549,0.459,6,11,6,665127,11317,114362,11894,0.08963534406285642,0.5124294515531429
4550,0.4591,10,13,10,665140,11304,114372,11884,0.08953237865923204,0.5125064688632051
4551,0.4592,13,5,13,665145,11299,114385,11871,0.08949277658091497,0.5123435476909797
4552,0.4593,9,11,9,665156,11288,114394,11862,0.08940565200861741,0.5123974082073434
4553,0.4594,11,9,11,665165,11279,114405,11851,0.08933436826764668,0.5123648940769563
4554,0.4595,9,12,9,665177,11267,114414,11842,0.08923932327968571,0.512441040287334
4555,0.4596,16,15,16,665192,11252,114430,11826,0.0891205170447345,0.5124360863159719
4556,0.4597,6,5,6,665197,11247,114436,11820,0.08908091496641744,0.512420340746521
4557,0.4598,7,3,7,665200,11244,114443,11813,0.0890571537194272,0.5123389859912391
4558,0.4599,11,6,11,665206,11238,114454,11802,0.08900963122544671,0.5122395833333333
4559,0.46,7,12,7,665218,11226,114461,11795,0.08891458623748574,0.5123582815690022
4560,0.4601,14,15,14,665233,11211,114475,11781,0.08879578000253453,0.5123956158663883
4561,0.4602,7,9,7,665242,11202,114482,11774,0.08872449626156381,0.5124477715877437
4562,0.4603,6,9,6,665251,11193,114488,11768,0.08865321252059308,0.5125212316536736
4563,0.4604,4,14,4,665265,11179,114492,11764,0.08854232670130528,0.5127489866190124
4564,0.4605,8,14,8,665279,11165,114500,11756,0.08843144088201749,0.5128921076741852
4565,0.4606,7,11,7,665290,11154,114507,11749,0.08834431630971994,0.512989564685849
4566,0.4607,7,7,7,665297,11147,114514,11742,0.08828887340007603,0.5129975097208266
4567,0.4608,10,10,10,665307,11137,114524,11732,0.0882096692434419,0.5130088766452403
4568,0.4609,12,10,12,665317,11127,114536,11720,0.08813046508680776,0.5129776338250098
4569,0.461,7,16,7,665333,11111,114543,11713,0.08800373843619314,0.5131878724150017
4570,0.4611,7,15,7,665348,11096,114550,11706,0.08788493220124192,0.5133760196473993
4571,0.4612,11,7,11,665355,11089,114561,11695,0.08782948929159802,0.5132988061797753
4572,0.4613,13,14,13,665369,11075,114574,11682,0.08771860347231022,0.5133365557850331
4573,0.4614,7,10,7,665379,11065,114581,11675,0.08763939931567609,0.5134124890061565
4574,0.4615,9,11,9,665390,11054,114590,11666,0.08755227474337854,0.5134683098591549
4575,0.4616,3,8,3,665398,11046,114593,11663,0.08748891141807122,0.5135849222775111
4576,0.4617,9,12,9,665410,11034,114602,11654,0.08739386643011025,0.513663610719323
4577,0.4618,13,12,13,665422,11022,114615,11641,0.08729882144214929,0.513656620923973
4578,0.4619,6,13,6,665435,11009,114621,11635,0.08719585603852491,0.5138226461755874
4579,0.462,15,15,15,665450,10994,114636,11620,0.0870770498035737,0.5138409834615725
4580,0.4621,6,8,6,665458,10986,114642,11614,0.08701368647826638,0.5138938053097345
4581,0.4622,2,8,2,665466,10978,114644,11612,0.08695032315295907,0.514032757857459
4582,0.4623,6,13,6,665479,10965,114650,11606,0.08684735774933469,0.5141996367019627
4583,0.4624,9,13,9,665492,10952,114659,11597,0.0867443923457103,0.5143021863497272
4584,0.4625,9,9,9,665501,10943,114668,11588,0.08667310860473958,0.5143136123563091
4585,0.4626,8,10,8,665511,10933,114676,11580,0.08659390444810544,0.5143694754142051
4586,0.4627,13,15,13,665526,10918,114689,11567,0.08647509821315423,0.5144318434511896
4587,0.4628,6,5,6,665531,10913,114695,11561,0.08643549613483716,0.5144166592506897
4588,0.4629,3,9,3,665540,10904,114698,11558,0.08636421239386644,0.5145579200427388
4589,0.463,9,9,9,665549,10895,114707,11549,0.0862929286528957,0.5145695954375334
4590,0.4631,10,13,10,665562,10882,114717,11539,0.08618996324927132,0.5146514428437625
4591,0.4632,6,11,6,665573,10871,114723,11533,0.08610283867697377,0.5147741474736655
4592,0.4633,13,11,13,665584,10860,114736,11520,0.08601571410467622,0.514745308310992
4593,0.4634,9,12,9,665596,10848,114745,11511,0.08592066911671524,0.514826244465316
4594,0.4635,4,17,4,665613,10831,114749,11507,0.08578602205043721,0.5151311666219
4595,0.4636,10,5,10,665618,10826,114759,11497,0.08574641997212014,0.5150293419343278
4596,0.4637,9,10,9,665628,10816,114768,11488,0.085667215815486,0.5150645624103299
4597,0.4638,9,17,9,665645,10799,114777,11479,0.08553256874920796,0.515261693150193
4598,0.4639,6,14,6,665659,10785,114783,11473,0.08542168292992017,0.5154551172612094
4599,0.464,12,13,12,665672,10772,114795,11461,0.08531871752629577,0.5154949849323078
4600,0.4641,14,24,14,665696,10748,114809,11447,0.08512862755037384,0.5157467898175264
4601,0.4642,8,13,8,665709,10735,114817,11439,0.08502566214674946,0.515874447551186
4602,0.4643,9,10,9,665719,10725,114826,11430,0.08494645799011533,0.5159106296547055
4603,0.4644,8,9,8,665728,10716,114834,11422,0.08487517424914459,0.5159454331917969
4604,0.4645,6,16,6,665744,10700,114840,11416,0.08474844759852997,0.5161873756556339
4605,0.4646,10,12,10,665756,10688,114850,11406,0.084653402610569,0.5162487553181859
4606,0.4647,9,16,9,665772,10672,114859,11397,0.08452667595995438,0.5164257555847569
4607,0.4648,5,11,5,665783,10661,114864,11392,0.08443955138765682,0.5165737087924546
4608,0.4649,8,12,8,665795,10649,114872,11384,0.08434450639969586,0.5166795261652976
4609,0.465,10,14,10,665809,10635,114882,11374,0.08423362058040806,0.516788586487346
4610,0.4651,9,6,9,665815,10629,114891,11365,0.08418609808642757,0.5167318359552605
4611,0.4652,4,10,4,665825,10619,114895,11361,0.08410689392979344,0.5168789808917198
4612,0.4653,10,15,10,665840,10604,114905,11351,0.08398808769484223,0.5170120701434753
4613,0.4654,11,14,11,665854,10590,114916,11340,0.08387720187555443,0.5170998632010944
4614,0.4655,3,19,3,665873,10571,114919,11337,0.08372671397794956,0.517482198283732
4615,0.4656,5,11,5,665884,10560,114924,11332,0.08363958940565201,0.5176320116937694
4616,0.4657,10,13,10,665897,10547,114934,11322,0.08353662400202763,0.5177191458228543
4617,0.4658,8,14,8,665911,10533,114942,11314,0.08342573818273984,0.5178743076852658
4618,0.4659,9,12,9,665923,10521,114951,11305,0.08333069319477886,0.5179602309172546
4619,0.466,9,13,9,665936,10508,114960,11296,0.08322772779115448,0.5180700788846083
4620,0.4661,8,7,8,665943,10501,114968,11288,0.08317228488151059,0.5180595713433384
4621,0.4662,14,7,14,665950,10494,114982,11274,0.08311684197186668,0.5179162072767365
4622,0.4663,7,17,7,665967,10477,114989,11267,0.08298219490558864,0.5181659308314938
4623,0.4664,6,11,6,665978,10466,114995,11261,0.08289507033329109,0.5182952087264694
4624,0.4665,7,7,7,665985,10459,115002,11254,0.0828396274236472,0.5183070050200341
4625,0.4666,9,12,9,665997,10447,115011,11245,0.08274458243568622,0.5183938779273465
4626,0.4667,10,8,10,666005,10439,115021,11235,0.08268121911037891,0.5183630155947218
4627,0.4668,9,15,9,666020,10424,115030,11226,0.0825624128754277,0.5185219399538106
4628,0.4669,8,9,8,666029,10415,115038,11218,0.08249112913445697,0.5185596080062866
4629,0.467,10,11,10,666040,10404,115048,11208,0.08240400456215942,0.5186007773459189
4630,0.4671,6,10,6,666050,10394,115054,11202,0.08232480040552528,0.518707167994073
4631,0.4672,9,8,9,666058,10386,115063,11193,0.08226143708021796,0.5186987348811344
4632,0.4673,9,14,9,666072,10372,115072,11184,0.08215055126093017,0.5188346632028206
4633,0.4674,13,10,13,666082,10362,115085,11171,0.08207134710429603,0.5187851205127014
4634,0.4675,9,8,9,666090,10354,115094,11162,0.08200798377898873,0.5187767242981967
4635,0.4676,6,9,6,666099,10345,115100,11156,0.08193670003801799,0.518859587926143
4636,0.4677,12,15,12,666114,10330,115112,11144,0.08181789380306678,0.518953152649716
4637,0.4678,8,8,8,666122,10322,115120,11136,0.08175453047775948,0.5189672849286979
4638,0.4679,11,9,11,666131,10313,115131,11125,0.08168324673678874,0.5189383337997947
4639,0.468,8,12,8,666143,10301,115139,11117,0.08158820174882778,0.5190493977028667
4640,0.4681,5,8,5,666151,10293,115144,11112,0.08152483842352047,0.5191310441485634
4641,0.4682,17,16,17,666167,10277,115161,11095,0.08139811177290585,0.5191371888452181
4642,0.4683,8,13,8,666180,10264,115169,11087,0.08129514636928147,0.5192731019624374
4643,0.4684,6,12,6,666192,10252,115175,11081,0.08120010138132049,0.5194299910936109
4644,0.4685,13,14,13,666206,10238,115188,11068,0.08108921556203269,0.519478081291655
4645,0.4686,9,13,9,666219,10225,115197,11059,0.08098625015840831,0.5195921819206916
4646,0.4687,7,9,7,666228,10216,115204,11052,0.08091496641743759,0.5196539401918375
4647,0.4688,8,7,8,666235,10209,115212,11044,0.08085952350779368,0.5196442855126335
4648,0.4689,9,9,9,666244,10200,115221,11035,0.08078823976682296,0.5196609371320933
4649,0.469,6,10,6,666254,10190,115227,11029,0.08070903561018883,0.5197700174372025
4650,0.4691,12,12,12,666266,10178,115239,11017,0.08061399062222785,0.519792403868837
4651,0.4692,10,17,10,666283,10161,115249,11007,0.08047934355594982,0.5199829931972789
4652,0.4693,8,10,8,666293,10151,115257,10999,0.08040013939931567,0.5200472813238771
4653,0.4694,12,11,12,666304,10140,115269,10987,0.08031301482701812,0.5200454394850191
4654,0.4695,10,11,10,666315,10129,115279,10977,0.08022589025472057,0.5200890741969109
4655,0.4696,11,12,11,666327,10117,115290,10966,0.08013084526675959,0.5201347056870465
4656,0.4697,5,12,5,666339,10105,115295,10961,0.08003580027879863,0.5203170986423621
4657,0.4698,10,14,10,666353,10091,115305,10951,0.07992491445951083,0.5204353198365175
4658,0.4699,4,14,4,666367,10077,115309,10947,0.07981402864022304,0.5206906392694064
4659,0.47,8,15,8,666382,10062,115317,10939,0.07969522240527183,0.5208799580972334
4660,0.4701,5,6,5,666388,10056,115322,10934,0.07964769991129135,0.5209147212958551
4661,0.4702,7,14,7,666402,10042,115329,10927,0.07953681409200355,0.5211025799990462
4662,0.4703,9,16,9,666418,10026,115338,10918,0.07941008744138893,0.5212948815889993
4663,0.4704,11,19,11,666437,10007,115349,10907,0.07925959954378406,0.5215166873864397
4664,0.4705,3,7,3,666444,10000,115352,10904,0.07920415663414015,0.5216226559510142
4665,0.4706,5,9,5,666453,9991,115357,10899,0.07913287289316943,0.5217328865485878
4666,0.4707,14,10,14,666463,9981,115371,10885,0.0790536687365353,0.5216620339307965
4667,0.4708,3,7,3,666470,9974,115374,10882,0.0789982258268914,0.5217683160721135
4668,0.4709,10,13,10,666483,9961,115384,10872,0.07889526042326701,0.5218643498295973
4669,0.471,9,8,9,666491,9953,115393,10863,0.07883189709795971,0.521858186010761
4670,0.4711,11,14,11,666505,9939,115404,10852,0.0787210112786719,0.5219566158433938
4671,0.4712,8,14,8,666519,9925,115412,10844,0.0786101254593841,0.5221243198998508
4672,0.4713,14,12,14,666531,9913,115426,10830,0.07851508047142314,0.5221038422600396
4673,0.4714,11,16,11,666547,9897,115437,10819,0.07838835382080851,0.5222533307588337
4674,0.4715,11,7,11,666554,9890,115448,10808,0.07833291091116462,0.5221760556575514
4675,0.4716,11,10,11,666564,9880,115459,10797,0.07825370675453047,0.5221743966726314
4676,0.4717,10,6,10,666570,9874,115469,10787,0.07820618426055,0.5220947679202362
4677,0.4718,9,10,9,666580,9864,115478,10778,0.07812698010391585,0.5221393275845364
4678,0.4719,15,8,15,666588,9856,115493,10763,0.07806361677860854,0.5219942771230418
4679,0.472,10,13,10,666601,9843,115503,10753,0.07796065137498416,0.5220916682851039
4680,0.4721,7,14,7,666615,9829,115510,10746,0.07784976555569637,0.52228432563791
4681,0.4722,6,9,6,666624,9820,115516,10740,0.07777848181472563,0.5223735408560312
4682,0.4723,7,13,7,666637,9807,115523,10733,0.07767551641110125,0.5225413826679649
4683,0.4724,6,6,6,666643,9801,115529,10727,0.07762799391712077,0.5225545596258768
4684,0.4725,9,11,9,666654,9790,115538,10718,0.07754086934482321,0.5226253169494831
4685,0.4726,8,5,8,666659,9785,115546,10710,0.07750126726650615,0.5225664796291778
4686,0.4727,5,4,5,666663,9781,115551,10705,0.07746958560385249,0.5225519867226398
4687,0.4728,8,12,8,666675,9769,115559,10697,0.07737454061589152,0.5226717482654158
4688,0.4729,4,11,4,666686,9758,115563,10693,0.07728741604359397,0.5228595178719867
4689,0.473,16,9,16,666695,9749,115579,10677,0.07721613230262324,0.5227161460883188
4690,0.4731,11,12,11,666707,9737,115590,10666,0.07712108731466227,0.5227662598637455
4691,0.4732,15,11,15,666718,9726,115605,10651,0.07703396274236472,0.5226971585611229
4692,0.4733,10,8,10,666726,9718,115615,10641,0.0769705994170574,0.5226681074708974
4693,0.4734,7,11,7,666737,9707,115622,10634,0.07688347484475985,0.522786490339708
4694,0.4735,7,8,7,666745,9699,115629,10627,0.07682011151945255,0.5228279051461183
4695,0.4736,8,13,8,666758,9686,115637,10619,0.07671714611582815,0.5229746367889683
4696,0.4737,9,9,9,666767,9677,115646,10610,0.07664586237485743,0.5229950214423029
4697,0.4738,7,9,7,666776,9668,115653,10603,0.07657457863388671,0.5230625030832223
4698,0.4739,5,11,5,666787,9657,115658,10598,0.07648745406158915,0.523228832387065
4699,0.474,5,11,5,666798,9646,115663,10593,0.0764003294892916,0.5233954246751322
4700,0.4741,6,4,6,666802,9642,115669,10587,0.07636864782663794,0.5233575559839834
4701,0.4742,9,9,9,666811,9633,115678,10578,0.07629736408566722,0.5233783583197269
4702,0.4743,8,3,8,666814,9630,115686,10570,0.07627360283867697,0.5232673267326733
4703,0.4744,8,10,8,666824,9620,115694,10562,0.07619439868204284,0.5233376275889406
4704,0.4745,12,17,12,666841,9603,115706,10550,0.0760597516157648,0.5234952612514265
4705,0.4746,6,4,6,666845,9599,115712,10544,0.07602806995311114,0.5234572804448195
4706,0.4747,7,12,7,666857,9587,115719,10537,0.07593302496515017,0.5236036573245876
4707,0.4748,17,11,17,666868,9576,115736,10520,0.07584590039285262,0.5234872611464968
4708,0.4749,9,6,9,666874,9570,115745,10511,0.07579837789887213,0.5234301080623475
4709,0.475,7,6,7,666880,9564,115752,10504,0.07575085540489165,0.5234203707394858
4710,0.4751,7,9,7,666889,9555,115759,10497,0.07567957166392092,0.5234889287851586
4711,0.4752,14,9,14,666898,9546,115773,10483,0.0756082879229502,0.5233910829297519
4712,0.4753,5,12,5,666910,9534,115778,10478,0.07551324293498923,0.5235858484909055
4713,0.4754,4,8,4,666918,9526,115782,10474,0.07544987960968191,0.5237
4714,0.4755,10,11,10,666929,9515,115792,10464,0.07536275503738436,0.523749937434306
4715,0.4756,9,15,9,666944,9500,115801,10455,0.07524394880243315,0.5239288398897519
4716,0.4757,7,9,7,666953,9491,115808,10448,0.07517266506146243,0.5239981944932043
4717,0.4758,9,10,9,666963,9481,115817,10439,0.07509346090482828,0.5240461847389558
4718,0.4759,6,12,6,666975,9469,115823,10433,0.07499841591686732,0.5242186714903024
4719,0.476,7,15,7,666990,9454,115830,10426,0.0748796096819161,0.5244466800804829
4720,0.4761,9,13,9,667003,9441,115839,10417,0.07477664427829173,0.5245744787994763
4721,0.4762,8,5,8,667008,9436,115847,10409,0.07473704219997465,0.5245149911816579
4722,0.4763,11,6,11,667014,9430,115858,10398,0.07468951970599418,0.5244099253580795
4723,0.4764,7,10,7,667024,9420,115865,10391,0.07461031554936003,0.5245065872495078
4724,0.4765,11,11,11,667035,9409,115876,10380,0.07452319097706248,0.524533831926828
4725,0.4766,15,8,15,667043,9401,115891,10365,0.07445982765175517,0.5243853081048264
4726,0.4767,6,6,6,667049,9395,115897,10359,0.07441230515777468,0.5244001214943809
4727,0.4768,13,8,13,667057,9387,115910,10346,0.07434894183246737,0.5242993969492727
4728,0.4769,6,6,6,667063,9381,115916,10340,0.07430141933848688,0.5243141828507683
4729,0.477,12,11,12,667074,9370,115928,10328,0.07421429476618933,0.5243171895623921
4730,0.4771,11,12,11,667086,9358,115939,10317,0.07411924977822835,0.5243710292249047
4731,0.4772,10,9,10,667095,9349,115949,10307,0.07404796603725763,0.5243691493691494
4732,0.4773,11,13,11,667108,9336,115960,10296,0.07394500063363325,0.5244498777506112
4733,0.4774,8,10,8,667118,9326,115968,10288,0.07386579647699912,0.5245232996838992
4734,0.4775,12,8,12,667126,9318,115980,10276,0.0738024331516918,0.5244462590588955
4735,0.4776,8,13,8,667139,9305,115988,10268,0.07369946774806742,0.524600214581311
4736,0.4777,4,9,4,667148,9296,115992,10264,0.0736281840070967,0.5247443762781187
4737,0.4778,12,9,12,667157,9287,116004,10252,0.07355690026612596,0.5246942013409079
4738,0.4779,8,13,8,667170,9274,116012,10244,0.07345393486250158,0.5248488574649042
4739,0.478,7,10,7,667180,9264,116019,10237,0.07337473070586745,0.5249474385928927
4740,0.4781,8,8,8,667188,9256,116027,10229,0.07331136738056013,0.5249679240441365
4741,0.4782,9,12,9,667200,9244,116036,10220,0.07321632239259916,0.5250719276613235
4742,0.4783,6,5,6,667205,9239,116042,10214,0.07317672031428209,0.525060401994551
4743,0.4784,10,10,10,667215,9229,116052,10204,0.07309751615764795,0.5250861935882262
4744,0.4785,9,9,9,667224,9220,116061,10195,0.07302623241667723,0.5251094514550605
4745,0.4786,3,8,3,667232,9212,116064,10192,0.07296286909136991,0.5252525252525253
4746,0.4787,6,11,6,667243,9201,116070,10186,0.07287574451907236,0.525403620983133
4747,0.4788,2,9,2,667252,9192,116072,10184,0.07280446077810164,0.5255986787778695
4748,0.4789,3,12,3,667264,9180,116075,10181,0.07270941579014066,0.525850937451578
4749,0.479,7,7,7,667271,9173,116082,10174,0.07265397288049677,0.525869643872435
4750,0.4791,9,15,9,667286,9158,116091,10165,0.07253516664554556,0.5260570304818093
4751,0.4792,8,6,8,667292,9152,116099,10157,0.07248764415156507,0.5260241338236056
4752,0.4793,5,4,5,667296,9148,116104,10152,0.07245596248891142,0.5260103626943006
4753,0.4794,9,8,9,667304,9140,116113,10143,0.0723925991636041,0.5260073639993776
4754,0.4795,7,6,7,667310,9134,116120,10136,0.07234507666962363,0.5259989621172807
4755,0.4796,9,10,9,667320,9124,116129,10127,0.07226587251298948,0.5260505947742974
4756,0.4797,6,9,6,667329,9115,116135,10121,0.07219458877201876,0.5261488875025992
4757,0.4798,10,8,10,667337,9107,116145,10111,0.07213122544671144,0.5261213445727964
4758,0.4799,11,13,11,667350,9094,116156,10100,0.07202826004308706,0.526206106074815
4759,0.48,7,10,7,667360,9084,116163,10093,0.07194905588645292,0.5263075559263701
4760,0.4801,10,10,10,667370,9074,116173,10083,0.07186985172981879,0.5263350211410972
4761,0.4802,6,8,6,667378,9066,116179,10077,0.07180648840451147,0.5264065193543331
4762,0.4803,13,6,13,667384,9060,116192,10064,0.07175896591053098,0.5262497385484208
4763,0.4804,10,10,10,667394,9050,116202,10054,0.07167976175389684,0.5262772194304858
4764,0.4805,7,6,7,667400,9044,116209,10047,0.07163223925991637,0.5262689225289403
4765,0.4806,7,8,7,667408,9036,116216,10040,0.07156887593460905,0.5263157894736842
4766,0.4807,5,15,5,667423,9021,116221,10035,0.07145006969965784,0.5266057934508817
4767,0.4808,8,11,8,667434,9010,116229,10027,0.07136294512736029,0.5267111414613647
4768,0.4809,10,13,10,667447,8997,116239,10017,0.0712599797237359,0.5268223414326286
4769,0.481,7,10,7,667457,8987,116246,10010,0.07118077556710176,0.5269253039953677
4770,0.4811,8,14,8,667471,8973,116254,10002,0.07106988974781396,0.5271146245059288
4771,0.4812,8,14,8,667485,8959,116262,9994,0.07095900392852617,0.5273043845301535
4772,0.4813,4,6,4,667491,8953,116266,9990,0.07091148143454569,0.5273715884495592
4773,0.4814,10,16,10,667507,8937,116276,9980,0.07078475478393106,0.5275677961621822
4774,0.4815,5,8,5,667515,8929,116281,9975,0.07072139145862374,0.5276661024121879
4775,0.4816,5,4,5,667519,8925,116286,9970,0.0706897097959701,0.5276528182058746
4776,0.4817,9,5,9,667524,8920,116295,9961,0.07065010771765302,0.5275673957947142
4777,0.4818,9,11,9,667535,8909,116304,9952,0.07056298314535547,0.5276496474206034
4778,0.4819,9,7,9,667542,8902,116313,9943,0.07050754023571157,0.5276200583709206
4779,0.482,9,11,9,667553,8891,116322,9934,0.07042041566341402,0.5277025232403718
4780,0.4821,6,6,6,667559,8885,116328,9928,0.07037289316943353,0.5277201934832296
4781,0.4822,4,8,4,667567,8877,116332,9924,0.07030952984412622,0.5278442636029999
4782,0.4823,8,11,8,667578,8866,116340,9916,0.07022240527182867,0.5279522947502928
4783,0.4824,9,8,9,667586,8858,116349,9907,0.07015904194652135,0.5279509725552891
4784,0.4825,2,8,2,667594,8850,116351,9905,0.07009567862121405,0.5281258331111703
4785,0.4826,6,10,6,667604,8840,116357,9899,0.0700164744645799,0.5282565771919526
4786,0.4827,13,7,13,667611,8833,116370,9886,0.069961031554936,0.5281265024841071
4787,0.4828,6,13,6,667624,8820,116376,9880,0.06985806615131163,0.5283422459893048
4788,0.4829,11,9,11,667633,8811,116387,9869,0.06978678241034089,0.5283190578158459
4789,0.483,9,11,9,667644,8800,116396,9860,0.06969965783804334,0.5284030010718114
4790,0.4831,9,8,9,667652,8792,116405,9851,0.06963629451273602,0.5284020812101057
4791,0.4832,10,13,10,667665,8779,116415,9841,0.06953332910911164,0.5285177228786251
4792,0.4833,5,10,5,667675,8769,116420,9836,0.0694541249524775,0.5286750873421123
4793,0.4834,5,16,5,667691,8753,116425,9831,0.06932739830186288,0.5290034438226431
4794,0.4835,11,4,11,667695,8749,116436,9820,0.06929571663920922,0.5288383865582422
4795,0.4836,11,8,11,667703,8741,116447,9809,0.06923235331390191,0.5287870619946091
4796,0.4837,5,16,5,667719,8725,116452,9804,0.06910562666328729,0.5291165200496519
4797,0.4838,4,7,4,667726,8718,116456,9800,0.06905018375364338,0.5292148180149044
4798,0.4839,11,8,11,667734,8710,116467,9789,0.06898682042833608,0.5291637385804638
4799,0.484,7,9,7,667743,8701,116474,9782,0.06891553668736536,0.5292430882432505
4800,0.4841,5,8,5,667751,8693,116479,9777,0.06885217336205804,0.529344883595019
4801,0.4842,6,6,6,667757,8687,116485,9771,0.06880465086807756,0.52936396142594
4802,0.4843,16,8,16,667765,8679,116501,9755,0.06874128754277024,0.529185201258544
4803,0.4844,8,11,8,667776,8668,116509,9747,0.06865416297047269,0.5292967689383654
4804,0.4845,8,8,8,667784,8660,116517,9739,0.06859079964516537,0.5293222457742268
4805,0.4846,12,11,12,667795,8649,116529,9727,0.06850367507286782,0.5293317370483239
4806,0.4847,8,5,8,667800,8644,116537,9719,0.06846407299455075,0.5292708163154168
4807,0.4848,9,8,9,667808,8636,116546,9710,0.06840070966924344,0.5292706857080562
4808,0.4849,9,12,9,667820,8624,116555,9701,0.06830566468128248,0.5293860845839018
4809,0.485,7,5,7,667825,8619,116562,9694,0.0682660626029654,0.5293507344509365
4810,0.4851,4,14,4,667839,8605,116566,9690,0.0681551767836776,0.52965291063132
4811,0.4852,10,11,10,667850,8594,116576,9680,0.06806805221138006,0.5297143482543505
4812,0.4853,5,8,5,667858,8586,116581,9675,0.06800468888607274,0.5298176441596846
4813,0.4854,6,10,6,667868,8576,116587,9669,0.0679254847294386,0.5299534118936695
4814,0.4855,9,9,9,667877,8567,116596,9660,0.06785420098846788,0.5299829922642234
4815,0.4856,5,3,5,667880,8564,116601,9655,0.06783043974147764,0.5299412701026401
4816,0.4857,10,12,10,667892,8552,116611,9645,0.06773539475351667,0.530032422926856
4817,0.4858,9,16,9,667908,8536,116620,9636,0.06760866810290204,0.5302663438256658
4818,0.4859,6,3,6,667911,8533,116626,9630,0.0675849068559118,0.5301987557121621
4819,0.486,8,4,8,667915,8529,116634,9622,0.06755322519325814,0.5301085339650708
4820,0.4861,11,8,11,667923,8521,116645,9611,0.06748986186795083,0.5300573571586146
4821,0.4862,9,12,9,667935,8509,116654,9602,0.06739481687998986,0.530175031748661
4822,0.4863,7,21,7,667956,8488,116661,9595,0.06722848815105817,0.5306088591494774
4823,0.4864,9,5,9,667961,8483,116670,9586,0.0671888860727411,0.530521888317007
4824,0.4865,6,6,6,667967,8477,116676,9580,0.06714136357876062,0.5305421720108545
4825,0.4866,4,17,4,667984,8460,116680,9576,0.06700671651248258,0.530938123752495
4826,0.4867,5,10,5,667994,8450,116685,9571,0.06692751235584843,0.5311026025192831
4827,0.4868,8,14,8,668008,8436,116693,9563,0.06681662653656063,0.5313072948497138
4828,0.4869,6,8,6,668016,8428,116699,9557,0.06675326321125333,0.5313872671670837
4829,0.487,8,9,8,668025,8419,116707,9549,0.0666819794702826,0.5314447907390917
4830,0.4871,9,9,9,668034,8410,116716,9540,0.06661069572931187,0.5314763231197771
4831,0.4872,6,9,6,668043,8401,116722,9534,0.06653941198834115,0.5315862838026206
4832,0.4873,6,10,6,668053,8391,116728,9528,0.066460207831707,0.5317261007868743
4833,0.4874,10,13,10,668066,8378,116738,9518,0.06635724242808262,0.5318506928922664
4834,0.4875,2,9,2,668075,8369,116740,9516,0.0662859586871119,0.5320659770757619
4835,0.4876,6,4,6,668079,8365,116746,9510,0.06625427702445824,0.532027972027972
4836,0.4877,13,11,13,668090,8354,116759,9497,0.06616715245216069,0.5320150131645286
4837,0.4878,5,8,5,668098,8346,116764,9492,0.06610378912685337,0.5321224352505887
4838,0.4879,8,11,8,668109,8335,116772,9484,0.06601666455455582,0.5322408664908244
4839,0.488,7,13,7,668122,8322,116779,9477,0.06591369915093144,0.5324456430136525
4840,0.4881,10,13,10,668135,8309,116789,9467,0.06581073374730706,0.5325720072007201
4841,0.4882,7,7,7,668142,8302,116796,9460,0.06575529083766316,0.5325976804413918
4842,0.4883,9,6,9,668148,8296,116805,9451,0.06570776834368268,0.5325407111061025
4843,0.4884,9,8,9,668156,8288,116814,9442,0.06564440501837536,0.5325437112239143
4844,0.4885,5,6,5,668162,8282,116819,9437,0.06559688252439488,0.5325921327388679
4845,0.4886,6,5,6,668167,8277,116825,9431,0.06555728044607781,0.5325841427603343
4846,0.4887,7,8,7,668175,8269,116832,9424,0.0654939171207705,0.5326400271293732
4847,0.4888,7,8,7,668183,8261,116839,9417,0.06543055379546318,0.5326960063355584
4848,0.4889,7,9,7,668192,8252,116846,9410,0.06535927005449246,0.5327822443664364
4849,0.489,7,4,7,668196,8248,116853,9403,0.0653275883918388,0.5327176930485525
4850,0.4891,11,9,11,668205,8239,116864,9392,0.06525630465086808,0.5326980885939538
4851,0.4892,2,9,2,668214,8230,116866,9390,0.06518502090989735,0.5329171396140749
4852,0.4893,7,5,7,668219,8225,116873,9383,0.06514541883158029,0.5328827805542935
4853,0.4894,8,13,8,668232,8212,116881,9375,0.06504245342795589,0.5330641951441406
4854,0.4895,9,9,9,668241,8203,116890,9366,0.06497116968698517,0.5330980704650237
4855,0.4896,5,9,5,668250,8194,116895,9361,0.06489988594601445,0.5332383936200513
4856,0.4897,11,16,11,668266,8178,116906,9350,0.06477315929539983,0.5334322227293473
4857,0.4898,15,10,15,668276,8168,116921,9335,0.06469395513876568,0.5333371422041936
4858,0.4899,5,6,5,668282,8162,116926,9330,0.0646464326447852,0.5333866910587697
4859,0.49,6,9,6,668291,8153,116932,9324,0.06457514890381447,0.5335011729701894
4860,0.4901,6,9,6,668300,8144,116938,9318,0.06450386516284375,0.5336158515633947
4861,0.4902,5,10,5,668310,8134,116943,9313,0.06442466100620961,0.5337880437897633
4862,0.4903,8,9,8,668319,8125,116951,9305,0.06435337726523888,0.5338496844520941
4863,0.4904,4,9,4,668328,8116,116955,9301,0.06428209352426816,0.5340184876844463
4864,0.4905,5,8,5,668336,8108,116960,9296,0.06421873019896084,0.5341300850379224
4865,0.4906,14,9,14,668345,8099,116974,9282,0.06414744645799011,0.5340314136125655
4866,0.4907,10,7,10,668352,8092,116984,9272,0.06409200354834621,0.533978346003225
4867,0.4908,12,7,12,668359,8085,116996,9260,0.06403656063870232,0.5338714326895359
4868,0.4909,4,12,4,668371,8073,117000,9256,0.06394151565074135,0.5341335333833458
4869,0.491,7,9,7,668380,8064,117007,9249,0.06387023190977062,0.534222838329579
4870,0.4911,10,8,10,668388,8056,117017,9239,0.06380686858446331,0.5342006360219717
4871,0.4912,3,15,3,668403,8041,117020,9236,0.0636880623495121,0.5345835503849048
4872,0.4913,9,10,9,668413,8031,117029,9227,0.06360885819287797,0.534650596824661
4873,0.4914,6,8,6,668421,8023,117035,9221,0.06354549486757065,0.5347367200185572
4874,0.4915,8,9,8,668430,8014,117043,9213,0.06347421112659993,0.5348000232193649
4875,0.4916,6,5,6,668435,8009,117049,9207,0.06343460904828285,0.5347932156133829
4876,0.4917,6,7,6,668442,8002,117055,9201,0.06337916613863896,0.5348485729233273
4877,0.4918,4,9,4,668451,7993,117059,9197,0.06330788239766823,0.535020360674811
4878,0.4919,6,6,6,668457,7987,117065,9191,0.06326035990368775,0.5350448247758761
4879,0.492,9,5,9,668462,7982,117074,9182,0.06322075782537068,0.5349568865066419
4880,0.4921,2,10,2,668472,7972,117076,9180,0.06314155366873654,0.535214552238806
4881,0.4922,6,13,6,668485,7959,117082,9174,0.06303858826511215,0.5354578882857643
4882,0.4923,9,7,9,668492,7952,117091,9165,0.06298314535546826,0.5354326108547058
4883,0.4924,6,4,6,668496,7948,117097,9159,0.0629514636928146,0.5353948675980593
4884,0.4925,9,12,9,668508,7936,117106,9150,0.06285641870485363,0.5355261617698701
4885,0.4926,11,11,11,668519,7925,117117,9139,0.06276929413255608,0.5355719643694328
4886,0.4927,9,5,9,668524,7920,117126,9130,0.062729692054239,0.535483870967742
4887,0.4928,4,8,4,668532,7912,117130,9126,0.0626663287289317,0.535626247212114
4888,0.4929,11,8,11,668540,7904,117141,9115,0.06260296540362438,0.5355778835419237
4889,0.493,5,9,5,668549,7895,117146,9110,0.06253168166265366,0.5357247868274037
4890,0.4931,11,9,11,668558,7886,117157,9099,0.06246039792168293,0.5357079776273183
4891,0.4932,6,12,6,668570,7874,117163,9093,0.06236535293372196,0.5359226734248836
4892,0.4933,3,10,3,668580,7864,117166,9090,0.062286148777087824,0.5361566591954701
4893,0.4934,6,13,6,668593,7851,117172,9084,0.06218318337346344,0.5364038972542072
4894,0.4935,9,11,9,668604,7840,117181,9075,0.062096058801165886,0.5365060597103163
4895,0.4936,4,7,4,668611,7833,117185,9071,0.06204061589152199,0.536618551822054
4896,0.4937,10,8,10,668619,7825,117195,9061,0.061977252566214676,0.5365983655098898
4897,0.4938,11,8,11,668627,7817,117206,9050,0.06191388924090736,0.5365506610541294
4898,0.4939,10,7,10,668634,7810,117216,9040,0.061858446331263466,0.5364985163204747
4899,0.494,15,10,15,668644,7800,117231,9025,0.06177924217462932,0.5364041604754829
4900,0.4941,4,5,4,668649,7795,117235,9021,0.061739640096312255,0.53645337773549
4901,0.4942,8,11,8,668660,7784,117243,9013,0.0616525155240147,0.53658391379413
4902,0.4943,8,2,8,668662,7782,117251,9005,0.061636674692687875,0.5364269970810747
4903,0.4944,10,6,10,668668,7776,117261,8995,0.061589152198707385,0.5363424959751952
4904,0.4945,5,9,5,668677,7767,117266,8990,0.061517868457736664,0.5364922122098228
4905,0.4946,6,8,6,668685,7759,117272,8984,0.06145450513242935,0.5365824523681538
4906,0.4947,10,12,10,668697,7747,117282,8974,0.06135946014446838,0.5366903893307816
4907,0.4948,9,6,9,668703,7741,117291,8965,0.0613119376504879,0.5366335448341913
4908,0.4949,12,6,12,668709,7735,117303,8953,0.061264415156507414,0.5364932885906041
4909,0.495,4,4,4,668713,7731,117307,8949,0.061232733493853754,0.5365107913669065
4910,0.4951,9,2,9,668715,7729,117316,8940,0.06121689266252693,0.5363249145119683
4911,0.4952,10,12,10,668727,7717,117326,8930,0.06112184767456596,0.5364329909292965
4912,0.4953,5,7,5,668734,7710,117331,8925,0.06106640476492206,0.5365193868349865
4913,0.4954,8,9,8,668743,7701,117339,8917,0.06099512102395134,0.5365868335539776
4914,0.4955,9,10,9,668753,7691,117348,8908,0.0609159168673172,0.5366588348695704
4915,0.4956,3,7,3,668760,7684,117351,8905,0.0608604739576733,0.5368014949665441
4916,0.4957,4,8,4,668768,7676,117355,8901,0.06079711063236599,0.536948784460397
4917,0.4958,6,15,6,668783,7661,117361,8895,0.06067830439741478,0.5372674559072239
4918,0.4959,13,11,13,668794,7650,117374,8882,0.06059117982511722,0.537261069441084
4919,0.496,7,6,7,668800,7644,117381,8875,0.06054365733113674,0.5372601247048853
4920,0.4961,9,9,9,668809,7635,117390,8866,0.06047237359016601,0.5373007696503243
4921,0.4962,4,13,4,668822,7622,117394,8862,0.06036940818654163,0.5376122300412521
4922,0.4963,8,8,8,668830,7614,117402,8854,0.060306044861234316,0.5376487733786738
4923,0.4964,11,10,11,668840,7604,117413,8843,0.06022684070460018,0.5376664437283395
4924,0.4965,1,10,1,668850,7594,117414,8842,0.06014763654796604,0.5379654417133123
4925,0.4966,10,10,10,668860,7584,117424,8832,0.060068432391331895,0.5380116959064327
4926,0.4967,6,7,6,668867,7577,117430,8826,0.060012989481688,0.5380723038468573
4927,0.4968,2,8,2,668875,7569,117432,8824,0.059949626156380685,0.538278533520405
4928,0.4969,9,5,9,668880,7564,117441,8815,0.05991002407806362,0.5381891446364246
4929,0.497,7,9,7,668889,7555,117448,8808,0.05983874033709289,0.5382876000733362
4930,0.4971,5,9,5,668898,7546,117453,8803,0.05976745659612216,0.5384427182090648
4931,0.4972,11,6,11,668904,7540,117464,8792,0.05971993410214168,0.538329659564046
4932,0.4973,6,8,6,668912,7532,117470,8786,0.05965657077683437,0.5384238264493197
4933,0.4974,7,10,7,668922,7522,117477,8779,0.05957736662020023,0.5385559168149193
4934,0.4975,12,7,12,668929,7515,117489,8767,0.05952192371055633,0.5384473651885517
4935,0.4976,4,13,4,668942,7502,117493,8763,0.059418958306931946,0.5387642176452505
4936,0.4977,6,7,6,668949,7495,117499,8757,0.05936351539728805,0.538825990647305
4937,0.4978,9,9,9,668958,7486,117508,8748,0.05929223165631732,0.5388690402858198
4938,0.4979,10,9,10,668967,7477,117518,8738,0.0592209479153466,0.5388837496145544
4939,0.498,11,10,11,668977,7467,117529,8727,0.05914174375871246,0.5389032975175991
4940,0.4981,10,11,10,668988,7456,117539,8717,0.0590546191864149,0.5389847276324738
4941,0.4982,16,8,16,668996,7448,117555,8701,0.058991255861107594,0.5387949718248808
4942,0.4983,7,8,7,669004,7440,117562,8694,0.05892789253580028,0.5388620304946077
4943,0.4984,4,11,4,669015,7429,117566,8690,0.058840767963502724,0.5391153297350952
4944,0.4985,10,11,10,669026,7418,117576,8680,0.058753643391205174,0.5391974158280531
4945,0.4986,8,10,8,669036,7408,117584,8672,0.05867443923457103,0.5393034825870647
4946,0.4987,4,13,4,669049,7395,117588,8668,0.05857147383094665,0.539625225673909
4947,0.4988,9,9,9,669058,7386,117597,8659,0.05850019008997592,0.5396696790277346
4948,0.4989,12,7,12,669065,7379,117609,8647,0.058444747180332025,0.53956071384001
4949,0.499,5,6,5,669071,7373,117614,8642,0.05839722468635154,0.5396191070871058
4950,0.4991,7,12,7,669083,7361,117621,8635,0.05830217969839057,0.5398224556139035
4951,0.4992,10,7,10,669090,7354,117631,8625,0.05824673678874667,0.5397709493710495
4952,0.4993,6,6,6,669096,7348,117637,8619,0.05819921429476619,0.5398008392309137
4953,0.4994,13,5,13,669101,7343,117650,8606,0.05815961221644912,0.5395949589315945
4954,0.4995,6,6,6,669107,7337,117656,8600,0.05811208972246863,0.5396247725418837
4955,0.4996,7,10,7,669117,7327,117663,8593,0.0580328855658345,0.5397613065326633
4956,0.4997,8,8,8,669125,7319,117671,8585,0.057969522240527184,0.5398013078470825
4957,0.4998,3,6,3,669131,7313,117674,8582,0.0579219997465467,0.5399182132746146
4958,0.4999,7,14,7,669145,7299,117681,8575,0.057811113927258906,0.5401915081264962
4959,0.5,9,9,9,669154,7290,117690,8566,0.05773983018628818,0.5402371342078708
4960,0.5001,5,11,5,669165,7279,117695,8561,0.05765270561399062,0.5404671717171717
4961,0.5002,15,12,15,669177,7267,117710,8546,0.057557660626029655,0.5404414089673054
4962,0.5003,7,13,7,669190,7254,117717,8539,0.057454695222405275,0.5406825808902679
4963,0.5004,5,7,5,669197,7247,117722,8534,0.05739925231276138,0.5407768835941955
4964,0.5005,6,6,6,669203,7241,117728,8528,0.05735172981878089,0.5408079142621599
4965,0.5006,6,3,6,669206,7238,117734,8522,0.05732796857179065,0.540736040609137
4966,0.5007,12,12,12,669218,7226,117746,8510,0.05723292358382968,0.5407981698017286
4967,0.5008,8,7,8,669225,7219,117754,8502,0.05717748067418578,0.5408052922842058
4968,0.5009,13,6,13,669231,7213,117767,8489,0.0571299581802053,0.5406317666539294
4969,0.501,6,12,6,669243,7201,117773,8483,0.05703491319224433,0.5408696761030349
4970,0.5011,6,10,6,669253,7191,117779,8477,0.05695570903561019,0.5410390605054889
4971,0.5012,8,5,8,669258,7186,117787,8469,0.05691610695729312,0.5409773235388055
4972,0.5013,10,3,10,669261,7183,117797,8459,0.056892345710302876,0.5407876230661041
4973,0.5014,5,6,5,669267,7177,117802,8454,0.05684482321632239,0.540848314247329
4974,0.5015,8,7,8,669274,7170,117810,8446,0.056789380306678496,0.5408555327868853
4975,0.5016,16,14,16,669288,7156,117826,8430,0.0566784944873907,0.5408700115488259
4976,0.5017,5,10,5,669298,7146,117831,8425,0.05659929033075656,0.5410699377047075
4977,0.5018,10,5,10,669303,7141,117841,8415,0.05655968825243949,0.5409488300334276
4978,0.5019,5,9,5,669312,7132,117846,8410,0.05648840451146876,0.5411143996911595
4979,0.502,10,7,10,669319,7125,117856,8400,0.056432961601824864,0.5410628019323671
4980,0.5021,7,17,7,669336,7108,117863,8393,0.056298314535546824,0.5414489387781434
4981,0.5022,5,6,5,669342,7102,117868,8388,0.05625079204156634,0.5415106520335701
4982,0.5023,14,8,14,669350,7094,117882,8374,0.05618742871625903,0.5413757434703905
4983,0.5024,6,8,6,669358,7086,117888,8368,0.056124065390951716,0.5414779345153359
4984,0.5025,12,8,12,669366,7078,117900,8356,0.056060702065644404,0.541402099261371
4985,0.5026,5,8,5,669374,7070,117905,8351,0.05599733874033709,0.5415342714480255
4986,0.5027,0,12,0,669386,7058,117905,8351,0.055902293752376125,0.5419559997404114
4987,0.5028,5,7,5,669393,7051,117910,8346,0.05584685084273223,0.5420536468143144
4988,0.5029,4,11,4,669404,7040,117914,8342,0.05575972627043467,0.5423221947731114
4989,0.503,7,10,7,669414,7030,117921,8335,0.055680522113800535,0.5424666449723398
4990,0.5031,4,14,4,669428,7016,117925,8331,0.05556963629451274,0.5428422492995374
4991,0.5032,9,11,9,669439,7005,117934,8322,0.05548251172221518,0.54296339792523
4992,0.5033,5,4,5,669443,7001,117939,8317,0.05545083005956153,0.5429559994777386
4993,0.5034,7,11,7,669454,6990,117946,8310,0.05536370548726397,0.5431372549019607
4994,0.5035,8,6,8,669460,6984,117954,8302,0.05531618299328349,0.5431113437132016
4995,0.5036,6,5,6,669465,6979,117960,8296,0.05527658091496642,0.5431096563011457
4996,0.5037,7,6,7,669471,6973,117967,8289,0.05522905842098593,0.5431136155156598
4997,0.5038,9,6,9,669477,6967,117976,8280,0.05518153592700545,0.5430576506853807
4998,0.5039,5,8,5,669485,6959,117981,8275,0.055118172601698136,0.5431928580806091
4999,0.504,10,8,10,669493,6951,117991,8265,0.05505480927639082,0.5431782334384858
5000,0.5041,12,7,12,669500,6944,118003,8253,0.054999366366746925,0.5430677107323814
5001,0.5042,10,3,10,669503,6941,118013,8243,0.05497560511975669,0.5428740779768177
5002,0.5043,8,6,8,669509,6935,118021,8235,0.0549280826257762,0.5428477257745551
5003,0.5044,4,13,4,669522,6922,118025,8231,0.05482511722215182,0.5431927671088234
5004,0.5045,2,5,2,669527,6917,118027,8229,0.05478551514383475,0.5433117654826357
5005,0.5046,5,6,5,669533,6911,118032,8224,0.05473799264985427,0.5433762801453584
5006,0.5047,9,8,9,669541,6903,118041,8215,0.054674629324546954,0.5433919830665432
5007,0.5048,4,9,4,669550,6894,118045,8211,0.05460334558357623,0.5435948361469712
5008,0.5049,3,9,3,669559,6885,118048,8208,0.0545320618426055,0.5438282647584973
5009,0.505,3,8,3,669567,6877,118051,8205,0.054468698517298186,0.5440259912478451
5010,0.5051,7,9,7,669576,6868,118058,8198,0.05439741477632746,0.5441391212000531
5011,0.5052,10,12,10,669588,6856,118068,8188,0.05430236978836649,0.5442701409199681
5012,0.5053,10,8,10,669596,6848,118078,8178,0.05423900646305918,0.5442566218554505
5013,0.5054,10,8,10,669604,6840,118088,8168,0.05417564313775187,0.5442430703624733
5014,0.5055,13,3,13,669607,6837,118101,8155,0.05415188189076163,0.5439567769477054
5015,0.5056,2,10,2,669617,6827,118103,8153,0.05407267773412749,0.5442590120160213
5016,0.5057,6,9,6,669626,6818,118109,8147,0.05400139399315676,0.5444036084196459
5017,0.5058,9,11,9,669637,6807,118118,8138,0.05391426942085921,0.5445299431247909
5018,0.5059,7,7,7,669644,6800,118125,8131,0.05385882651121531,0.5445716964704307
5019,0.506,10,8,10,669652,6792,118135,8121,0.053795463185908,0.5445584389458862
5020,0.5061,5,16,5,669668,6776,118140,8116,0.053668736535293374,0.5449905989793178
5021,0.5062,10,8,10,669676,6768,118150,8106,0.05360537320998606,0.54497781363453
5022,0.5063,2,5,2,669681,6763,118152,8104,0.05356577113166899,0.5450998856527881
5023,0.5064,9,13,9,669694,6750,118161,8095,0.053462805728044606,0.5453014482990906
5024,0.5065,3,8,3,669702,6742,118164,8092,0.05339944240273729,0.5455035728731293
5025,0.5066,13,10,13,669712,6732,118177,8079,0.05332023824610316,0.5454729592870164
5026,0.5067,3,7,3,669719,6725,118180,8076,0.05326479533645926,0.5456388081886359
5027,0.5068,2,9,2,669728,6716,118182,8074,0.05319351159548853,0.5459093982420554
5028,0.5069,6,11,6,669739,6705,118188,8068,0.053106387023190975,0.5461314560346578
5029,0.507,11,7,11,669746,6698,118199,8057,0.05305094411354708,0.5460521856997628
5030,0.5071,13,10,13,669756,6688,118212,8044,0.05297173995691294,0.546022264458322
5031,0.5072,12,9,12,669765,6679,118224,8032,0.052900456215942214,0.5459859968730881
5032,0.5073,8,11,8,669776,6668,118232,8024,0.052813331643644656,0.546147563299755
5033,0.5074,6,6,6,669782,6662,118238,8018,0.052765809149664174,0.5461852861035422
5034,0.5075,4,9,4,669791,6653,118242,8014,0.052694525408693446,0.5463966728028908
5035,0.5076,7,8,7,669799,6645,118249,8007,0.052631162083386133,0.5464782964782965
5036,0.5077,5,3,5,669802,6642,118254,8002,0.052607400836395896,0.5464354001638897
5037,0.5078,6,8,6,669810,6634,118260,7996,0.05254403751108858,0.5465481886534518
5038,0.5079,6,8,6,669818,6626,118266,7990,0.05248067418578127,0.5466611932129174
5039,0.508,6,8,6,669826,6618,118272,7984,0.05241731086047396,0.5467744144637721
5040,0.5081,5,6,5,669832,6612,118277,7979,0.052369788366493475,0.5468439448975396
5041,0.5082,7,9,7,669841,6603,118284,7972,0.05229850462552275,0.5469639794168096
5042,0.5083,5,9,5,669850,6594,118289,7967,0.05222722088455202,0.5471464871918138
5043,0.5084,14,10,14,669860,6584,118303,7953,0.052148016727917884,0.5470867441700489
5044,0.5085,9,7,9,669867,6577,118312,7944,0.052092573818273986,0.5470697610357413
5045,0.5086,7,7,7,669874,6570,118319,7937,0.05203713090863008,0.5471151857723857
5046,0.5087,7,8,7,669882,6562,118326,7930,0.051973767583322776,0.5471984543196247
5047,0.5088,7,8,7,669890,6554,118333,7923,0.05191040425801546,0.5472818954203219
5048,0.5089,10,7,10,669897,6547,118343,7913,0.051854961348371566,0.5472337482710927
5049,0.509,7,9,7,669906,6538,118350,7906,0.05178367760740084,0.5473553032400997
5050,0.5091,9,6,9,669912,6532,118359,7897,0.051736155113420355,0.5473005752304387
5051,0.5092,10,7,10,669919,6525,118369,7887,0.05168071220377645,0.5472522897585346
5052,0.5093,8,7,8,669926,6518,118377,7879,0.05162526929413255,0.5472667916927137
5053,0.5094,5,11,5,669937,6507,118382,7874,0.051538144721835,0.5475279883179195
5054,0.5095,4,7,4,669944,6500,118386,7870,0.051482701812191105,0.5476687543493389
5055,0.5096,8,9,8,669953,6491,118394,7862,0.05141141807122038,0.5477600501637289
5056,0.5097,9,14,9,669967,6477,118403,7853,0.05130053225193258,0.5480111653872993
5057,0.5098,6,3,6,669970,6474,118409,7847,0.05127677100494234,0.5479365966063823
5058,0.5099,10,8,10,669978,6466,118419,7837,0.051213407679635024,0.5479270083199329
5059,0.51,9,7,9,669985,6459,118428,7828,0.05115796476999113,0.5479106880380765
5060,0.5101,3,10,3,669995,6449,118431,7825,0.05107876061335699,0.5481995236093596
5061,0.5102,7,4,7,669999,6445,118438,7818,0.05104707895070333,0.5481315291313188
5062,0.5103,3,5,3,670004,6440,118441,7815,0.05100747687238626,0.5482286916871273
5063,0.5104,5,6,5,670010,6434,118446,7810,0.05095995437840578,0.5483010390339792
5064,0.5105,10,7,10,670017,6427,118456,7800,0.05090451146876188,0.5482533211499262
5065,0.5106,10,9,10,670026,6418,118466,7790,0.050833227727791155,0.5482826576576577
5066,0.5107,16,5,16,670031,6413,118482,7774,0.05079362564947409,0.5479664481567632
5067,0.5108,14,7,14,670038,6406,118496,7760,0.05073818273983018,0.5477904842580827
5068,0.5109,2,10,2,670048,6396,118498,7758,0.05065897858319605,0.5481136074607885
5069,0.511,5,9,5,670057,6387,118503,7753,0.05058769484222532,0.5483026874115983
5070,0.5111,6,7,6,670064,6380,118509,7747,0.05053225193258142,0.5483825299072698
5071,0.5112,6,8,6,670072,6372,118515,7741,0.05046888860727411,0.5485013817048112
5072,0.5113,10,5,10,670077,6367,118525,7731,0.05042928652895704,0.5483756561214357
5073,0.5114,8,7,8,670084,6360,118533,7723,0.050373843619313144,0.5483916779095364
5074,0.5115,8,11,8,670095,6349,118541,7715,0.050286719047015586,0.5485637087599545
5075,0.5116,4,6,4,670101,6343,118545,7711,0.050239196553035104,0.5486694179592998
5076,0.5117,7,8,7,670109,6335,118552,7704,0.05017583322772779,0.548757033976779
5077,0.5118,8,7,8,670116,6328,118560,7696,0.05012039031808389,0.5487735310895607
5078,0.5119,6,7,6,670123,6321,118566,7690,0.050064947408439996,0.548854471486689
5079,0.512,8,10,8,670133,6311,118574,7682,0.04998574325180585,0.5489887801043379
5080,0.5121,6,6,6,670139,6305,118580,7676,0.04993822075782537,0.5490308275516773
5081,0.5122,6,5,6,670144,6300,118586,7670,0.0498986186795083,0.5490336435218325
5082,0.5123,5,9,5,670153,6291,118591,7665,0.049827334938537575,0.5492261392949269
5083,0.5124,7,2,7,670155,6289,118598,7658,0.049811494107210745,0.5490786549078654
5084,0.5125,6,4,6,670159,6285,118604,7652,0.04977981244455709,0.5490421181028916
5085,0.5126,7,6,7,670165,6279,118611,7645,0.04973228995057661,0.5490519965527147
5086,0.5127,4,4,4,670169,6275,118615,7641,0.04970060828792295,0.5490801954584651
5087,0.5128,9,6,9,670175,6269,118624,7632,0.04965308579394247,0.5490252499820156
5088,0.5129,13,8,13,670183,6261,118637,7619,0.049589722468635154,0.5489193083573487
5089,0.513,5,8,5,670191,6253,118642,7614,0.04952635914332784,0.549073339583183
5090,0.5131,7,7,7,670198,6246,118649,7607,0.049470916233683944,0.549122933660579
5091,0.5132,5,7,5,670205,6239,118654,7602,0.049415473324040046,0.5492377718372949
5092,0.5133,6,8,6,670213,6231,118660,7596,0.049352109998732734,0.549359947927967
5093,0.5134,12,6,12,670219,6225,118672,7584,0.04930458750475225,0.549207038887682
5094,0.5135,9,6,9,670225,6219,118681,7575,0.04925706501077177,0.5491518051326664
5095,0.5136,3,4,3,670229,6215,118684,7572,0.04922538334811811,0.5492130267643432
5096,0.5137,5,6,5,670235,6209,118689,7567,0.049177860854137626,0.5492886178861789
5097,0.5138,13,5,13,670240,6204,118702,7554,0.04913825877582056,0.5490623637156563
5098,0.5139,9,5,9,670245,6199,118711,7545,0.04909865669750348,0.5489668218859138
5099,0.514,8,9,8,670254,6190,118719,7537,0.049027372956532755,0.5490638886865302
5100,0.5141,7,8,7,670262,6182,118726,7530,0.04896400963122545,0.5491540256709452
5101,0.5142,7,5,7,670267,6177,118733,7523,0.048924407552908375,0.5491240875912409
5102,0.5143,8,9,8,670276,6168,118741,7515,0.04885312381193765,0.5492216619162464
5103,0.5144,7,8,7,670284,6160,118748,7508,0.04878976048663034,0.5493122622183202
5104,0.5145,12,7,12,670291,6153,118760,7496,0.04873431757698644,0.5491977434244267
5105,0.5146,5,10,5,670301,6143,118765,7491,0.0486551134203523,0.5494352354408097
5106,0.5147,7,5,7,670306,6138,118772,7484,0.04861551134203523,0.5494053736602554
5107,0.5148,5,6,5,670312,6132,118777,7479,0.048567988848054744,0.5494820365880538
5108,0.5149,8,5,8,670317,6127,118785,7471,0.048528386769737676,0.5494190322106192
5109,0.515,5,11,5,670328,6116,118790,7466,0.04844126219744012,0.5496981298777794
5110,0.5151,5,7,5,670335,6109,118795,7461,0.04838581928779622,0.5498157700810612
5111,0.5152,3,8,3,670343,6101,118798,7458,0.04832245596248891,0.5500405634633823
5112,0.5153,6,4,6,670347,6097,118804,7452,0.048290774299835255,0.5500036903092479
5113,0.5154,9,6,9,670353,6091,118813,7443,0.04824325180585477,0.5499482784099305
5114,0.5155,1,6,1,670359,6085,118814,7442,0.04819572931187429,0.5501589413765062
5115,0.5156,3,10,3,670369,6075,118817,7439,0.04811652515524015,0.5504661832174041
5116,0.5157,6,6,6,670375,6069,118823,7433,0.048069002661259665,0.5505110354021626
5117,0.5158,7,4,7,670379,6065,118830,7426,0.048037320998606005,0.5504410347639167
5118,0.5159,4,8,4,670387,6057,118834,7422,0.04797395767329869,0.5506343200534164
5119,0.516,8,7,8,670394,6050,118842,7414,0.047918514763654795,0.5506535947712419
5120,0.5161,10,8,10,670402,6042,118852,7404,0.04785515143834748,0.5506470325747435
5121,0.5162,2,11,2,670413,6031,118854,7402,0.04776802686604993,0.5510310429539195
5122,0.5163,15,7,15,670420,6024,118869,7387,0.047712583956406034,0.5508164939228991
5123,0.5164,11,8,11,670428,6016,118880,7376,0.04764922063109872,0.5507765830346476
5124,0.5165,9,9,9,670437,6007,118889,7367,0.04757793689012799,0.5508449229848961
5125,0.5166,5,5,5,670442,6002,118894,7362,0.047538334811810926,0.550882969170907
5126,0.5167,7,8,7,670450,5994,118901,7355,0.04747497148650361,0.5509776013184509
5127,0.5168,7,5,7,670455,5989,118908,7348,0.04743536940818654,0.5509484891654794
5128,0.5169,4,11,4,670466,5978,118912,7344,0.04734824483588899,0.5512685782915479
5129,0.517,9,8,9,670474,5970,118921,7335,0.047284881510581675,0.5512965050732808
5130,0.5171,5,6,5,670480,5964,118926,7330,0.04723735901660119,0.5513765608545208
5131,0.5172,7,8,7,670488,5956,118933,7323,0.04717399569129388,0.5514722494163717
5132,0.5173,4,10,4,670498,5946,118937,7319,0.04709479153465974,0.5517527327553713
5133,0.5174,4,11,4,670509,5935,118941,7315,0.047007666962362187,0.5520754716981132
5134,0.5175,6,5,6,670514,5930,118947,7309,0.04696806488404511,0.5520809728831483
5135,0.5176,9,3,9,670517,5927,118956,7300,0.046944303637054874,0.5519014137748545
5136,0.5177,9,5,9,670522,5922,118965,7291,0.0469047015587378,0.5518050404904261
5137,0.5178,7,10,7,670532,5912,118972,7284,0.046825497402103664,0.551985450136405
5138,0.5179,4,9,4,670541,5903,118976,7280,0.046754213661132936,0.5522263521201547
5139,0.518,5,8,5,670549,5895,118981,7275,0.04669085033582562,0.5523917995444191
5140,0.5181,8,3,8,670552,5892,118989,7267,0.046667089088835385,0.552245611368645
5141,0.5182,5,8,5,670560,5884,118994,7262,0.04660372576352807,0.5524113798874182
5142,0.5183,7,9,7,670569,5875,119001,7255,0.046532442022557345,0.5525514089870526
5143,0.5184,6,9,6,670578,5866,119007,7249,0.04646115828158662,0.5527258863896302
5144,0.5185,4,7,4,670585,5859,119011,7245,0.04640571537194272,0.5528846153846154
5145,0.5186,7,8,7,670593,5851,119018,7238,0.04634235204663541,0.5529834211933685
5146,0.5187,6,7,6,670600,5844,119024,7232,0.04628690913699151,0.5530743346589171
5147,0.5188,6,6,6,670606,5838,119030,7226,0.04623938664301103,0.5531230863441519
5148,0.5189,7,5,7,670611,5833,119037,7219,0.04619978456469395,0.5530953110634386
5149,0.519,7,9,7,670620,5824,119044,7212,0.04612850082372323,0.5532371893218779
5150,0.5191,2,8,2,670628,5816,119046,7210,0.04606513749841592,0.5535083678796253
5151,0.5192,5,5,5,670633,5811,119051,7205,0.046025535420098844,0.5535494775660725
5152,0.5193,6,9,6,670642,5802,119057,7199,0.04595425167912812,0.5537266364125837
5153,0.5194,14,7,14,670649,5795,119071,7185,0.045898808769484226,0.5535439137134053
5154,0.5195,8,8,8,670657,5787,119079,7177,0.04583544544417691,0.5536099969145325
5155,0.5196,7,2,7,670659,5785,119086,7170,0.04581960461285008,0.5534542647626399
5156,0.5197,10,11,10,670670,5774,119096,7160,0.045732480040552526,0.5535797123859595
5157,0.5198,4,9,4,670679,5765,119100,7156,0.045661196299581805,0.5538271031653896
5158,0.5199,11,8,11,670687,5757,119111,7145,0.04559783297427449,0.5537901100604558
5159,0.52,9,11,9,670698,5746,119120,7136,0.045510708401976935,0.5539512498059308
5160,0.5201,8,4,8,670702,5742,119128,7128,0.04547902673932328,0.5538461538461539
5161,0.5202,7,3,7,670705,5739,119135,7121,0.04545526549233304,0.5537325038880249
5162,0.5203,8,5,8,670710,5734,119143,7113,0.04541566341401597,0.5536701175371682
5163,0.5204,8,7,8,670717,5727,119151,7105,0.04536022050437207,0.5536938902743143
5164,0.5205,7,6,7,670723,5721,119158,7098,0.04531269801039158,0.5537093377018488
5165,0.5206,12,4,12,670727,5717,119170,7086,0.04528101634773793,0.553464031867531
5166,0.5207,9,6,9,670733,5711,119179,7077,0.045233493853757446,0.5534094463559587
5167,0.5208,7,8,7,670741,5703,119186,7070,0.045170130528450134,0.5535113129257027
5168,0.5209,8,6,8,670747,5697,119194,7062,0.04512260803446965,0.5534916529508582
5169,0.521,7,13,7,670760,5684,119201,7055,0.045019642630845264,0.5538111311719915
5170,0.5211,7,9,7,670769,5675,119208,7048,0.04494835888987454,0.5539573999842804
5171,0.5212,4,9,4,670778,5666,119212,7044,0.044877075148903815,0.5542092840283241
5172,0.5213,5,4,5,670782,5662,119217,7039,0.044845393486250155,0.5542083300527517
5173,0.5214,11,8,11,670790,5654,119228,7028,0.04478203016094284,0.5541712663617726
5174,0.5215,8,4,8,670794,5650,119236,7020,0.04475034849828919,0.5540647198105761
5175,0.5216,11,9,11,670803,5641,119247,7009,0.04467906475731846,0.5540711462450593
5176,0.5217,4,3,4,670806,5638,119251,7005,0.044655303510328224,0.5540615360278415
5177,0.5218,7,7,7,670813,5631,119258,6998,0.04459986060068433,0.5541214664660702
5178,0.5219,5,10,5,670823,5621,119263,6993,0.044520656444050184,0.5543840177580466
5179,0.522,9,5,9,670828,5616,119272,6984,0.044481054365733116,0.5542857142857143
5180,0.5221,5,3,5,670831,5613,119277,6979,0.04445729311874287,0.5542407878017789
5181,0.5222,2,3,2,670834,5610,119279,6977,0.04443353187175263,0.5543020576785572
5182,0.5223,6,5,6,670839,5605,119285,6971,0.04439392979343556,0.554309796437659
5183,0.5224,9,3,9,670842,5602,119294,6962,0.044370168546445314,0.5541228907991086
5184,0.5225,8,8,8,670850,5594,119302,6954,0.04430680522113801,0.5541919030921262
5185,0.5226,6,5,6,670855,5589,119308,6948,0.044267203142820934,0.5541995692749462
5186,0.5227,5,11,5,670866,5578,119313,6943,0.04418007857052338,0.5545084258445812
5187,0.5228,10,7,10,670873,5571,119323,6933,0.044124635660879485,0.5544625719769674
5188,0.5229,5,5,5,670878,5566,119328,6928,0.04408503358256241,0.55450616295822
5189,0.523,9,5,9,670883,5561,119337,6919,0.04404543150424534,0.5544070512820513
5190,0.5231,2,4,2,670887,5557,119339,6917,0.04401374984159169,0.5545133878467212
5191,0.5232,4,7,4,670894,5550,119343,6913,0.043958306931947785,0.5546818583005697
5192,0.5233,5,10,5,670904,5540,119348,6908,0.04387910277531365,0.5549485861182519
5193,0.5234,5,2,5,670906,5538,119353,6903,0.04386326194398682,0.554858934169279
5194,0.5235,5,6,5,670912,5532,119358,6898,0.04381573945000634,0.5549477071600966
5195,0.5236,9,8,9,670920,5524,119367,6889,0.043752376124699024,0.5549826794489648
5196,0.5237,6,8,6,670928,5516,119373,6883,0.04368901279939171,0.5551254133397855
5197,0.5238,2,9,2,670937,5507,119375,6881,0.043617729058420984,0.5554568937681628
5198,0.5239,5,5,5,670942,5502,119380,6876,0.043578126980103916,0.5555016965584101
5199,0.524,10,5,10,670947,5497,119390,6866,0.04353852490178685,0.5553668203510475
5200,0.5241,4,3,4,670950,5494,119394,6862,0.043514763654796604,0.5553577209452898
5201,0.5242,3,6,3,670956,5488,119397,6859,0.04346724116081612,0.5555195594071435
5202,0.5243,12,11,12,670967,5477,119409,6847,0.043380116588518564,0.5555826030509575
5203,0.5244,11,9,11,670976,5468,119420,6836,0.043308832847547836,0.555591677503251
5204,0.5245,7,3,7,670979,5465,119427,6829,0.0432850716005576,0.555474215064259
5205,0.5246,6,6,6,670985,5459,119433,6823,0.043237549106577115,0.5555284155674971
5206,0.5247,2,8,2,670993,5451,119435,6821,0.0431741857812698,0.5558181225554107
5207,0.5248,11,6,11,670999,5445,119446,6810,0.04312666328728932,0.5556915544675642
5208,0.5249,8,6,8,671005,5439,119454,6802,0.04307914079330883,0.5556735560820194
5209,0.525,4,6,4,671011,5433,119458,6798,0.04303161829932835,0.5558008339465293
5210,0.5251,6,3,6,671014,5430,119464,6792,0.04300785705233811,0.5557191948944527
5211,0.5252,1,6,1,671020,5424,119465,6791,0.04296033455835762,0.555955792058944
5212,0.5253,5,3,5,671023,5421,119470,6786,0.04293657331136738,0.5559105431309904
5213,0.5254,4,5,4,671028,5416,119474,6782,0.04289697123305031,0.5559927857025742
5214,0.5255,12,7,12,671035,5409,119486,6770,0.04284152832340641,0.5558748665736103
5215,0.5256,2,7,2,671042,5402,119488,6768,0.04278608541376251,0.5561216105176664
5216,0.5257,9,3,9,671045,5399,119497,6759,0.042762324166772274,0.5559302516861326
5217,0.5258,6,8,6,671053,5391,119503,6753,0.04269896084146496,0.5560770750988142
5218,0.5259,4,2,4,671055,5389,119507,6749,0.04268312001013813,0.5560224089635855
5219,0.526,10,5,10,671060,5384,119517,6739,0.042643517931821064,0.5558855068877341
5220,0.5261,7,6,7,671066,5378,119524,6732,0.04259599543784058,0.5559042113955409
5221,0.5262,8,5,8,671071,5373,119532,6724,0.042556393359523506,0.555840290981235
5222,0.5263,7,6,7,671077,5367,119539,6717,0.04250887086554302,0.5558589870903674
5223,0.5264,6,7,6,671084,5360,119545,6711,0.042453427955899126,0.5559605666473366
5224,0.5265,12,4,12,671088,5356,119557,6699,0.04242174629324547,0.555703027789299
5225,0.5266,5,7,5,671095,5349,119562,6694,0.04236630338360157,0.5558415677156855
5226,0.5267,6,6,6,671101,5343,119568,6688,0.042318780889621085,0.5558972653977226
5227,0.5268,9,7,9,671108,5336,119577,6679,0.04226333797997719,0.5558884727424054
5228,0.5269,8,9,8,671117,5327,119585,6671,0.04219205423900646,0.5560093348891482
5229,0.527,4,6,4,671123,5321,119589,6667,0.04214453174502598,0.5561394728061395
5230,0.5271,3,3,3,671126,5318,119592,6664,0.04212077049803574,0.556167584710399
5231,0.5272,3,5,3,671131,5313,119595,6661,0.042081168419718665,0.5562886253549357
5232,0.5273,6,5,6,671136,5308,119601,6655,0.0420415663414016,0.5562985873108752
5233,0.5274,1,5,1,671141,5303,119602,6654,0.04200196426308453,0.5564941038722088
5234,0.5275,4,3,4,671144,5300,119606,6650,0.041978203016094284,0.5564853556485355
5235,0.5276,6,4,6,671148,5296,119612,6644,0.04194652135344063,0.5564489112227806
5236,0.5277,5,6,5,671154,5290,119617,6639,0.04189899885946014,0.5565428786989689
5237,0.5278,10,7,10,671161,5283,119627,6629,0.041843555949816244,0.556497649429147
5238,0.5279,8,5,8,671166,5278,119635,6621,0.041803953871499176,0.5564333137238423
5239,0.528,8,2,8,671168,5276,119643,6613,0.041788113040172346,0.5562284464631172
5240,0.5281,5,7,5,671175,5269,119648,6608,0.04173267013052845,0.5563694535657152
5241,0.5282,4,13,4,671188,5256,119652,6604,0.04162970472690407,0.5568296795952783
5242,0.5283,4,8,4,671196,5248,119656,6600,0.041566341401596756,0.5570560432140446
5243,0.5284,6,8,6,671204,5240,119662,6594,0.04150297807628944,0.5572080446172046
5244,0.5285,14,9,14,671213,5231,119676,6580,0.041431694335318715,0.5571077808822285
5245,0.5286,2,5,2,671218,5226,119678,6578,0.04139209225700165,0.5572687224669604
5246,0.5287,1,2,1,671220,5224,119679,6577,0.04137625142567482,0.5573256503686128
5247,0.5288,9,4,9,671224,5220,119688,6568,0.041344569763021165,0.5571767899558874
5248,0.5289,6,4,6,671228,5216,119694,6562,0.041312888100367505,0.5571404313126167
5249,0.529,1,7,1,671235,5209,119695,6561,0.04125744519072361,0.5574341546304163
5250,0.5291,3,6,3,671241,5203,119698,6558,0.041209922696743125,0.5576056457784202
5251,0.5292,8,3,8,671244,5200,119706,6550,0.04118616144975288,0.5574468085106383
5252,0.5293,4,5,4,671249,5195,119710,6546,0.04114655937143581,0.5575334298611703
5253,0.5294,5,4,5,671253,5191,119715,6541,0.04111487770878216,0.5575349471530856
5254,0.5295,11,9,11,671262,5182,119726,6530,0.04104359396781143,0.5575478142076503
5255,0.5296,6,6,6,671268,5176,119732,6524,0.04099607147383095,0.5576068376068376
5256,0.5297,4,5,4,671273,5171,119736,6520,0.040956469395513874,0.5576939526131212
5257,0.5298,7,3,7,671276,5168,119743,6513,0.040932708148523636,0.5575721256741717
5258,0.5299,6,5,6,671281,5163,119749,6507,0.04089310607020656,0.5575835475578406
5259,0.53,8,6,8,671287,5157,119757,6499,0.04084558357622608,0.557566918325326
5260,0.5301,10,5,10,671292,5152,119767,6489,0.04080598149790901,0.5574263379434756
5261,0.5302,5,8,5,671300,5144,119772,6484,0.0407426181726017,0.5576195390436877
5262,0.5303,9,4,9,671304,5140,119781,6475,0.040710936509948045,0.5574687903572966
5263,0.5304,6,5,6,671309,5135,119787,6469,0.04067133443163097,0.557480179248535
5264,0.5305,2,3,2,671312,5132,119789,6467,0.04064757318464073,0.557548064488318
5265,0.5306,7,7,7,671319,5125,119796,6460,0.040592130274996835,0.5576176089771256
5266,0.5307,9,6,9,671325,5119,119805,6451,0.040544607781016345,0.5575626620570441
5267,0.5308,7,6,7,671331,5113,119812,6444,0.04049708528703586,0.5575841481353292
5268,0.5309,6,4,6,671335,5109,119818,6438,0.04046540362438221,0.5575474149129644
5269,0.531,9,9,9,671344,5100,119827,6429,0.04039411988341148,0.5576372625552953
5270,0.5311,7,6,7,671350,5094,119834,6422,0.040346597389431,0.557658909343522
5271,0.5312,7,6,7,671356,5088,119841,6415,0.040299074895450517,0.5576806050595496
5272,0.5313,3,6,3,671362,5082,119844,6412,0.04025155240147003,0.5578562728380024
5273,0.5314,5,6,5,671368,5076,119849,6407,0.040204029907489544,0.5579552381781764
5274,0.5315,6,9,6,671377,5067,119855,6401,0.040132746166518816,0.5581618416463202
5275,0.5316,6,3,6,671380,5064,119861,6395,0.04010898491952858,0.5580766209965966
5276,0.5317,9,4,9,671384,5060,119870,6386,0.04007730325687492,0.5579241656473878
5277,0.5318,8,6,8,671390,5054,119878,6378,0.040029780762894436,0.5579076277116864
5278,0.5319,13,3,13,671393,5051,119891,6365,0.04000601951590419,0.5575508058864751
5279,0.532,3,8,3,671401,5043,119894,6362,0.039942656190596885,0.5578255151249452
5280,0.5321,7,3,7,671404,5040,119901,6355,0.03991889494360664,0.5577007459412023
5281,0.5322,6,5,6,671409,5035,119907,6349,0.03987929286528957,0.5577125790583275
5282,0.5323,8,8,8,671417,5027,119915,6341,0.03981592953998226,0.5577938071780436
5283,0.5324,6,6,6,671423,5021,119921,6335,0.03976840704600178,0.5578548784783375
5284,0.5325,4,6,4,671429,5015,119925,6331,0.03972088455202129,0.5579940066983959
5285,0.5326,11,7,11,671436,5008,119936,6320,0.03966544164237739,0.557909604519774
5286,0.5327,6,3,6,671439,5005,119942,6314,0.03964168039538715,0.5578231292517006
5287,0.5328,4,5,4,671444,5000,119946,6310,0.03960207831707008,0.5579133510167993
5288,0.5329,3,6,3,671450,4994,119949,6307,0.039554555823089595,0.5580922042297142
5289,0.533,5,3,5,671453,4991,119954,6302,0.03953079457609936,0.5580448065173116
5290,0.5331,9,11,9,671464,4980,119963,6293,0.0394436700038018,0.5582364942783642
5291,0.5332,5,1,5,671465,4979,119968,6288,0.039435749588138384,0.5580899973373569
5292,0.5333,10,3,10,671468,4976,119978,6278,0.039411988341148146,0.5578460991647414
5293,0.5334,5,2,5,671470,4974,119983,6273,0.039396147509821317,0.5577487329954655
5294,0.5335,11,8,11,671478,4966,119994,6262,0.039332784184514004,0.5577128607053794
5295,0.5336,6,4,6,671482,4962,120000,6256,0.039301102521860344,0.5576751649135319
5296,0.5337,8,8,8,671490,4954,120008,6248,0.03923773919655304,0.55775754329584
5297,0.5338,4,9,4,671499,4945,120012,6244,0.03916645545558231,0.5580480829386004
5298,0.5339,6,9,6,671508,4936,120018,6238,0.03909517171461158,0.5582602470019689
5299,0.534,3,8,3,671516,4928,120021,6235,0.03903180838930427,0.5585416106781331
5300,0.5341,6,5,6,671521,4923,120027,6229,0.0389922063109872,0.5585545193687231
5301,0.5342,6,9,6,671530,4914,120033,6223,0.038920922570016475,0.5587680703959774
5302,0.5343,8,7,8,671537,4907,120041,6215,0.03886547966037258,0.5588023736737997
5303,0.5344,6,6,6,671543,4901,120047,6209,0.038817957166392095,0.5588658865886589
5304,0.5345,6,6,6,671549,4895,120053,6203,0.038770434672411605,0.5589295368534871
5305,0.5346,6,9,6,671558,4886,120059,6197,0.038699150931440884,0.5591446359289001
5306,0.5347,7,5,7,671563,4881,120066,6190,0.03865954885312381,0.5591184174871285
5307,0.5348,1,3,1,671566,4878,120067,6189,0.03863578760613357,0.5592301436703714
5308,0.5349,1,6,1,671572,4872,120068,6188,0.03858826511215309,0.5594936708860759
5309,0.535,4,6,4,671578,4866,120072,6184,0.0385407426181726,0.5596380090497738
5310,0.5351,6,9,6,671587,4857,120078,6178,0.03846945887720188,0.5598550067965564
5311,0.5352,9,4,9,671591,4853,120087,6169,0.03843777721454822,0.5596987842496824
5312,0.5353,4,4,4,671595,4849,120091,6165,0.038406095551894566,0.5597421463591792
5313,0.5354,7,8,7,671603,4841,120098,6158,0.03834273222658725,0.5598690790071825
5314,0.5355,7,3,7,671606,4838,120105,6151,0.03831897097959701,0.5597415597415597
5315,0.5356,10,4,10,671610,4834,120115,6141,0.038287289316943356,0.5595444191343963
5316,0.5357,7,4,7,671614,4830,120122,6134,0.038255607654289696,0.5594673476833273
5317,0.5358,4,7,4,671621,4823,120126,6130,0.0382001647446458,0.559664018990231
5318,0.5359,2,1,2,671622,4822,120128,6128,0.03819224432898238,0.559634703196347
5319,0.536,7,4,7,671626,4818,120135,6121,0.03816056266632873,0.5595575463936374
5320,0.5361,5,7,5,671633,4811,120140,6116,0.03810511975668483,0.5597144687471401
5321,0.5362,9,10,9,671643,4801,120149,6107,0.03802591560005069,0.5598643197653098
5322,0.5363,7,4,7,671647,4797,120156,6100,0.03799423393739704,0.5597870973662475
5323,0.5364,11,5,11,671652,4792,120167,6089,0.03795463185907996,0.5595993015347854
5324,0.5365,5,8,5,671660,4784,120172,6084,0.03789126853377265,0.5598086124401914
5325,0.5366,7,3,7,671663,4781,120179,6077,0.03786750728678241,0.559679498986922
5326,0.5367,4,6,4,671669,4775,120183,6073,0.03781998479280193,0.5598266961651918
5327,0.5368,5,6,5,671675,4769,120188,6068,0.03777246229882144,0.559933560948602
5328,0.5369,5,8,5,671683,4761,120193,6063,0.03770909897351413,0.5601441241685144
5329,0.537,7,6,7,671689,4755,120200,6056,0.037661576479533644,0.5601701970215521
5330,0.5371,6,7,6,671696,4748,120206,6050,0.037606133569889746,0.5602889423967401
5331,0.5372,4,6,4,671702,4742,120210,6046,0.037558611075909264,0.560437523173897
5332,0.5373,3,5,3,671707,4737,120213,6043,0.037519008997592196,0.5605751391465678
5333,0.5374,8,6,8,671713,4731,120221,6035,0.037471486503611706,0.5605610254504922
5334,0.5375,4,8,4,671721,4723,120225,6031,0.0374081231783044,0.5608145806211642
5335,0.5376,4,7,4,671728,4716,120229,6027,0.037352680268660496,0.5610164758447361
5336,0.5377,4,4,4,671732,4712,120233,6023,0.03732099860600684,0.5610619469026549
5337,0.5378,8,5,8,671737,4707,120241,6015,0.037281396527689775,0.5609960828203693
5338,0.5379,8,4,8,671741,4703,120249,6007,0.037249714865036115,0.5608776844070962
5339,0.538,3,4,3,671745,4699,120252,6004,0.03721803320238246,0.5609642156404746
5340,0.5381,10,4,10,671749,4695,120262,5994,0.0371863515397288,0.5607634016278417
5341,0.5382,7,10,7,671759,4685,120269,5987,0.03710714738309467,0.5610007496251874
5342,0.5383,2,5,2,671764,4680,120271,5985,0.03706754530477759,0.5611814345991561
5343,0.5384,3,12,3,671776,4668,120274,5982,0.03697250031681663,0.5616901408450704
5344,0.5385,6,8,6,671784,4660,120280,5976,0.036909136991509314,0.5618653629183904
5345,0.5386,5,7,5,671791,4653,120285,5971,0.03685369408186542,0.5620293674698795
5346,0.5387,3,6,3,671797,4647,120288,5968,0.036806171587884934,0.5622232689590203
5347,0.5388,3,5,3,671802,4642,120291,5965,0.03676656950956786,0.5623644762892429
5348,0.5389,2,7,2,671809,4635,120293,5963,0.03671112659992396,0.5626533308171353
5349,0.539,10,6,10,671815,4629,120303,5953,0.03666360410594348,0.5625590625590625
5350,0.5391,11,5,11,671820,4624,120314,5942,0.03662400202762641,0.5623698656066629
5351,0.5392,6,10,6,671830,4614,120320,5936,0.03654479787099227,0.562654028436019
5352,0.5393,7,6,7,671836,4608,120327,5929,0.036497275377011786,0.562683875865996
5353,0.5394,3,5,3,671841,4603,120330,5926,0.03645767329869472,0.5628264792477918
5354,0.5395,4,9,4,671850,4594,120334,5922,0.03638638955772399,0.5631418790414606
5355,0.5396,6,4,6,671854,4590,120340,5916,0.03635470789507033,0.5631067961165048
5356,0.5397,1,3,1,671857,4587,120341,5915,0.03633094664808009,0.563226052180537
5357,0.5398,6,2,6,671859,4585,120347,5909,0.03631510581675326,0.5630836668572518
5358,0.5399,9,3,9,671862,4582,120356,5900,0.03629134456976302,0.5628696813585193
5359,0.54,9,7,9,671869,4575,120365,5891,0.03623590166011912,0.5628702465125167
5360,0.5401,5,3,5,671872,4572,120370,5886,0.03621214041312888,0.5628227194492255
5361,0.5402,3,6,3,671878,4566,120373,5883,0.0361646179191484,0.5630203847258111
5362,0.5403,5,3,5,671881,4563,120378,5878,0.036140856672158155,0.5629728953165406
5363,0.5404,2,8,2,671889,4555,120380,5876,0.03607749334685084,0.5633208704822165
5364,0.5405,9,4,9,671893,4551,120389,5867,0.03604581168419719,0.563159915530812
5365,0.5406,2,8,2,671901,4543,120391,5865,0.035982448358889876,0.5635088393543428
5366,0.5407,1,6,1,671907,4537,120392,5864,0.035934925864909394,0.5637919430823959
5367,0.5408,3,14,3,671921,4523,120395,5861,0.03582404004562159,0.5644260400616333
5368,0.5409,4,3,4,671924,4520,120399,5857,0.03580027879863135,0.5644213163727474
5369,0.541,6,6,6,671930,4514,120405,5851,0.03575275630465087,0.5644958996623252
5370,0.5411,4,5,4,671935,4509,120409,5847,0.035713154226333796,0.5646002317497103
5371,0.5412,6,3,6,671938,4506,120415,5841,0.03568939297934356,0.564511452594955
5372,0.5413,6,9,6,671947,4497,120421,5835,0.03561810923837283,0.5647502903600464
5373,0.5414,6,5,6,671952,4492,120427,5829,0.03557850716005576,0.5647708555372541
5374,0.5415,7,10,7,671962,4482,120434,5822,0.03549930300342162,0.5650232919254659
5375,0.5416,7,9,7,671971,4473,120441,5815,0.03542801926245089,0.5652216174183515
5376,0.5417,7,5,7,671976,4468,120448,5808,0.035388417184133825,0.565200467107824
5377,0.5418,7,5,7,671981,4463,120455,5801,0.03534881510581675,0.5651792673421668
5378,0.5419,8,8,8,671989,4455,120463,5793,0.035285451780509444,0.5652810304449649
5379,0.542,3,8,3,671997,4447,120466,5790,0.03522208845520213,0.5655953892742014
5380,0.5421,5,10,5,672007,4437,120471,5785,0.03514288429856799,0.5659362160046958
5381,0.5422,9,7,9,672014,4430,120480,5776,0.03508744138892409,0.56594160297864
5382,0.5423,6,5,6,672019,4425,120486,5770,0.035047839310607024,0.5659637076998528
5383,0.5424,3,2,3,672021,4423,120489,5767,0.035031998479280194,0.5659470068694799
5384,0.5425,6,3,6,672024,4420,120495,5761,0.03500823723228995,0.5658579707297908
5385,0.5426,5,12,5,672036,4408,120500,5756,0.03491319224432898,0.5663124754033845
5386,0.5427,6,9,6,672045,4399,120506,5750,0.034841908503358256,0.5665582816040989
5387,0.5428,6,10,6,672055,4389,120512,5744,0.03476270434672411,0.566860751998421
5388,0.5429,2,8,2,672063,4381,120514,5742,0.0346993410214168,0.5672231551911489
5389,0.543,6,5,6,672068,4376,120520,5736,0.03465973894309973,0.567246835443038
5390,0.5431,8,8,8,672076,4368,120528,5728,0.03459637561779242,0.5673534072900158
5391,0.5432,3,10,3,672086,4358,120531,5725,0.034517171461158284,0.567787364871566
5392,0.5433,6,2,6,672088,4356,120537,5719,0.034501330629831455,0.5676426799007445
5393,0.5434,8,8,8,672096,4348,120545,5711,0.03443796730452414,0.5677502733870166
5394,0.5435,4,4,4,672100,4344,120549,5707,0.03440628564187048,0.5678041985872052
5395,0.5436,4,5,4,672105,4339,120553,5703,0.034366683563553414,0.5679147580163314
5396,0.5437,3,2,3,672107,4337,120556,5700,0.034350842732226584,0.5678987745342233
5397,0.5438,7,2,7,672109,4335,120563,5693,0.03433500190089976,0.567710410849621
5398,0.5439,3,5,3,672114,4330,120566,5690,0.03429539982258269,0.5678642714570858
5399,0.544,5,8,5,672122,4322,120571,5685,0.034232036497275374,0.5681023283701409
5400,0.5441,6,7,6,672129,4315,120577,5679,0.034176593587631476,0.56824094456674
5401,0.5442,10,6,10,672135,4309,120587,5669,0.034129071093650994,0.5681499298456605
5402,0.5443,2,4,2,672139,4305,120589,5667,0.03409738943099734,0.5682912154031288
5403,0.5444,5,7,5,672146,4298,120594,5662,0.03404194652135344,0.5684738955823293
5404,0.5445,8,7,8,672153,4291,120602,5654,0.033986503611709545,0.5685268979386626
5405,0.5446,5,3,5,672156,4288,120607,5649,0.0339627423647193,0.5684814330280769
5406,0.5447,3,9,3,672165,4279,120610,5646,0.03389145862374857,0.5688664987405542
5407,0.5448,6,4,6,672169,4275,120616,5640,0.03385977696109492,0.5688350983358548
5408,0.5449,5,4,5,672173,4271,120621,5635,0.03382809529844126,0.5688471633353523
5409,0.545,3,5,3,672178,4266,120624,5632,0.03378849322012419,0.5690038391594261
5410,0.5451,5,5,5,672183,4261,120629,5627,0.033748891141807125,0.5690736245954693
5411,0.5452,6,7,6,672190,4254,120635,5621,0.03369344823216323,0.5692151898734177
5412,0.5453,5,5,5,672195,4249,120640,5616,0.03365384615384615,0.5692853522554485
5413,0.5454,2,4,2,672199,4245,120642,5614,0.0336221644911925,0.5694289481691855
5414,0.5455,4,2,4,672201,4243,120646,5610,0.03360632365986567,0.569369735106059
5415,0.5456,5,10,5,672211,4233,120651,5605,0.03352711950323153,0.5697296198414312
5416,0.5457,10,4,10,672215,4229,120661,5595,0.033495437840577874,0.5695236156351792
5417,0.5458,3,5,3,672220,4224,120664,5592,0.033455835762260806,0.5696821515892421
5418,0.5459,4,8,4,672228,4216,120668,5588,0.033392472436953494,0.5699714402284781
5419,0.546,5,3,5,672231,4213,120673,5583,0.03336871118996325,0.569926500612495
5420,0.5461,4,8,4,672239,4205,120677,5579,0.033305347864655936,0.5702166802943581
5421,0.5462,7,7,7,672246,4198,120684,5572,0.03324990495501204,0.570317297850563
5422,0.5463,6,6,6,672252,4192,120690,5566,0.033202382461031556,0.5704037712646034
5423,0.5464,8,3,8,672255,4189,120698,5558,0.03317862121404131,0.5702267364317226
5424,0.5465,6,6,6,672261,4183,120704,5552,0.03313109872006083,0.5703133025166923
5425,0.5466,7,14,7,672275,4169,120711,5545,0.03302021290077303,0.5708256125180152
5426,0.5467,9,9,9,672284,4160,120720,5536,0.032948929159802305,0.570957095709571
5427,0.5468,2,8,2,672292,4152,120722,5534,0.03288556583449499,0.5713400784637621
5428,0.5469,3,7,3,672299,4145,120725,5531,0.032830122924851095,0.5716205043406366
5429,0.547,5,4,5,672303,4141,120730,5526,0.03279844126219744,0.5716354608461777
5430,0.5471,8,3,8,672306,4138,120738,5518,0.0327746800152072,0.5714581607290804
5431,0.5472,3,3,3,672309,4135,120741,5515,0.03275091876821696,0.5715025906735751
5432,0.5473,5,8,5,672317,4127,120746,5510,0.03268755544290965,0.5717546954446404
5433,0.5474,4,7,4,672324,4120,120750,5506,0.03263211253326575,0.5719925202576356
5434,0.5475,7,6,7,672330,4114,120757,5499,0.03258459003928526,0.5720378653906169
5435,0.5476,5,4,5,672334,4110,120762,5494,0.032552908376631606,0.5720533111203665
5436,0.5477,9,4,9,672338,4106,120771,5485,0.032521226713977947,0.5718903138358878
5437,0.5478,8,8,8,672346,4098,120779,5477,0.03245786338867064,0.5720104438642297
5438,0.5479,4,3,4,672349,4095,120783,5473,0.032434102141680396,0.5720108695652174
5439,0.548,10,5,10,672354,4090,120793,5463,0.03239450006336333,0.5718622422275725
5440,0.5481,6,3,6,672357,4087,120799,5457,0.03237073881637308,0.5717728415758592
5441,0.5482,3,4,3,672361,4083,120802,5454,0.03233905715371943,0.5718779490405788
5442,0.5483,10,7,10,672368,4076,120812,5444,0.032283614244075526,0.5718487394957983
5443,0.5484,5,3,5,672371,4073,120817,5439,0.03225985299708529,0.5718040370058873
5444,0.5485,4,4,4,672375,4069,120821,5435,0.03222817133443163,0.5718644781144782
5445,0.5486,2,8,2,672383,4061,120823,5433,0.032164808009124315,0.5722561617863914
5446,0.5487,5,4,5,672387,4057,120828,5428,0.03213312634647066,0.5722720084343701
5447,0.5488,5,5,5,672392,4052,120833,5423,0.032093524268153595,0.5723482849604221
5448,0.5489,10,4,10,672396,4048,120843,5413,0.032061842605499935,0.572138251770426
5449,0.549,9,3,9,672399,4045,120852,5404,0.0320380813585097,0.5719123716795428
5450,0.5491,7,6,7,672405,4039,120859,5397,0.03199055886452921,0.5719584569732937
5451,0.5492,7,6,7,672411,4033,120866,5390,0.031943036370548725,0.5720046694258729
5452,0.5493,3,4,3,672415,4029,120869,5387,0.03191135470789507,0.5721112999150383
5453,0.5494,3,7,3,672422,4022,120872,5384,0.031855911798251174,0.5724005953646608
5454,0.5495,8,4,8,672426,4018,120880,5376,0.031824230135597514,0.5722801788375559
5455,0.5496,7,4,7,672430,4014,120887,5369,0.03179254847294386,0.5722050516892252
5456,0.5497,1,5,1,672435,4009,120888,5368,0.03175294639462679,0.5724645408979417
5457,0.5498,6,5,6,672440,4004,120894,5362,0.03171334431630972,0.5724962630792227
5458,0.5499,2,8,2,672448,3996,120896,5360,0.031649980991002406,0.572894399315947
5459,0.55,6,3,6,672451,3993,120902,5354,0.03162621974401217,0.5728041082700331
5460,0.5501,4,4,4,672455,3989,120906,5350,0.03159453808135851,0.5728664739265446
5461,0.5502,6,6,6,672461,3983,120912,5344,0.031547015587378026,0.57296022300847
5462,0.5503,2,3,2,672464,3980,120914,5342,0.03152325434038778,0.5730529929199742
5463,0.5504,7,9,7,672473,3971,120921,5335,0.03145197059941706,0.5732860520094563
5464,0.5505,6,9,6,672482,3962,120927,5329,0.03138068685844633,0.5735658163814444
5465,0.5506,2,7,2,672489,3955,120929,5327,0.031325243948802435,0.5739064856711915
5466,0.5507,5,5,5,672494,3950,120934,5322,0.03128564187048536,0.5739861949956859
5467,0.5508,5,9,5,672503,3941,120939,5317,0.031214358129514636,0.5743141067185137
5468,0.5509,4,3,4,672506,3938,120943,5313,0.031190596882524395,0.5743162901307967
5469,0.551,5,5,5,672511,3933,120948,5308,0.031150994804207324,0.5743967103127368
5470,0.5511,3,5,3,672516,3928,120951,5305,0.031111392725890256,0.5745694790425647
5471,0.5512,6,3,6,672519,3925,120957,5299,0.031087631478900014,0.574479618386817
5472,0.5513,4,6,4,672525,3919,120961,5295,0.031040108984919528,0.5746689819839375
5473,0.5514,6,4,6,672529,3915,120967,5289,0.031008427322265872,0.5746414602346805
5474,0.5515,6,7,6,672536,3908,120973,5283,0.030952984412621974,0.5748014361875748
5475,0.5516,7,7,7,672543,3901,120980,5276,0.030897541502978076,0.574915549743925
5476,0.5517,8,5,8,672548,3896,120988,5268,0.030857939424661005,0.5748581405499782
5477,0.5518,9,5,9,672553,3891,120997,5259,0.030818337346343937,0.5747540983606557
5478,0.5519,5,4,5,672557,3887,121002,5254,0.03078665568369028,0.5747730007657805
5479,0.552,9,7,9,672564,3880,121011,5245,0.030731212774046383,0.5747945205479452
5480,0.5521,10,4,10,672568,3876,121021,5235,0.030699531111392727,0.5745801778070464
5481,0.5522,11,6,11,672574,3870,121032,5224,0.03065200861741224,0.574444688805806
5482,0.5523,5,3,5,672577,3867,121037,5219,0.030628247370422,0.5744001760950913
5483,0.5524,5,7,5,672584,3860,121042,5214,0.030572804460778102,0.5746087723165088
5484,0.5525,8,5,8,672589,3855,121050,5206,0.03053320238246103,0.5745502703895817
5485,0.5526,6,6,6,672595,3849,121056,5200,0.030485679888480548,0.5746491325008288
5486,0.5527,3,5,3,672600,3844,121059,5197,0.030446077810163476,0.5748257936069019
5487,0.5528,7,4,7,672604,3840,121066,5190,0.03041439614750982,0.574750830564784
5488,0.5529,4,2,4,672606,3838,121070,5186,0.030398555316182994,0.5746897163120568
5489,0.553,7,5,7,672611,3833,121077,5179,0.030358953237865922,0.5746782068353307
5490,0.5531,5,4,5,672615,3829,121082,5174,0.030327271575212266,0.5746973231145174
5491,0.5532,4,1,4,672616,3828,121086,5170,0.030319351159548855,0.5745721271393643
5492,0.5533,7,5,7,672621,3823,121093,5163,0.030279749081231783,0.5745604273314044
5493,0.5534,9,5,9,672626,3818,121102,5154,0.030240147002914712,0.5744538564422649
5494,0.5535,4,7,4,672633,3811,121106,5150,0.030184704093270814,0.5747126436781609
5495,0.5536,3,4,3,672637,3807,121109,5147,0.030153022430617158,0.5748268930087111
5496,0.5537,3,7,3,672644,3800,121112,5144,0.03009757952097326,0.575134168157424
5497,0.5538,5,4,5,672648,3796,121117,5139,0.030065897858319604,0.5751538891997762
5498,0.5539,4,3,4,672651,3793,121121,5135,0.030042136611329363,0.5751568100358423
5499,0.554,3,8,3,672659,3785,121124,5132,0.02997877328602205,0.5755298867332063
5500,0.5541,4,15,4,672674,3770,121128,5128,0.02985996705107084,0.5763092829849404
5501,0.5542,5,6,5,672680,3764,121133,5123,0.029812444557090357,0.5764599977495217
5502,0.5543,6,7,6,672687,3757,121139,5117,0.02975700164744646,0.5766283524904214
5503,0.5544,2,7,2,672694,3750,121141,5115,0.02970155873780256,0.5769881556683587
5504,0.5545,6,5,6,672699,3745,121147,5109,0.02966195665948549,0.5770273322791959
5505,0.5546,5,8,5,672707,3737,121152,5104,0.029598593334178178,0.5773102590204728
5506,0.5547,5,4,5,672711,3733,121157,5099,0.02956691167152452,0.5773324275362319
5507,0.5548,5,8,5,672719,3725,121162,5094,0.02950354834621721,0.5776165098083683
5508,0.5549,4,5,4,672724,3720,121166,5090,0.02946394626790014,0.5777525539160046
5509,0.555,5,3,5,672727,3717,121171,5085,0.029440185020909896,0.5777096114519428
5510,0.5551,4,2,4,672729,3715,121175,5081,0.02942434418958307,0.5776489313324238
5511,0.5552,3,5,3,672734,3710,121178,5078,0.029384742111266,0.5778334091943559
5512,0.5553,4,6,4,672740,3704,121182,5074,0.029337219617285516,0.5780359990886307
5513,0.5554,6,2,6,672742,3702,121188,5068,0.029321378785958686,0.57787913340935
5514,0.5555,5,3,5,672745,3699,121193,5063,0.029297617538968444,0.5778361104770601
5515,0.5556,4,3,4,672748,3696,121197,5059,0.029273856291978203,0.577841233580811
5516,0.5557,6,2,6,672750,3694,121203,5053,0.029258015460651376,0.5776837772950726
5517,0.5558,7,11,7,672761,3683,121210,5046,0.029170890888353822,0.5780730897009967
5518,0.5559,7,5,7,672766,3678,121217,5039,0.02913128881003675,0.5780658483423196
5519,0.556,3,5,3,672771,3673,121220,5036,0.02909168673171968,0.5782523825927202
5520,0.5561,6,9,6,672780,3664,121226,5030,0.029020402990748956,0.5785599263860134
5521,0.5562,5,6,5,672786,3658,121231,5025,0.02897288049676847,0.5787170332834274
5522,0.5563,0,2,0,672788,3656,121231,5025,0.028957039665441643,0.5788503628614214
5523,0.5564,5,6,5,672794,3650,121236,5020,0.028909517171461157,0.5790080738177624
5524,0.5565,4,5,4,672799,3645,121240,5016,0.02886991509314409,0.5791479043990302
5525,0.5566,6,4,6,672803,3641,121246,5010,0.028838233430490433,0.5791238007166801
5526,0.5567,7,7,7,672810,3634,121253,5003,0.028782790520846535,0.5792520551117286
5527,0.5568,6,10,6,672820,3624,121259,4997,0.028703586364212393,0.5796311332792019
5528,0.5569,5,2,5,672822,3622,121264,4992,0.028687745532885566,0.5795217088460646
5529,0.557,2,9,2,672831,3613,121266,4990,0.02861646179191484,0.580030222015576
5530,0.5571,2,5,2,672836,3608,121268,4988,0.02857685971359777,0.5802698929734761
5531,0.5572,3,6,3,672842,3602,121271,4985,0.028529337219617285,0.5805287061837662
5532,0.5573,8,3,8,672845,3599,121279,4977,0.028505575972627043,0.5803404850746269
5533,0.5574,2,3,2,672848,3596,121281,4975,0.028481814725636802,0.5804456889511143
5534,0.5575,9,2,9,672850,3594,121290,4966,0.028465973894309972,0.5801401869158879
5535,0.5576,4,5,4,672855,3589,121294,4962,0.028426371815992904,0.5802830078353409
5536,0.5577,3,4,3,672859,3585,121297,4959,0.028394690153339248,0.5804073033707865
5537,0.5578,4,3,4,672862,3582,121301,4955,0.028370928906349006,0.5804146655733864
5538,0.5579,4,9,4,672871,3573,121305,4951,0.02829964516537828,0.580830595964336
5539,0.558,5,5,5,672876,3568,121310,4946,0.028260043087061208,0.5809255344139065
5540,0.5581,3,2,3,672878,3566,121313,4943,0.02824420225573438,0.5809143260077565
5541,0.5582,7,2,7,672880,3564,121320,4936,0.02822836142440755,0.5807058823529412
5542,0.5583,1,4,1,672884,3560,121321,4935,0.0281966797617539,0.5809299587992937
5543,0.5584,6,5,6,672889,3555,121327,4929,0.028157077683436827,0.580975954738331
5544,0.5585,4,4,4,672893,3551,121331,4925,0.02812539602078317,0.5810523831996225
5545,0.5586,6,5,6,672898,3546,121337,4919,0.0280857939424661,0.5810986414648552
5546,0.5587,6,2,6,672900,3544,121343,4913,0.028069953111139273,0.5809388672105947
5547,0.5588,6,6,6,672906,3538,121349,4907,0.028022430617158787,0.5810538780343398
5548,0.5589,3,7,3,672913,3531,121352,4904,0.02796698770751489,0.5813870776526379
5549,0.559,0,5,0,672918,3526,121352,4904,0.02792738562919782,0.5817319098457888
5550,0.5591,10,5,10,672923,3521,121362,4894,0.02788778355088075,0.5815805109922757
5551,0.5592,9,2,9,672925,3519,121371,4885,0.027871942719553924,0.5812708234174203
5552,0.5593,1,1,1,672926,3518,121372,4884,0.02786402230389051,0.5812901690073792
5553,0.5594,5,2,5,672928,3516,121377,4879,0.02784818147256368,0.5811792733770101
5554,0.5595,5,6,5,672934,3510,121382,4874,0.027800658978583196,0.5813454198473282
5555,0.5596,8,3,8,672937,3507,121390,4866,0.027776897731592955,0.5811537083482623
5556,0.5597,8,8,8,672945,3499,121398,4858,0.027713534406285642,0.5813090822065334
5557,0.5598,5,5,5,672950,3494,121403,4853,0.02767393232796857,0.5814064933509046
5558,0.5599,5,2,5,672952,3492,121408,4848,0.027658091496641744,0.581294964028777
5559,0.56,6,2,6,672954,3490,121414,4842,0.027642250665314914,0.5811329812770043
5560,0.5601,4,5,4,672959,3485,121418,4838,0.027602648586997847,0.5812807881773399
5561,0.5602,2,5,2,672964,3480,121420,4836,0.027563046508680775,0.5815295815295816
5562,0.5603,4,4,4,672968,3476,121424,4832,0.02753136484602712,0.5816080885893115
5563,0.5604,3,7,3,672975,3469,121427,4829,0.02747592193638322,0.5819474572186069
5564,0.5605,8,6,8,672981,3463,121435,4821,0.02742839944240274,0.5819652341863834
5565,0.5606,4,5,4,672986,3458,121439,4817,0.027388797364085667,0.5821148036253776
5566,0.5607,1,3,1,672989,3455,121440,4816,0.027365036117095426,0.5822754201426672
5567,0.5608,3,8,3,672997,3447,121443,4813,0.027301672791788113,0.5826876513317192
5568,0.5609,7,4,7,673001,3443,121450,4806,0.027269991129134457,0.5826160746757183
5569,0.561,6,5,6,673006,3438,121456,4800,0.027230389050817386,0.5826656955571741
5570,0.5611,2,7,2,673013,3431,121458,4798,0.027174946141173488,0.583059910074128
5571,0.5612,7,5,7,673018,3426,121465,4791,0.02713534406285642,0.5830595107703541
5572,0.5613,3,4,3,673022,3422,121468,4788,0.027103662400202764,0.5831912302070645
5573,0.5614,6,4,6,673026,3418,121474,4782,0.027071980737549108,0.583170731707317
5574,0.5615,5,5,5,673031,3413,121479,4777,0.027032378659232036,0.5832722832722833
5575,0.5616,9,2,9,673033,3411,121488,4768,0.02701653782790521,0.5829563516322289
5576,0.5617,7,2,7,673035,3409,121495,4761,0.02700069699657838,0.5827417380660954
5577,0.5618,3,4,3,673039,3405,121498,4758,0.026969015333924724,0.5828739434031606
5578,0.5619,7,3,7,673042,3402,121505,4751,0.026945254086934482,0.5827302833312891
5579,0.562,3,3,3,673045,3399,121508,4748,0.02692149283994424,0.5827912114888916
5580,0.5621,5,2,5,673047,3397,121513,4743,0.02690565200861741,0.5826781326781327
5581,0.5622,1,6,1,673053,3391,121514,4742,0.026858129514636928,0.5830566826509284
5582,0.5623,8,4,8,673057,3387,121522,4734,0.026826447851983272,0.5829331363132619
5583,0.5624,0,10,0,673067,3377,121522,4734,0.026747243695349133,0.5836518308469979
5584,0.5625,6,5,6,673072,3372,121528,4728,0.02670764161703206,0.5837037037037037
5585,0.5626,7,4,7,673076,3368,121535,4721,0.026675959954378405,0.5836320929657559
5586,0.5627,5,0,5,673076,3368,121540,4716,0.026675959954378405,0.5833745670460169
5587,0.5628,6,3,6,673079,3365,121546,4710,0.026652198707388164,0.58328173374613
5588,0.5629,5,1,5,673080,3364,121551,4705,0.02664427829172475,0.5830957987359029
5589,0.563,2,3,2,673083,3361,121553,4703,0.026620517044734508,0.5832093253968254
5590,0.5631,3,5,3,673088,3356,121556,4700,0.026580914966417436,0.583416087388282
5591,0.5632,5,2,5,673090,3354,121561,4695,0.02656507413509061,0.583302273574357
5592,0.5633,8,5,8,673095,3349,121569,4687,0.02652547205677354,0.5832503733200597
5593,0.5634,9,3,9,673098,3346,121578,4678,0.026501710809783297,0.5830009970089731
5594,0.5635,3,5,3,673103,3341,121581,4675,0.026462108731466226,0.5832085828343313
5595,0.5636,6,5,6,673108,3336,121587,4669,0.026422506653149158,0.583260462211118
5596,0.5637,7,8,7,673116,3328,121594,4662,0.026359143327841845,0.5834793491864831
5597,0.5638,4,7,4,673123,3321,121598,4658,0.026303700418197948,0.583782428875799
5598,0.5639,3,6,3,673129,3315,121601,4655,0.02625617792421746,0.5840652446675031
5599,0.564,6,4,6,673133,3311,121607,4649,0.026224496261563805,0.5840452261306532
5600,0.5641,3,4,3,673137,3307,121610,4646,0.026192814598910152,0.5841820696592481
5601,0.5642,6,3,6,673140,3304,121616,4640,0.026169053351919908,0.5840886203423967
5602,0.5643,1,4,1,673144,3300,121617,4639,0.02613737168926625,0.584330520216652
5603,0.5644,7,6,7,673150,3294,121624,4632,0.02608984919528577,0.5844057532172596
5604,0.5645,4,4,4,673154,3290,121628,4628,0.026058167532632112,0.584491033089164
5605,0.5646,4,3,4,673157,3287,121632,4624,0.02603440628564187,0.5845025913285299
5606,0.5647,4,7,4,673164,3280,121636,4620,0.025978963375997973,0.5848101265822785
5607,0.5648,3,1,3,673165,3279,121639,4617,0.025971042960334558,0.584726443768997
5608,0.5649,6,8,6,673173,3271,121645,4611,0.025907679635027245,0.5850038061405735
5609,0.565,4,4,4,673177,3267,121649,4607,0.02587599797237359,0.5850901701803404
5610,0.5651,6,3,6,673180,3264,121655,4601,0.025852236725383348,0.5849968213604577
5611,0.5652,7,7,7,673187,3257,121662,4594,0.02579679381573945,0.5851483887402879
5612,0.5653,4,3,4,673190,3254,121666,4590,0.02577303256874921,0.5851606323304437
5613,0.5654,4,1,4,673191,3253,121670,4586,0.025765112153085794,0.5850235999489731
5614,0.5655,8,2,8,673193,3251,121678,4578,0.025749271321758967,0.5847490100906885
5615,0.5656,5,1,5,673194,3250,121683,4573,0.025741350906095552,0.5845583535727982
5616,0.5657,2,2,2,673196,3248,121685,4571,0.025725510074768723,0.5846016114592659
5617,0.5658,7,9,7,673205,3239,121692,4564,0.025654226333798,0.5849032423426888
5618,0.5659,7,8,7,673213,3231,121699,4557,0.025590863008490686,0.5851309707241911
5619,0.566,6,5,6,673218,3226,121705,4551,0.025551260930173614,0.5851870901375852
5620,0.5661,7,4,7,673222,3222,121712,4544,0.025519579267519958,0.5851146021117692
5621,0.5662,6,5,6,673227,3217,121718,4538,0.02547997718920289,0.5851708575112831
5622,0.5663,5,3,5,673230,3214,121723,4533,0.02545621594221265,0.5851297276365045
5623,0.5664,8,7,8,673237,3207,121731,4525,0.025400773032568748,0.5852302121055354
5624,0.5665,3,1,3,673238,3206,121734,4522,0.025392852616905336,0.5851449275362319
5625,0.5666,7,3,7,673241,3203,121741,4515,0.02536909136991509,0.584996112982638
5626,0.5667,4,2,4,673243,3201,121745,4511,0.025353250538588265,0.5849325726141079
5627,0.5668,1,3,1,673246,3198,121746,4510,0.025329489291598024,0.5851063829787234
5628,0.5669,6,3,6,673249,3195,121752,4504,0.025305728044607782,0.5850110403948565
5629,0.567,5,2,5,673251,3193,121757,4499,0.025289887213280952,0.5848933957358294
5630,0.5671,4,4,4,673255,3189,121761,4495,0.025258205550627296,0.5849817803227486
5631,0.5672,4,3,4,673258,3186,121765,4491,0.025234444303637055,0.5849941383352872
5632,0.5673,6,2,6,673260,3184,121771,4485,0.02521860347231023,0.5848220106923979
5633,0.5674,5,7,5,673267,3177,121776,4480,0.025163160562666327,0.5850855426407209
5634,0.5675,4,0,4,673267,3177,121780,4476,0.025163160562666327,0.5848686789494316
5635,0.5676,2,2,2,673269,3175,121782,4474,0.0251473197313395,0.5849130605307883
5636,0.5677,7,5,7,673274,3170,121789,4467,0.02510771765302243,0.5849155427523897
5637,0.5678,5,4,5,673278,3166,121794,4462,0.025076035990368773,0.5849501835343471
5638,0.5679,6,5,6,673283,3161,121800,4456,0.025036433912051705,0.5850072206905605
5639,0.568,6,3,6,673286,3158,121806,4450,0.025012672665061464,0.5849106203995794
5640,0.5681,7,2,7,673288,3156,121813,4443,0.024996831833734634,0.5846821950256613
5641,0.5682,3,7,3,673295,3149,121816,4440,0.024941388924090736,0.5850573198049809
5642,0.5683,5,3,5,673298,3146,121821,4435,0.024917627677100495,0.5850151695027042
5643,0.5684,5,7,5,673305,3139,121826,4430,0.024862184767456597,0.5852820716078743
5644,0.5685,8,4,8,673309,3135,121834,4422,0.02483050310480294,0.5851528384279476
5645,0.5686,7,2,7,673311,3133,121841,4415,0.02481466227347611,0.5849231584525703
5646,0.5687,7,5,7,673316,3128,121848,4408,0.024775060195159043,0.5849256900212314
5647,0.5688,10,9,10,673325,3119,121858,4398,0.024703776454188316,0.5850738326460024
5648,0.5689,4,3,4,673328,3116,121862,4394,0.024680015207198074,0.58508655126498
5649,0.569,7,4,7,673332,3112,121869,4387,0.024648333544544418,0.585011334844646
5650,0.5691,8,4,8,673336,3108,121877,4379,0.02461665188189076,0.5848804594630693
5651,0.5692,8,5,8,673341,3103,121885,4371,0.02457704980357369,0.5848274016590849
5652,0.5693,8,5,8,673346,3098,121893,4363,0.024537447725256623,0.5847741589599249
5653,0.5694,6,1,6,673347,3097,121899,4357,0.024529527309593208,0.5845183793936142
5654,0.5695,5,2,5,673349,3095,121904,4352,0.024513686478266378,0.5843964012353968
5655,0.5696,2,3,2,673352,3092,121906,4350,0.024489925231276136,0.5845202902445579
5656,0.5697,6,2,6,673354,3090,121912,4344,0.02447408439994931,0.5843422114608555
5657,0.5698,3,1,3,673355,3089,121915,4341,0.024466163984285895,0.5842530282637954
5658,0.5699,8,5,8,673360,3084,121923,4333,0.024426561905968824,0.5841984629904274
5659,0.57,4,7,4,673367,3077,121927,4329,0.024371118996324926,0.5845260599513907
5660,0.5701,3,2,3,673369,3075,121930,4326,0.0243552781649981,0.5845156059991893
5661,0.5702,4,3,4,673372,3072,121934,4322,0.024331516918007858,0.5845279956721666
5662,0.5703,4,8,4,673380,3064,121938,4318,0.024268153592700546,0.5849363316174478
5663,0.5704,9,4,9,673384,3060,121947,4309,0.02423647193004689,0.5847469127425702
5664,0.5705,7,1,7,673385,3059,121954,4302,0.024228551514383474,0.5844314631164244
5665,0.5706,8,8,8,673393,3051,121962,4294,0.02416518818907616,0.5846153846153846
5666,0.5707,7,6,7,673399,3045,121969,4287,0.02411766569509568,0.5846972176759411
5667,0.5708,3,5,3,673404,3040,121972,4284,0.024078063616778608,0.5849262697979246
5668,0.5709,3,5,3,673409,3035,121975,4281,0.02403846153846154,0.5851558228540186
5669,0.571,7,10,7,673419,3025,121982,4274,0.023959257381827397,0.5855596657076312
5670,0.5711,2,3,2,673422,3022,121984,4272,0.023935496134837156,0.5856868659171922
5671,0.5712,7,8,7,673430,3014,121991,4265,0.023872132809529843,0.5859321335348262
5672,0.5713,3,5,3,673435,3009,121994,4262,0.023832530731212775,0.5861642140008252
5673,0.5714,6,4,6,673439,3005,122000,4256,0.02380084906855912,0.5861451590689988
5674,0.5715,2,1,2,673440,3004,122002,4254,0.023792928652895704,0.5861118765500137
5675,0.5716,2,4,2,673444,3000,122004,4252,0.023761246990242048,0.5863210148924435
5676,0.5717,6,0,6,673444,3000,122010,4246,0.023761246990242048,0.5859784708804858
5677,0.5718,7,2,7,673446,2998,122017,4239,0.02374540615891522,0.5857399474920547
5678,0.5719,5,3,5,673449,2995,122022,4234,0.023721644911924977,0.5856965002074975
5679,0.572,2,5,2,673454,2990,122024,4232,0.02368204283360791,0.5859872611464968
5680,0.5721,3,4,3,673458,2986,122027,4229,0.023650361170954252,0.5861399861399862
5681,0.5722,4,11,4,673469,2975,122031,4225,0.0235632365986567,0.5868055555555556
5682,0.5723,2,3,2,673472,2972,122033,4223,0.023539475351666457,0.5869353717859624
5683,0.5724,4,4,4,673476,2968,122037,4219,0.0235077936890128,0.587032141366356
5684,0.5725,9,3,9,673479,2965,122046,4210,0.023484032442022556,0.5867595818815331
5685,0.5726,3,2,3,673481,2963,122049,4207,0.02346819161069573,0.5867503486750348
5686,0.5727,7,4,7,673485,2959,122056,4200,0.023436509948042073,0.5866741164967174
5687,0.5728,11,7,11,673492,2952,122067,4189,0.023381067038398175,0.5866125192550063
5688,0.5729,1,7,1,673499,2945,122068,4188,0.023325624128754278,0.5871302397308286
5689,0.573,7,2,7,673501,2943,122075,4181,0.023309783297427448,0.5868893879842785
5690,0.5731,7,6,7,673507,2937,122082,4174,0.023262260803446965,0.5869779215300239
5691,0.5732,3,3,3,673510,2934,122085,4171,0.023238499556456724,0.5870513722730472
5692,0.5733,4,2,4,673512,2932,122089,4167,0.023222658725129894,0.5869840822651078
5693,0.5734,3,5,3,673517,2927,122092,4164,0.023183056646812826,0.587223240727683
5694,0.5735,5,3,5,673520,2924,122097,4159,0.02315929539982258,0.5871805732034449
5695,0.5736,5,3,5,673523,2921,122102,4154,0.02313553415283234,0.5871378091872792
5696,0.5737,6,6,6,673529,2915,122108,4148,0.023088011658851857,0.587285855868611
5697,0.5738,1,4,1,673533,2911,122109,4147,0.0230563299961982,0.5875602153584585
5698,0.5739,7,6,7,673539,2905,122116,4140,0.023008807502217718,0.5876508161816891
5699,0.574,3,4,3,673543,2901,122119,4137,0.02297712583956406,0.5878090366581415
5700,0.5741,2,7,2,673550,2894,122121,4135,0.02292168292992016,0.5882771375729122
5701,0.5742,2,5,2,673555,2889,122123,4133,0.022882080851603093,0.5885787524921675
5702,0.5743,2,5,2,673560,2884,122125,4131,0.02284247877328602,0.5888809693513899
5703,0.5744,3,2,3,673562,2882,122128,4128,0.022826637941959195,0.5888730385164052
5704,0.5745,4,2,4,673564,2880,122132,4124,0.022810797110632365,0.5888063963449457
5705,0.5746,5,3,5,673567,2877,122137,4119,0.022787035863642124,0.5887650085763293
5706,0.5747,3,1,3,673568,2876,122140,4116,0.02277911544797871,0.5886727688787186
5707,0.5748,3,9,3,673577,2867,122143,4113,0.022707831707007985,0.5892550143266476
5708,0.5749,1,4,1,673581,2863,122144,4112,0.02267615004435433,0.5895340501792115
5709,0.575,4,3,4,673584,2860,122148,4108,0.022652388797364087,0.5895522388059702
5710,0.5751,0,2,0,673586,2858,122148,4108,0.022636547966037257,0.5897215044501867
5711,0.5752,4,5,4,673591,2853,122152,4104,0.02259694588772019,0.5899094437257438
5712,0.5753,3,7,3,673598,2846,122155,4101,0.022541502978076288,0.5903267597524111
5713,0.5754,2,1,2,673599,2845,122157,4099,0.022533582562412877,0.5902937788018433
5714,0.5755,1,2,1,673601,2843,122158,4098,0.022517741731086047,0.5904048408010373
5715,0.5756,4,5,4,673606,2838,122162,4094,0.02247813965276898,0.5905943450663589
5716,0.5757,3,1,3,673607,2837,122165,4091,0.022470219237105564,0.5905023094688222
5717,0.5758,5,2,5,673609,2835,122170,4086,0.022454378405778734,0.5903771131339401
5718,0.5759,4,7,4,673616,2828,122174,4082,0.022398935496134836,0.5907380607814762
5719,0.576,8,3,8,673619,2825,122182,4074,0.022375174249144595,0.590520365270329
5720,0.5761,5,3,5,673622,2822,122187,4069,0.022351413002154354,0.5904803366710202
5721,0.5762,3,4,3,673626,2818,122190,4066,0.022319731339500697,0.5906449738524114
5722,0.5763,3,3,3,673629,2815,122193,4063,0.022295970092510456,0.5907240476882815
5723,0.5764,5,1,5,673630,2814,122198,4058,0.02228804967684704,0.590512223515716
5724,0.5765,7,0,7,673630,2814,122205,4051,0.02228804967684704,0.590094683175528
5725,0.5766,4,3,4,673633,2811,122209,4047,0.0222642884298568,0.5901137357830272
5726,0.5767,3,7,3,673640,2804,122212,4044,0.022208845520212902,0.5905373831775701
5727,0.5768,6,6,6,673646,2798,122218,4038,0.022161323026232416,0.5906963136337039
5728,0.5769,5,5,5,673651,2793,122223,4033,0.022121720947915348,0.5908291825373572
5729,0.577,3,4,3,673655,2789,122226,4030,0.02209003928526169,0.5909957471770054
5730,0.5771,4,0,4,673655,2789,122230,4026,0.02209003928526169,0.5907556859867938
5731,0.5772,0,5,0,673660,2784,122230,4026,0.02205043720694462,0.5911894273127754
5732,0.5773,0,3,0,673663,2781,122230,4026,0.02202667595995438,0.5914499779638608
5733,0.5774,4,0,4,673663,2781,122234,4022,0.02202667595995438,0.5912097603998236
5734,0.5775,5,3,5,673666,2778,122239,4017,0.022002914712964138,0.5911699779249449
5735,0.5776,4,1,4,673667,2777,122243,4013,0.021994994297300723,0.5910162002945508
5736,0.5777,3,0,3,673667,2777,122246,4010,0.021994994297300723,0.5908354206571387
5737,0.5778,2,3,2,673670,2774,122248,4008,0.02197123305031048,0.5909761132409319
5738,0.5779,2,6,2,673676,2768,122250,4006,0.021923710556329995,0.5913788012990847
5739,0.578,14,2,14,673678,2766,122264,3992,0.02190786972500317,0.5907073098549867
5740,0.5781,8,8,8,673686,2758,122272,3984,0.021844506399695856,0.5909225749035895
5741,0.5782,4,1,4,673687,2757,122276,3980,0.02183658598403244,0.5907674038889713
5742,0.5783,5,2,5,673689,2755,122281,3975,0.021820745152705615,0.5906389301634473
5743,0.5784,6,7,6,673696,2748,122287,3969,0.021765302243061717,0.5908887896382313
5744,0.5785,5,3,5,673699,2745,122292,3964,0.021741540996071475,0.5908481144730958
5745,0.5786,2,4,2,673703,2741,122294,3962,0.02170985933341782,0.5910786215127555
5746,0.5787,5,3,5,673706,2738,122299,3957,0.021686098086427574,0.5910380881254668
5747,0.5788,6,8,6,673714,2730,122305,3951,0.021622734761120265,0.5913785361472833
5748,0.5789,1,4,1,673718,2726,122306,3950,0.02159105309846661,0.591671659676453
5749,0.579,3,2,3,673720,2724,122309,3947,0.02157521226713978,0.5916654174786389
5750,0.5791,3,2,3,673722,2722,122312,3944,0.021559371435812952,0.5916591659165916
5751,0.5792,3,3,3,673725,2719,122315,3941,0.02153561018882271,0.5917417417417418
5752,0.5793,1,4,1,673729,2715,122316,3940,0.021503928526169055,0.5920360631104433
5753,0.5794,9,5,9,673734,2710,122325,3931,0.021464326447851984,0.5919289263665111
5754,0.5795,2,4,2,673738,2706,122327,3929,0.021432644785198327,0.5921627731725697
5755,0.5796,1,2,1,673740,2704,122328,3928,0.0214168039538715,0.5922798552472859
5756,0.5797,5,2,5,673742,2702,122333,3923,0.02140096312254467,0.5921509433962264
5757,0.5798,8,3,8,673745,2699,122341,3915,0.02137720187555443,0.5919262171152102
5758,0.5799,2,7,2,673752,2692,122343,3913,0.021321758965910532,0.5924299772899319
5759,0.58,4,7,4,673759,2685,122347,3909,0.021266316056266634,0.5928116469517744
5760,0.5801,4,6,4,673765,2679,122351,3905,0.021218793562286148,0.5931044957472661
5761,0.5802,5,3,5,673768,2676,122356,3900,0.021195032315295907,0.593065693430657
5762,0.5803,8,6,8,673774,2670,122364,3892,0.021147509821315424,0.5931118561414203
5763,0.5804,7,5,7,673779,2665,122371,3885,0.021107907742998352,0.5931297709923664
5764,0.5805,3,3,3,673782,2662,122374,3882,0.02108414649600811,0.5932151589242054
5765,0.5806,8,4,8,673786,2658,122382,3874,0.021052464833354455,0.5930802204531537
5766,0.5807,3,2,3,673788,2656,122385,3871,0.021036624002027625,0.5930749195648843
5767,0.5808,4,4,4,673792,2652,122389,3867,0.021004942339373972,0.5931891394385642
5768,0.5809,4,1,4,673793,2651,122393,3863,0.020997021923710557,0.5930303960700031
5769,0.581,4,6,4,673799,2645,122397,3859,0.02094949942973007,0.5933271832718328
5770,0.5811,3,4,3,673803,2641,122400,3856,0.020917817767076415,0.5935046944743728
5771,0.5812,5,8,5,673811,2633,122405,3851,0.020854454441769105,0.5939235040098705
5772,0.5813,7,2,7,673813,2631,122412,3844,0.020838613610442275,0.5936679536679537
5773,0.5814,3,0,3,673813,2631,122415,3841,0.020838613610442275,0.5934796044499382
5774,0.5815,2,0,2,673813,2631,122417,3839,0.020838613610442275,0.5933539412673879
5775,0.5816,2,7,2,673820,2624,122419,3837,0.020783170700798378,0.5938709178145798
5776,0.5817,7,2,7,673822,2622,122426,3830,0.02076732986947155,0.5936143831370118
5777,0.5818,4,4,4,673826,2618,122430,3826,0.020735648206817895,0.5937306021104903
5778,0.5819,6,6,6,673832,2612,122436,3820,0.02068812571283741,0.5939054726368159
5779,0.582,2,4,2,673836,2608,122438,3818,0.020656444050183752,0.5941487706193589
5780,0.5821,4,7,4,673843,2601,122442,3814,0.020601001140539855,0.5945440374123149
5781,0.5822,1,4,1,673847,2597,122443,3813,0.0205693194778862,0.5948517940717629
5782,0.5823,5,3,5,673850,2594,122448,3808,0.020545558230895957,0.5948141205873164
5783,0.5824,3,3,3,673853,2591,122451,3805,0.020521796983905716,0.5949030644152595
5784,0.5825,3,4,3,673857,2587,122454,3802,0.02049011532125206,0.5950853028642981
5785,0.5826,7,7,7,673864,2580,122461,3795,0.02043467241160816,0.5952941176470589
5786,0.5827,3,4,3,673868,2576,122464,3792,0.020402990748954505,0.5954773869346733
5787,0.5828,2,1,2,673869,2575,122466,3790,0.02039507033329109,0.5954438334642577
5788,0.5829,3,2,3,673871,2573,122469,3787,0.020379229501964264,0.595440251572327
5789,0.583,5,6,5,673877,2567,122474,3782,0.020331707007983778,0.5956843597416916
5790,0.5831,3,5,3,673882,2562,122477,3779,0.02029210492966671,0.5959627818956
5791,0.5832,6,3,6,673885,2559,122483,3773,0.020268343682676465,0.5958622867972204
5792,0.5833,1,7,1,673892,2552,122484,3772,0.020212900773032567,0.5964579380139152
5793,0.5834,7,5,7,673897,2547,122491,3765,0.0201732986947155,0.5964828897338403
5794,0.5835,4,2,4,673899,2545,122495,3761,0.02015745786338867,0.5964161116397082
5795,0.5836,2,2,2,673901,2543,122497,3759,0.020141617032061843,0.59647730879086
5796,0.5837,4,2,4,673903,2541,122501,3755,0.020125776200735013,0.5964104193138501
5797,0.5838,6,3,6,673906,2538,122507,3749,0.020102014953744772,0.5963098457133769
5798,0.5839,4,4,4,673910,2534,122511,3745,0.020070333291091116,0.5964325529542921
5799,0.584,6,3,6,673913,2531,122517,3739,0.020046572044100874,0.5963317384370016
5800,0.5841,5,3,5,673916,2528,122522,3734,0.020022810797110633,0.596295113382306
5801,0.5842,5,3,5,673919,2525,122527,3729,0.01999904955012039,0.5962583946274385
5802,0.5843,5,6,5,673925,2519,122532,3724,0.019951527056139905,0.596508089059747
5803,0.5844,5,2,5,673927,2517,122537,3719,0.01993568622481308,0.5963758819756254
5804,0.5845,5,6,5,673933,2511,122542,3714,0.019888163730832593,0.5966265060240964
5805,0.5846,6,3,6,673936,2508,122548,3708,0.01986440248384235,0.5965250965250966
5806,0.5847,5,3,5,673939,2505,122553,3703,0.01984064123685211,0.5964884020618557
5807,0.5848,6,2,6,673941,2503,122559,3697,0.019824800405525284,0.5962903225806452
5808,0.5849,5,4,5,673945,2499,122564,3692,0.019793118742871627,0.5963495396543369
5809,0.585,9,6,9,673951,2493,122573,3683,0.01974559624889114,0.5963406735751295
5810,0.5851,8,3,8,673954,2490,122581,3675,0.0197218350019009,0.5961070559610706
5811,0.5852,3,3,3,673957,2487,122584,3672,0.019698073754910658,0.5962006819288845
5812,0.5853,1,3,1,673960,2484,122585,3671,0.019674312507920417,0.59642567018684
5813,0.5854,3,3,3,673963,2481,122588,3668,0.019650551260930172,0.596519759310457
5814,0.5855,5,4,5,673967,2477,122593,3663,0.01961886959827652,0.5965798045602606
5815,0.5856,4,4,4,673971,2473,122597,3659,0.019587187935622863,0.5967058056099152
5816,0.5857,4,3,4,673974,2470,122601,3655,0.019563426688632618,0.5967346938775511
5817,0.5858,3,3,3,673977,2467,122604,3652,0.019539665441642377,0.5968295473116523
5818,0.5859,4,3,4,673980,2464,122608,3648,0.019515904194652135,0.5968586387434555
5819,0.586,4,6,4,673986,2458,122612,3644,0.019468381700671653,0.5971812520485087
5820,0.5861,4,4,4,673990,2454,122616,3640,0.019436700038017996,0.5973088283557597
5821,0.5862,1,0,1,673990,2454,122617,3639,0.019436700038017996,0.5972427375677006
5822,0.5863,1,3,1,673993,2451,122618,3638,0.019412938791027755,0.5974708490720972
5823,0.5864,4,2,4,673995,2449,122622,3634,0.019397097959700925,0.5974025974025974
5824,0.5865,3,2,3,673997,2447,122625,3631,0.0193812571283741,0.5974004606778546
5825,0.5866,5,4,5,674001,2443,122630,3626,0.019349575465720442,0.5974625144175317
5826,0.5867,1,2,1,674003,2441,122631,3625,0.019333734634393612,0.5975931421035279
5827,0.5868,7,3,7,674006,2438,122638,3618,0.01930997338740337,0.5974240422721269
5828,0.5869,2,0,2,674006,2438,122640,3616,0.01930997338740337,0.5972910472414932
5829,0.587,7,4,7,674010,2434,122647,3609,0.019278291724749715,0.5972199238788681
5830,0.5871,5,3,5,674013,2431,122652,3604,0.019254530477759473,0.5971830985915493
5831,0.5872,8,6,8,674019,2425,122660,3596,0.019207007983778987,0.5972429828932071
5832,0.5873,4,3,4,674022,2422,122664,3592,0.019183246736788746,0.5972730295976055
5833,0.5874,5,1,5,674023,2421,122669,3587,0.019175326321125334,0.5970372836218375
5834,0.5875,5,3,5,674026,2418,122674,3582,0.01915156507413509,0.597
5835,0.5876,4,5,4,674031,2413,122678,3578,0.01911196299581802,0.5972291770989818
5836,0.5877,1,4,1,674035,2409,122679,3577,0.019080281333164365,0.5975609756097561
5837,0.5878,4,3,4,674038,2406,122683,3573,0.019056520086174124,0.5975915704967386
5838,0.5879,2,0,2,674038,2406,122685,3571,0.019056520086174124,0.5974569181863811
5839,0.588,4,4,4,674042,2402,122689,3567,0.019024838423520467,0.5975875356006031
5840,0.5881,3,6,3,674048,2396,122692,3564,0.01897731592953998,0.5979865771812081
5841,0.5882,3,1,3,674049,2395,122695,3561,0.01896939551387657,0.5978844862323707
5842,0.5883,5,1,5,674050,2394,122700,3556,0.018961475098213155,0.5976470588235294
5843,0.5884,2,2,2,674052,2392,122702,3554,0.018945634266886325,0.5977127480659267
5844,0.5885,6,8,6,674060,2384,122708,3548,0.018882270941579016,0.598111935266352
5845,0.5886,2,1,2,674061,2383,122710,3546,0.0188743505259156,0.5980772474278968
5846,0.5887,5,3,5,674064,2380,122715,3541,0.01885058927892536,0.5980408714744131
5847,0.5888,8,1,8,674065,2379,122723,3533,0.018842668863261944,0.5975981055480379
5848,0.5889,5,7,5,674072,2372,122728,3528,0.018787225953618047,0.5979661016949153
5849,0.589,5,3,5,674075,2369,122733,3523,0.018763464706627805,0.5979293957909029
5850,0.5891,1,2,1,674077,2367,122734,3522,0.018747623875300976,0.5980641874681609
5851,0.5892,3,3,3,674080,2364,122737,3519,0.018723862628310734,0.5981642019377869
5852,0.5893,7,6,7,674086,2358,122744,3512,0.018676340134330248,0.5982964224872231
5853,0.5894,0,3,0,674089,2355,122744,3512,0.018652578887340007,0.598602352139083
5854,0.5895,8,5,8,674094,2350,122752,3504,0.01861297680902294,0.5985650837034506
5855,0.5896,5,4,5,674098,2346,122757,3499,0.018581295146369282,0.5986313088109495
5856,0.5897,3,2,3,674100,2344,122760,3496,0.018565454315042453,0.5986301369863014
5857,0.5898,7,1,7,674101,2343,122767,3489,0.01855753389937904,0.5982510288065843
5858,0.5899,4,4,4,674105,2339,122771,3485,0.018525852236725385,0.598385989010989
5859,0.59,9,4,9,674109,2335,122780,3476,0.01849417057407173,0.5981758733436586
5860,0.5901,1,5,1,674114,2330,122781,3475,0.018454568495754657,0.5986218776916451
5861,0.5902,1,3,1,674117,2327,122782,3474,0.018430807248764416,0.5988622651267023
5862,0.5903,5,3,5,674120,2324,122787,3469,0.018407046001774174,0.5988261695149318
5863,0.5904,2,7,2,674127,2317,122789,3467,0.018351603092130277,0.5994121715076072
5864,0.5905,8,5,8,674132,2312,122797,3459,0.018312001013813205,0.5993761913013342
5865,0.5906,4,4,4,674136,2308,122801,3455,0.01828031935115955,0.5995141419399618
5866,0.5907,14,7,14,674143,2301,122815,3441,0.01822487644151565,0.5992685475444096
5867,0.5908,7,3,7,674146,2298,122822,3434,0.01820111519452541,0.599092812281926
5868,0.5909,3,1,3,674147,2297,122825,3431,0.018193194778861995,0.5989874301675978
5869,0.591,3,3,3,674150,2294,122828,3428,0.018169433531871754,0.5990912268437609
5870,0.5911,3,2,3,674152,2292,122831,3425,0.018153592700544924,0.5990904320447787
5871,0.5912,3,7,3,674159,2285,122834,3422,0.018098149790901026,0.5996145084983354
5872,0.5913,1,5,1,674164,2280,122835,3421,0.018058547712583955,0.6000701631292755
5873,0.5914,1,4,1,674168,2276,122836,3420,0.018026866049930302,0.6004213483146067
5874,0.5915,1,1,1,674169,2275,122837,3419,0.018018945634266887,0.6004566210045662
5875,0.5916,3,2,3,674171,2273,122840,3416,0.018003104802940057,0.6004570223237827
5876,0.5917,3,3,3,674174,2270,122843,3413,0.017979343555949816,0.6005630828787613
5877,0.5918,7,1,7,674175,2269,122850,3406,0.0179714231402864,0.6001762114537444
5878,0.5919,3,4,3,674179,2265,122853,3403,0.017939741477632744,0.6003881439661256
5879,0.592,3,3,3,674182,2262,122856,3400,0.017915980230642503,0.6004945249028611
5880,0.5921,4,9,4,674191,2253,122860,3396,0.01784469648967178,0.6011683483802442
5881,0.5922,5,6,5,674197,2247,122865,3391,0.017797173995691293,0.6014544164597375
5882,0.5923,3,3,3,674200,2244,122868,3388,0.01777341274870105,0.6015625
5883,0.5924,7,5,7,674205,2239,122875,3381,0.01773381067038398,0.6016014234875445
5884,0.5925,3,5,3,674210,2234,122878,3378,0.017694208592066912,0.6019244476122595
5885,0.5926,5,3,5,674213,2231,122883,3373,0.01767044734507667,0.601891506067095
5886,0.5927,5,1,5,674214,2230,122888,3368,0.017662526929413256,0.601643444087174
5887,0.5928,4,4,4,674218,2226,122892,3364,0.0176308452667596,0.6017889087656529
5888,0.5929,5,1,5,674219,2225,122897,3359,0.017622924851096185,0.6015401146131805
5889,0.593,4,3,4,674222,2222,122901,3355,0.017599163604105943,0.6015779092702169
5890,0.5931,1,1,1,674223,2221,122902,3354,0.01759124318844253,0.6016143497757848
5891,0.5932,6,3,6,674226,2218,122908,3348,0.017567481941452287,0.6015091627739849
5892,0.5933,3,4,3,674230,2214,122911,3345,0.01753580027879863,0.6017269293038316
5893,0.5934,2,2,2,674232,2212,122913,3343,0.017519959447471804,0.6018001800180018
5894,0.5935,1,4,1,674236,2208,122914,3342,0.017488277784818148,0.6021621621621621
5895,0.5936,2,1,2,674237,2207,122916,3340,0.017480357369154733,0.6021272760050478
5896,0.5937,3,7,3,674244,2200,122919,3337,0.017424914459510835,0.6026729275781109
5897,0.5938,4,4,4,674248,2196,122923,3333,0.01739323279685718,0.6028214867064569
5898,0.5939,7,4,7,674252,2192,122930,3326,0.017361551134203523,0.6027546212395796
5899,0.594,5,1,5,674253,2191,122935,3321,0.017353630718540108,0.6025036284470247
5900,0.5941,4,4,4,674257,2187,122939,3317,0.01732194905588645,0.6026526162790697
5901,0.5942,2,3,2,674260,2184,122941,3315,0.01729818780889621,0.6028368794326241
5902,0.5943,2,3,2,674263,2181,122943,3313,0.01727442656190597,0.6030214779759738
5903,0.5944,3,1,3,674264,2180,122946,3310,0.017266506146242554,0.6029143897996357
5904,0.5945,4,3,4,674267,2177,122950,3306,0.017242744899252312,0.602954586904979
5905,0.5946,2,6,2,674273,2171,122952,3304,0.01719522240527183,0.6034703196347032
5906,0.5947,4,5,4,674278,2166,122956,3300,0.01715562032695476,0.6037321624588364
5907,0.5948,4,3,4,674281,2163,122960,3296,0.017131859079964517,0.6037735849056604
5908,0.5949,6,2,6,674283,2161,122966,3290,0.017116018248637687,0.603558980003669
5909,0.595,6,5,6,674288,2156,122972,3284,0.01707641617032062,0.6036764705882353
5910,0.5951,3,1,3,674289,2155,122975,3281,0.017068495754657204,0.6035688005886681
5911,0.5952,4,2,4,674291,2153,122979,3277,0.017052654923330378,0.6034990791896869
5912,0.5953,2,5,2,674296,2148,122981,3275,0.017013052845013307,0.6039092753088696
5913,0.5954,2,1,2,674297,2147,122983,3273,0.01700513242934989,0.6038745387453874
5914,0.5955,2,5,2,674302,2142,122985,3271,0.016965530351032824,0.6042859782006281
5915,0.5956,5,3,5,674305,2139,122990,3266,0.01694176910404258,0.6042553191489362
5916,0.5957,3,2,3,674307,2137,122993,3263,0.016925928272715753,0.6042592592592593
5917,0.5958,6,2,6,674309,2135,122999,3257,0.016910087441388923,0.6040430267062314
5918,0.5959,5,3,5,674312,2132,123004,3252,0.01688632619439868,0.6040118870728083
5919,0.596,1,3,1,674315,2129,123005,3251,0.01686256494740844,0.6042750929368029
5920,0.5961,3,2,3,674317,2127,123008,3248,0.016846724116081613,0.6042790697674418
5921,0.5962,7,3,7,674320,2124,123015,3241,0.01682296286909137,0.6041006523765144
5922,0.5963,8,3,8,674323,2121,123023,3233,0.016799201622101127,0.6038475905864774
5923,0.5964,2,3,2,674326,2118,123025,3231,0.016775440375110886,0.604038137969714
5924,0.5965,1,3,1,674329,2115,123026,3230,0.016751679128120645,0.6043030869971936
5925,0.5966,6,1,6,674330,2114,123032,3224,0.01674375871245723,0.6039715249156987
5926,0.5967,3,1,3,674331,2113,123035,3221,0.016735838296793815,0.603862017247844
5927,0.5968,5,3,5,674334,2110,123040,3216,0.016712077049803573,0.6038302666165978
5928,0.5969,5,0,5,674334,2110,123045,3211,0.016712077049803573,0.6034579966171773
5929,0.597,2,1,2,674335,2109,123047,3209,0.01670415663414016,0.6034223392252727
5930,0.5971,1,5,1,674340,2104,123048,3208,0.01666455455582309,0.6039156626506024
5931,0.5972,4,2,4,674342,2102,123052,3204,0.01664871372449626,0.6038447041085564
5932,0.5973,3,2,3,674344,2100,123055,3201,0.016632872893169434,0.6038483305036786
5933,0.5974,9,2,9,674346,2098,123064,3192,0.016617032061842604,0.6034026465028356
5934,0.5975,3,2,3,674348,2096,123067,3189,0.016601191230515778,0.6034058656575213
5935,0.5976,6,6,6,674354,2090,123073,3183,0.01655366873653529,0.6036411909728807
5936,0.5977,2,4,2,674358,2086,123075,3181,0.01652198707388164,0.6039491171444845
5937,0.5978,4,4,4,674362,2082,123079,3177,0.016490305411227982,0.6041072447233314
5938,0.5979,4,3,4,674365,2079,123083,3173,0.016466544164237738,0.6041507996953541
5939,0.598,3,3,3,674368,2076,123086,3170,0.016442782917247496,0.6042699199390011
5940,0.5981,3,4,3,674372,2072,123089,3167,0.01641110125459384,0.6045046764649742
5941,0.5982,3,4,3,674376,2068,123092,3164,0.016379419591940184,0.6047400611620795
5942,0.5983,5,3,5,674379,2065,123097,3159,0.016355658344949942,0.6047090352220521
5943,0.5984,5,2,5,674381,2063,123102,3154,0.016339817513623116,0.6045620088173279
5944,0.5985,3,3,3,674384,2060,123105,3151,0.016316056266632874,0.6046824026098637
5945,0.5986,4,1,4,674385,2059,123109,3147,0.01630813585096946,0.6044948136765271
5946,0.5987,6,3,6,674388,2056,123115,3141,0.016284374603979218,0.6043871464306331
5947,0.5988,3,2,3,674390,2054,123118,3138,0.016268533772652388,0.6043913713405239
5948,0.5989,3,2,3,674392,2052,123121,3135,0.016252692941325562,0.6043956043956044
5949,0.599,4,1,4,674393,2051,123125,3131,0.016244772525662147,0.6042068699343882
5950,0.5991,4,5,4,674398,2046,123129,3127,0.016205170447345076,0.6044848250531606
5951,0.5992,4,3,4,674401,2043,123133,3123,0.016181409200354834,0.6045296167247387
5952,0.5993,5,4,5,674405,2039,123138,3118,0.016149727537701178,0.604615086290479
5953,0.5994,7,4,7,674409,2035,123145,3111,0.01611804587504752,0.604547221142635
5954,0.5995,2,1,2,674410,2034,123147,3109,0.01611012545938411,0.6045109858059499
5955,0.5996,3,7,3,674417,2027,123150,3106,0.01605468254974021,0.6051042275472434
5956,0.5997,2,8,2,674425,2019,123152,3104,0.0159913192244329,0.6058949834081593
5957,0.5998,2,1,2,674426,2018,123154,3102,0.015983398808769485,0.605859375
5958,0.5999,3,5,3,674431,2013,123157,3099,0.015943796730452413,0.6062206572769953
5959,0.6,4,2,4,674433,2011,123161,3095,0.015927955899125587,0.6061496278887584
5960,0.6001,5,7,5,674440,2004,123166,3090,0.01587251298948169,0.6065959952885748
5961,0.6002,4,5,4,674445,1999,123170,3086,0.015832910911164618,0.6068829891838742
5962,0.6003,2,0,2,674445,1999,123172,3084,0.015832910911164618,0.6067283100531182
5963,0.6004,4,2,4,674447,1997,123176,3080,0.015817070079837788,0.6066574748867442
5964,0.6005,5,1,5,674448,1996,123181,3075,0.015809149664174377,0.6063892723328732
5965,0.6006,4,4,4,674452,1992,123185,3071,0.01577746800152072,0.6065573770491803
5966,0.6007,3,3,3,674455,1989,123188,3068,0.01575370675453048,0.6066838046272494
5967,0.6008,1,1,1,674456,1988,123189,3067,0.015745786338867064,0.6067260138476755
5968,0.6009,5,4,5,674460,1984,123194,3062,0.015714104676213408,0.606817281014665
5969,0.601,4,2,4,674462,1982,123198,3058,0.01569826384488658,0.6067460317460317
5970,0.6011,2,3,2,674465,1979,123200,3056,0.015674502597896336,0.6069513406156901
5971,0.6012,5,4,5,674469,1975,123205,3051,0.01564282093524268,0.6070433744528452
5972,0.6013,5,5,5,674474,1970,123210,3046,0.01560321885692561,0.6072567783094099
5973,0.6014,5,5,5,674479,1965,123215,3041,0.015563616778608541,0.60747103475829
5974,0.6015,2,3,2,674482,1962,123217,3039,0.0155398555316183,0.6076784643071386
5975,0.6016,3,1,3,674483,1961,123220,3036,0.015531935115954885,0.6075645387232339
5976,0.6017,3,2,3,674485,1959,123223,3033,0.015516094284628057,0.6075721153846154
5977,0.6018,5,3,5,674488,1956,123228,3028,0.015492333037637815,0.6075441412520064
5978,0.6019,4,5,4,674493,1951,123232,3024,0.015452730959320746,0.6078391959798995
5979,0.602,6,2,6,674495,1949,123238,3018,0.015436890127993918,0.60761022750151
5980,0.6021,4,4,4,674499,1945,123242,3014,0.015405208465340261,0.6077838273845534
5981,0.6022,3,1,3,674500,1944,123245,3011,0.015397288049676846,0.6076690211907164
5982,0.6023,2,1,2,674501,1943,123247,3009,0.015389367634013433,0.6076332794830371
5983,0.6024,6,3,6,674504,1940,123253,3003,0.015365606387023192,0.607525794052195
5984,0.6025,2,0,2,674504,1940,123255,3001,0.015365606387023192,0.6073669297713014
5985,0.6026,5,1,5,674505,1939,123260,2996,0.015357685971359777,0.6070921985815603
5986,0.6027,5,2,5,674507,1937,123265,2991,0.015341845140032949,0.606939935064935
5987,0.6028,6,7,6,674514,1930,123271,2985,0.015286402230389051,0.6073245167853509
5988,0.6029,6,3,6,674517,1927,123277,2979,0.01526264098339881,0.6072156543008561
5989,0.603,3,2,3,674519,1925,123280,2976,0.015246800152071981,0.6072230157110794
5990,0.6031,9,0,9,674519,1925,123289,2967,0.015246800152071981,0.6065004088307441
5991,0.6032,6,6,6,674525,1919,123295,2961,0.015199277658091497,0.6067622950819672
5992,0.6033,0,1,0,674526,1918,123295,2961,0.015191357242428082,0.6068866571018652
5993,0.6034,5,4,5,674530,1914,123300,2956,0.015159675579774427,0.6069815195071868
5994,0.6035,4,0,4,674530,1914,123304,2952,0.015159675579774427,0.6066584463625154
5995,0.6036,2,2,2,674532,1912,123306,2950,0.0151438347484476,0.6067461949814891
5996,0.6037,2,3,2,674535,1909,123308,2948,0.015120073501457356,0.606959028206712
5997,0.6038,1,3,1,674538,1906,123309,2947,0.015096312254467115,0.6072532454152071
5998,0.6039,3,1,3,674539,1905,123312,2944,0.0150883918388037,0.6071354918539905
5999,0.604,3,2,3,674541,1903,123315,2941,0.015072551007476872,0.6071428571428571
6000,0.6041,1,2,1,674543,1901,123316,2940,0.015056710176150045,0.607312538731667
6001,0.6042,4,3,4,674546,1898,123320,2936,0.015032948929159802,0.6073645014480761
6002,0.6043,4,6,4,674552,1892,123324,2932,0.014985426435179318,0.6077943615257048
6003,0.6044,3,2,3,674554,1890,123327,2929,0.01496958560385249,0.6078024486407968
6004,0.6045,1,4,1,674558,1886,123328,2928,0.014937903941198835,0.6082260074781887
6005,0.6046,2,3,2,674561,1883,123330,2926,0.014914142694208592,0.6084425036390102
6006,0.6047,2,3,2,674564,1880,123332,2924,0.01489038144721835,0.6086594504579517
6007,0.6048,2,6,2,674570,1874,123334,2922,0.014842858953237866,0.609257714762302
6008,0.6049,4,2,4,674572,1872,123338,2918,0.014827018121911038,0.6091858037578288
6009,0.605,4,1,4,674573,1871,123342,2914,0.014819097706247624,0.6089864158829676
6010,0.6051,7,2,7,674575,1869,123349,2907,0.014803256874920796,0.6086683417085427
6011,0.6052,4,1,4,674576,1868,123353,2903,0.014795336459257381,0.6084678264514777
6012,0.6053,1,6,1,674582,1862,123354,2902,0.014747813965276899,0.609151973131822
6013,0.6054,4,1,4,674583,1861,123358,2898,0.014739893549613484,0.6089514603908384
6014,0.6055,4,1,4,674584,1860,123362,2894,0.01473197313395007,0.6087505258729491
6015,0.6056,2,1,2,674585,1859,123364,2892,0.014724052718286655,0.6087139549568512
6016,0.6057,6,2,6,674587,1857,123370,2886,0.014708211886959827,0.6084756483238457
6017,0.6058,7,6,7,674593,1851,123377,2879,0.014660689392979343,0.6086680761099366
6018,0.6059,5,5,5,674598,1846,123382,2874,0.014621087314662273,0.6088983050847457
6019,0.606,6,1,6,674599,1845,123388,2868,0.01461316689899886,0.6085295989815405
6020,0.6061,5,4,5,674603,1841,123393,2863,0.014581485236345204,0.6086309523809523
6021,0.6062,5,3,5,674606,1838,123398,2858,0.01455772398935496,0.608603066439523
6022,0.6063,3,1,3,674607,1837,123401,2855,0.014549803573691547,0.6084825234441603
6023,0.6064,1,4,1,674611,1833,123402,2854,0.014518121911037891,0.6089182846170258
6024,0.6065,2,5,2,674616,1828,123404,2852,0.014478519832720822,0.6094017094017095
6025,0.6066,7,3,7,674619,1825,123411,2845,0.014454758585730578,0.6092077087794433
6026,0.6067,6,2,6,674621,1823,123417,2839,0.01443891775440375,0.6089661089661089
6027,0.6068,4,2,4,674623,1821,123421,2835,0.014423076923076924,0.6088917525773195
6028,0.6069,6,1,6,674624,1820,123427,2829,0.014415156507413509,0.6085179608517961
6029,0.607,6,8,6,674632,1812,123433,2823,0.014351793182106196,0.6090614886731391
6030,0.6071,2,1,2,674633,1811,123435,2821,0.014343872766442783,0.6090241796200345
6031,0.6072,1,4,1,674637,1807,123436,2820,0.014312191103789127,0.6094661767884159
6032,0.6073,3,6,3,674643,1801,123439,2817,0.014264668609808642,0.6100043308791685
6033,0.6074,2,6,2,674649,1795,123441,2815,0.01421714611582816,0.6106290672451193
6034,0.6075,4,4,4,674653,1791,123445,2811,0.014185464453174503,0.6108213820078227
6035,0.6076,5,2,5,674655,1789,123450,2806,0.014169623621847675,0.6106637649619151
6036,0.6077,2,2,2,674657,1787,123452,2804,0.014153782790520847,0.6107601829666739
6037,0.6078,1,2,1,674659,1785,123453,2803,0.014137941959194019,0.6109415867480383
6038,0.6079,6,2,6,674661,1783,123459,2797,0.01412210112786719,0.6106986899563319
6039,0.608,4,4,4,674665,1779,123463,2793,0.014090419465213534,0.6108923884514436
6040,0.6081,3,3,3,674668,1776,123466,2790,0.014066658218223293,0.6110381077529566
6041,0.6082,2,5,2,674673,1771,123468,2788,0.014027056139906222,0.611537617898662
6042,0.6083,1,0,1,674673,1771,123469,2787,0.014027056139906222,0.6114523913997367
6043,0.6084,2,2,2,674675,1769,123471,2785,0.014011215308579393,0.6115502854633289
6044,0.6085,5,2,5,674677,1767,123476,2780,0.013995374477252567,0.6113921266769299
6045,0.6086,1,1,1,674678,1766,123477,2779,0.013987454061589152,0.6114411441144114
6046,0.6087,6,2,6,674680,1764,123483,2773,0.013971613230262324,0.6111968260965396
6047,0.6088,2,3,2,674683,1761,123485,2771,0.013947851983272083,0.6114298323036187
6048,0.6089,1,8,1,674691,1753,123486,2770,0.01388448865796477,0.6124253813840371
6049,0.609,4,5,4,674696,1748,123490,2766,0.0138448865796477,0.6127603012848915
6050,0.6091,2,1,2,674697,1747,123492,2764,0.013836966163984285,0.612724451341166
6051,0.6092,3,1,3,674698,1746,123495,2761,0.013829045748320872,0.6126026181495452
6052,0.6093,0,3,0,674701,1743,123495,2761,0.013805284501330629,0.6130106571936057
6053,0.6094,2,3,2,674704,1740,123497,2759,0.013781523254340388,0.613247388308513
6054,0.6095,0,4,0,674708,1736,123497,2759,0.013749841591686731,0.6137931034482759
6055,0.6096,6,2,6,674710,1734,123503,2753,0.013734000760359903,0.6135502562959662
6056,0.6097,5,3,5,674713,1731,123508,2748,0.013710239513369662,0.6135298057602143
6057,0.6098,0,3,0,674716,1728,123508,2748,0.01368647826637942,0.613941018766756
6058,0.6099,1,0,1,674716,1728,123509,2747,0.01368647826637942,0.613854748603352
6059,0.61,3,4,3,674720,1724,123512,2744,0.013654796603725764,0.6141450313339302
6060,0.6101,3,4,3,674724,1720,123515,2741,0.013623114941072108,0.6144362250616454
6061,0.6102,0,3,0,674727,1717,123515,2741,0.013599353694081865,0.6148497083894123
6062,0.6103,3,4,3,674731,1713,123518,2738,0.01356767203142821,0.6151426645697596
6063,0.6104,2,6,2,674737,1707,123520,2736,0.013520149537447726,0.6158001350438893
6064,0.6105,5,1,5,674738,1706,123525,2731,0.01351222912178431,0.6155059725039441
6065,0.6106,0,2,0,674740,1704,123525,2731,0.013496388290457483,0.6157835400225479
6066,0.6107,5,4,5,674744,1700,123530,2726,0.013464706627803828,0.6159060099412562
6067,0.6108,2,3,2,674747,1697,123532,2724,0.013440945380813585,0.6161501922641937
6068,0.6109,3,5,3,674752,1692,123535,2721,0.013401343302496515,0.6165873555404486
6069,0.611,5,2,5,674754,1690,123540,2716,0.013385502471169687,0.616432137993645
6070,0.6111,1,5,1,674759,1685,123541,2715,0.013345900392852618,0.6170454545454546
6071,0.6112,1,6,1,674765,1679,123542,2714,0.013298377898872133,0.6178010471204188
6072,0.6113,6,3,6,674768,1676,123548,2708,0.01327461665188189,0.6177007299270073
6073,0.6114,3,1,3,674769,1675,123551,2705,0.013266696236218477,0.617579908675799
6074,0.6115,6,2,6,674771,1673,123557,2699,0.013250855404891649,0.6173376029277219
6075,0.6116,5,3,5,674774,1670,123562,2694,0.013227094157901407,0.6173235563703025
6076,0.6117,8,4,8,674778,1666,123570,2686,0.013195412495247751,0.6171875
6077,0.6118,5,1,5,674779,1665,123575,2681,0.013187492079584336,0.616889093419236
6078,0.6119,2,2,2,674781,1663,123577,2679,0.013171651248257508,0.6169967756794104
6079,0.612,2,2,2,674783,1661,123579,2677,0.013155810416930681,0.6171046565237437
6080,0.6121,2,0,2,674783,1661,123581,2675,0.013155810416930681,0.6169280442804428
6081,0.6122,4,2,4,674785,1659,123585,2671,0.013139969585603853,0.6168591224018476
6082,0.6123,2,2,2,674787,1657,123587,2669,0.013124128754277025,0.6169671752196024
6083,0.6124,3,2,3,674789,1655,123590,2666,0.013108287922950197,0.6169868086091183
6084,0.6125,3,2,3,674791,1653,123593,2663,0.013092447091623369,0.6170064874884152
6085,0.6126,7,1,7,674792,1652,123600,2656,0.013084526675959954,0.61652739090065
6086,0.6127,2,2,2,674794,1650,123602,2654,0.013068685844633126,0.616635687732342
6087,0.6128,0,1,0,674795,1649,123602,2654,0.013060765428969712,0.6167789914013478
6088,0.6129,3,2,3,674797,1647,123605,2651,0.013044924597642884,0.6167985109353188
6089,0.613,2,1,2,674798,1646,123607,2649,0.013037004181979471,0.6167636786961583
6090,0.6131,3,2,3,674800,1644,123610,2646,0.013021163350652643,0.6167832167832168
6091,0.6132,2,2,2,674802,1642,123612,2644,0.013005322519325815,0.6168922071861875
6092,0.6133,4,2,4,674804,1640,123616,2640,0.012989481687998987,0.616822429906542
6093,0.6134,3,1,3,674805,1639,123619,2637,0.012981561272335572,0.6166978484565014
6094,0.6135,3,3,3,674808,1636,123622,2634,0.01295780002534533,0.6168618266978922
6095,0.6136,3,4,3,674812,1632,123625,2631,0.012926118362691674,0.6171710063335679
6096,0.6137,4,3,4,674815,1629,123629,2627,0.012902357115701433,0.6172462406015038
6097,0.6138,6,1,6,674816,1628,123635,2621,0.012894436700038018,0.6168510237702989
6098,0.6139,4,4,4,674820,1624,123639,2617,0.012862755037384361,0.6170714454138175
6099,0.614,5,3,5,674823,1621,123644,2612,0.01283899379039412,0.6170564611386723
6100,0.6141,5,2,5,674825,1619,123649,2607,0.012823152959067292,0.6168954093705632
6101,0.6142,6,3,6,674828,1616,123655,2601,0.01279939171207705,0.6167891866255631
6102,0.6143,0,5,0,674833,1611,123655,2601,0.012759789633759979,0.6175213675213675
6103,0.6144,2,2,2,674835,1609,123657,2599,0.012743948802433151,0.6176330798479087
6104,0.6145,6,5,6,674840,1604,123663,2593,0.012704346724116081,0.6178222539909459
6105,0.6146,1,2,1,674842,1602,123664,2592,0.012688505892789253,0.6180257510729614
6106,0.6147,2,1,2,674843,1601,123666,2590,0.01268058547712584,0.6179909329515628
6107,0.6148,5,3,5,674846,1598,123671,2585,0.012656824230135597,0.6179775280898876
6108,0.6149,3,5,3,674851,1593,123674,2582,0.012617222151818527,0.6184431137724551
6109,0.615,3,2,3,674853,1591,123677,2579,0.0126013813204917,0.6184652278177458
6110,0.6151,3,2,3,674855,1589,123680,2576,0.012585540489164871,0.6184873949579832
6111,0.6152,1,2,1,674857,1587,123681,2575,0.012569699657838043,0.618692936088419
6112,0.6153,5,0,5,674857,1587,123686,2570,0.012569699657838043,0.6182343035843156
6113,0.6154,3,1,3,674858,1586,123689,2567,0.01256177924217463,0.6181073922465687
6114,0.6155,4,0,4,674858,1586,123693,2563,0.01256177924217463,0.6177392142684984
6115,0.6156,1,3,1,674861,1583,123694,2562,0.012538017995184387,0.6180940892641738
6116,0.6157,2,2,2,674863,1581,123696,2560,0.012522177163857558,0.6182081622796426
6117,0.6158,2,1,2,674864,1580,123698,2558,0.012514256748194145,0.6181730304494925
6118,0.6159,2,0,2,674864,1580,123700,2556,0.012514256748194145,0.6179883945841392
6119,0.616,1,3,1,674867,1577,123701,2555,0.012490495501203904,0.6183446272991288
6120,0.6161,6,1,6,674868,1576,123707,2549,0.012482575085540489,0.6179393939393939
6121,0.6162,1,3,1,674871,1573,123708,2548,0.012458813838550247,0.6182965299684543
6122,0.6163,5,0,5,674871,1573,123713,2543,0.012458813838550247,0.6178328474246841
6123,0.6164,3,3,3,674874,1570,123716,2540,0.012435052591560004,0.6180048661800487
6124,0.6165,2,6,2,674880,1564,123718,2538,0.012387530097579522,0.6187225743539737
6125,0.6166,2,2,2,674882,1562,123720,2536,0.012371689266252693,0.618838457784285
6126,0.6167,4,0,4,674882,1562,123724,2532,0.012371689266252693,0.618466047874939
6127,0.6168,3,0,3,674882,1562,123727,2529,0.012371689266252693,0.6181862625274994
6128,0.6169,2,2,2,674884,1560,123729,2527,0.012355848434925865,0.61830193295816
6129,0.617,3,3,3,674887,1557,123732,2524,0.012332087187935622,0.6184758637588826
6130,0.6171,6,3,6,674890,1554,123738,2518,0.01230832594094538,0.6183693516699411
6131,0.6172,1,2,1,674892,1552,123739,2517,0.012292485109618553,0.6185795035635291
6132,0.6173,3,4,3,674896,1548,123742,2514,0.012260803446964896,0.6189069423929099
6133,0.6174,3,4,3,674900,1544,123745,2511,0.01222912178431124,0.6192355117139334
6134,0.6175,3,7,3,674907,1537,123748,2508,0.012173678874667342,0.6200247218788628
6135,0.6176,2,0,2,674907,1537,123750,2506,0.012173678874667342,0.6198367548849864
6136,0.6177,5,4,5,674911,1533,123755,2501,0.012141997212013686,0.619980168567179
6137,0.6178,6,0,6,674911,1533,123761,2495,0.012141997212013686,0.6194141012909633
6138,0.6179,1,2,1,674913,1531,123762,2494,0.012126156380686858,0.6196273291925466
6139,0.618,5,2,5,674915,1529,123767,2489,0.01211031554936003,0.619462419113987
6140,0.6181,1,1,1,674916,1528,123768,2488,0.012102395133696616,0.6195219123505976
6141,0.6182,5,2,5,674918,1526,123773,2483,0.012086554302369788,0.6193564479920179
6142,0.6183,3,2,3,674920,1524,123776,2480,0.01207071347104296,0.6193806193806194
6143,0.6184,3,3,3,674923,1521,123779,2477,0.012046952224052719,0.6195597798899449
6144,0.6185,3,2,3,674925,1519,123782,2474,0.01203111139272589,0.6195842724768345
6145,0.6186,3,4,3,674929,1515,123785,2471,0.011999429730072234,0.619919719016558
6146,0.6187,1,3,1,674932,1512,123786,2470,0.011975668483081993,0.6202913108990457
6147,0.6188,3,3,3,674935,1509,123789,2467,0.01195190723609175,0.6204728370221329
6148,0.6189,1,0,1,674935,1509,123790,2466,0.01195190723609175,0.6203773584905661
6149,0.619,4,3,4,674938,1506,123794,2462,0.011928145989101508,0.6204637096774194
6150,0.6191,4,0,4,674938,1506,123798,2458,0.011928145989101508,0.6200807265388496
6151,0.6192,2,0,2,674938,1506,123800,2456,0.011928145989101508,0.6198889449772842
6152,0.6193,4,3,4,674941,1503,123804,2452,0.011904384742111265,0.6199747155499368
6153,0.6195,4,0,4,674941,1503,123808,2448,0.011904384742111265,0.6195899772209568
6154,0.6196,7,3,7,674944,1500,123815,2441,0.011880623495121024,0.6193859426541487
6155,0.6197,3,3,3,674947,1497,123818,2438,0.011856862248130783,0.6195679796696315
6156,0.6198,4,5,4,674952,1492,123822,2434,0.011817260169813711,0.6199694345389709
6157,0.6199,4,4,4,674956,1488,123826,2430,0.011785578507160055,0.6202143950995406
6158,0.62,2,1,2,674957,1487,123828,2428,0.011777658091496642,0.6201787994891443
6159,0.6201,2,1,2,674958,1486,123830,2426,0.011769737675833229,0.6201431492842536
6160,0.6202,0,2,0,674960,1484,123830,2426,0.0117538968445064,0.620460358056266
6161,0.6203,3,3,3,674963,1481,123833,2423,0.011730135597516157,0.6206454918032787
6162,0.6204,2,1,2,674964,1480,123835,2421,0.011722215181852744,0.6206100999743656
6163,0.6205,1,1,1,674965,1479,123836,2420,0.011714294766189329,0.6206719671710695
6164,0.6206,2,3,2,674968,1476,123838,2418,0.011690533519199088,0.6209553158705701
6165,0.6207,2,4,2,674972,1472,123840,2416,0.011658851856545431,0.6213991769547325
6166,0.6208,3,2,3,674974,1470,123843,2413,0.011643011025218603,0.6214267319083183
6167,0.6209,5,6,5,674980,1464,123848,2408,0.011595488531238119,0.621900826446281
6168,0.621,3,3,3,674983,1461,123851,2405,0.011571727284247877,0.6220900155199173
6169,0.6211,3,2,3,674985,1459,123854,2402,0.01155588645292105,0.6221186221186221
6170,0.6212,1,5,1,674990,1454,123855,2401,0.01151628437460398,0.6228274967574579
6171,0.6213,1,4,1,674994,1450,123856,2400,0.011484602711950323,0.6233766233766234
6172,0.6214,3,2,3,674996,1448,123859,2397,0.011468761880623495,0.623407022106632
6173,0.6215,3,1,3,674997,1447,123862,2394,0.01146084146496008,0.623275188752929
6174,0.6216,5,2,5,674999,1445,123867,2389,0.011445000633633254,0.6231090245174752
6175,0.6217,0,1,0,675000,1444,123867,2389,0.011437080217969839,0.6232715888338116
6176,0.6218,2,5,2,675005,1439,123869,2387,0.01139747813965277,0.6238891792995296
6177,0.6219,2,2,2,675007,1437,123871,2385,0.011381637308325941,0.6240188383045526
6178,0.622,3,2,3,675009,1435,123874,2382,0.011365796476999113,0.6240503012837306
6179,0.6221,3,2,3,675011,1433,123877,2379,0.011349955645672285,0.6240818467995802
6180,0.6222,4,2,4,675013,1431,123881,2375,0.011334114814345457,0.6240147136100893
6181,0.6223,4,2,4,675015,1429,123885,2371,0.011318273983018629,0.6239473684210526
6182,0.6224,1,2,1,675017,1427,123886,2370,0.0113024331516918,0.6241769818277587
6183,0.6225,6,0,6,675017,1427,123892,2364,0.0113024331516918,0.6235821682933262
6184,0.6226,2,3,2,675020,1424,123894,2362,0.011278671904701559,0.623877443211833
6185,0.6227,2,3,2,675023,1421,123896,2360,0.011254910657711316,0.624173499074319
6186,0.6228,3,3,3,675026,1418,123899,2357,0.011231149410721075,0.6243708609271523
6187,0.6229,8,5,8,675031,1413,123907,2349,0.011191547332404005,0.6244019138755981
6188,0.623,2,1,2,675032,1412,123909,2347,0.01118362691674059,0.6243681830274009
6189,0.6231,3,4,3,675036,1408,123912,2344,0.011151945254086934,0.6247334754797441
6190,0.6232,2,3,2,675039,1405,123914,2342,0.011128184007096692,0.6250333600213505
6191,0.6233,5,1,5,675040,1404,123919,2337,0.011120263591433279,0.6246992782678428
6192,0.6234,7,1,7,675041,1403,123926,2330,0.011112343175769864,0.6241628716849719
6193,0.6235,4,2,4,675043,1401,123930,2326,0.011096502344443036,0.6240944459350685
6194,0.6236,3,3,3,675046,1398,123933,2323,0.011072741097452795,0.624294544477291
6195,0.6237,3,4,3,675050,1394,123936,2320,0.011041059434799138,0.624663435648896
6196,0.6238,3,1,3,675051,1393,123939,2317,0.011033139019135725,0.6245283018867924
6197,0.6239,4,2,4,675053,1391,123943,2313,0.011017298187808897,0.6244600431965442
6198,0.624,4,1,4,675054,1390,123947,2309,0.011009377772145482,0.6242227629088943
6199,0.6241,1,2,1,675056,1388,123948,2308,0.010993536940818654,0.6244588744588745
6200,0.6242,6,3,6,675059,1385,123954,2302,0.010969775693828412,0.62435584486032
6201,0.6243,5,3,5,675062,1382,123959,2297,0.01094601444683817,0.62435444414243
6202,0.6244,1,5,1,675067,1377,123960,2296,0.0109064123685211,0.6251020963789817
6203,0.6245,4,1,4,675068,1376,123964,2292,0.010898491952857687,0.6248636859323882
6204,0.6246,1,3,1,675071,1373,123965,2291,0.010874730705867443,0.6252729257641921
6205,0.6247,1,4,1,675075,1369,123966,2290,0.010843049043213787,0.6258540584859251
6206,0.6248,0,2,0,675077,1367,123966,2290,0.010827208211886959,0.626196335794367
6207,0.6249,2,1,2,675078,1366,123968,2288,0.010819287796223546,0.6261631089217297
6208,0.625,3,2,3,675080,1364,123971,2285,0.010803446964896718,0.6261989586187997
6209,0.6251,4,5,4,675085,1359,123975,2281,0.010763844886579648,0.6266483516483516
6210,0.6252,4,3,4,675088,1356,123979,2277,0.010740083639589405,0.6267547481420314
6211,0.6253,2,3,2,675091,1353,123981,2275,0.010716322392599164,0.6270672546857773
6212,0.6254,1,2,1,675093,1351,123982,2274,0.010700481561272335,0.6273103448275862
6213,0.6255,3,2,3,675095,1349,123985,2271,0.010684640729945507,0.6273480662983425
6214,0.6256,2,2,2,675097,1347,123987,2269,0.010668799898618679,0.6274889380530974
6215,0.6257,4,2,4,675099,1345,123991,2265,0.010652959067291851,0.6274238227146814
6216,0.6258,2,1,2,675100,1344,123993,2263,0.010645038651628438,0.6273911838092597
6217,0.6259,2,3,2,675103,1341,123995,2261,0.010621277404638195,0.6277068295391449
6218,0.626,2,4,2,675107,1337,123997,2259,0.01058959574198454,0.6281979977753059
6219,0.6261,1,2,1,675109,1335,123998,2258,0.010573754910657712,0.6284441970498191
6220,0.6262,2,2,2,675111,1333,124000,2256,0.010557914079330884,0.6285873502368348
6221,0.6263,5,0,5,675111,1333,124005,2251,0.010557914079330884,0.6280691964285714
6222,0.6264,3,2,3,675113,1331,124008,2248,0.010542073248004056,0.6281084101704387
6223,0.6265,5,4,5,675117,1327,124013,2243,0.0105103915853504,0.6282913165266106
6224,0.6266,6,2,6,675119,1325,124019,2237,0.010494550754023571,0.6280179674340258
6225,0.6267,2,1,2,675120,1324,124021,2235,0.010486630338360158,0.6279853891542568
6226,0.6268,3,0,3,675120,1324,124024,2232,0.010486630338360158,0.6276715410573678
6227,0.6269,7,2,7,675122,1322,124031,2225,0.01047078950703333,0.6272906681702848
6228,0.627,1,3,1,675125,1319,124032,2224,0.010447028260043087,0.6277166243296641
6229,0.6271,1,0,1,675125,1319,124033,2223,0.010447028260043087,0.6276115189158668
6230,0.6272,4,1,4,675126,1318,124037,2219,0.010439107844379673,0.6273678258411083
6231,0.6273,2,3,2,675129,1315,124039,2217,0.01041534659738943,0.6276896942242356
6232,0.6274,2,2,2,675131,1313,124041,2215,0.010399505766062602,0.6278344671201814
6233,0.6275,0,2,0,675133,1311,124041,2215,0.010383664934735776,0.6281905842314237
6234,0.6276,3,0,3,675133,1311,124044,2212,0.010383664934735776,0.6278739710474028
6235,0.6277,2,1,2,675134,1310,124046,2210,0.01037574451907236,0.6278409090909091
6236,0.6278,5,5,5,675139,1305,124051,2205,0.010336142440755291,0.6282051282051282
6237,0.6279,3,0,3,675139,1305,124054,2202,0.010336142440755291,0.6278870829769033
6238,0.628,4,0,4,675139,1305,124058,2198,0.010336142440755291,0.6274621752783328
6239,0.6281,2,1,2,675140,1304,124060,2196,0.010328222025091876,0.6274285714285714
6240,0.6282,1,4,1,675144,1300,124061,2195,0.01029654036243822,0.6280400572246065
6241,0.6283,1,1,1,675145,1299,124062,2194,0.010288619946774807,0.6281133695963356
6242,0.6284,0,1,0,675146,1298,124062,2194,0.010280699531111393,0.6282932416953035
6243,0.6285,2,1,2,675147,1297,124064,2192,0.010272779115447979,0.6282602464889653
6244,0.6286,4,1,4,675148,1296,124068,2188,0.010264858699784565,0.6280137772675086
6245,0.6287,2,2,2,675150,1294,124070,2186,0.010249017868457737,0.6281609195402299
6246,0.6288,6,3,6,675153,1291,124076,2180,0.010225256621467494,0.6280610774992798
6247,0.6289,3,0,3,675153,1291,124079,2177,0.010225256621467494,0.6277393310265282
6248,0.629,2,2,2,675155,1289,124081,2175,0.010209415790140666,0.6278868360277137
6249,0.6291,5,0,5,675155,1289,124086,2170,0.010209415790140666,0.6273489447817289
6250,0.6292,3,1,3,675156,1288,124089,2167,0.010201495374477253,0.6272069464544139
6251,0.6293,0,1,0,675157,1287,124089,2167,0.010193574958813838,0.6273885350318471
6252,0.6294,4,3,4,675160,1284,124093,2163,0.010169813711823596,0.6275021758050479
6253,0.6295,7,6,7,675166,1278,124100,2156,0.010122291217843112,0.6278392545136867
6254,0.6296,4,1,4,675167,1277,124104,2152,0.010114370802179699,0.6275882181393992
6255,0.6297,3,1,3,675168,1276,124107,2149,0.010106450386516284,0.6274452554744525
6256,0.6298,5,1,5,675169,1275,124112,2144,0.01009852997085287,0.6270839426732963
6257,0.6299,2,3,2,675172,1272,124114,2142,0.010074768723862629,0.6274165202108963
6258,0.63,2,5,2,675177,1267,124116,2140,0.010035166645545558,0.6281185793953625
6259,0.6301,3,3,3,675180,1264,124119,2137,0.010011405398555316,0.6283446045280799
6260,0.6302,3,3,3,675183,1261,124122,2134,0.009987644151565073,0.6285714285714286
6261,0.6303,3,2,3,675185,1259,124125,2131,0.009971803320238247,0.6286135693215339
6262,0.6304,1,4,1,675189,1255,124126,2130,0.00994012165758459,0.6292466765140325
6263,0.6305,5,1,5,675190,1254,124131,2125,0.009932201241921176,0.6288842852915064
6264,0.6306,3,2,3,675192,1252,124134,2122,0.009916360410594348,0.6289270895080024
6265,0.6307,2,3,2,675195,1249,124136,2120,0.009892599163604106,0.6292668447610567
6266,0.6308,0,2,0,675197,1247,124136,2120,0.009876758332277278,0.6296406296406296
6267,0.6309,3,1,3,675198,1246,124139,2117,0.009868837916613863,0.6294974724947963
6268,0.631,4,1,4,675199,1245,124143,2113,0.00986091750095045,0.6292435973793925
6269,0.6311,5,2,5,675201,1243,124148,2108,0.009845076669623622,0.6290659504625485
6270,0.6312,3,2,3,675203,1241,124151,2105,0.009829235838296793,0.6291093843395099
6271,0.6313,3,1,3,675204,1240,124154,2102,0.00982131542263338,0.6289646918013165
6272,0.6314,3,3,3,675207,1237,124157,2099,0.009797554175643137,0.6291966426858513
6273,0.6315,2,1,2,675208,1236,124159,2097,0.009789633759979724,0.6291629162916291
6274,0.6316,0,3,0,675211,1233,124159,2097,0.00976587251298948,0.6297297297297297
6275,0.6317,2,4,2,675215,1229,124161,2095,0.009734190850335826,0.6302647412755716
6276,0.6318,3,1,3,675216,1228,124164,2092,0.009726270434672411,0.6301204819277109
6277,0.6319,2,3,2,675219,1225,124166,2090,0.00970250918768217,0.6304675716440422
6278,0.632,2,1,2,675220,1224,124168,2088,0.009694588772018755,0.6304347826086957
6279,0.6321,1,1,1,675221,1223,124169,2087,0.009686668356355342,0.6305135951661631
6280,0.6322,4,4,4,675225,1219,124173,2083,0.009654986693701685,0.6308298001211387
6281,0.6323,2,3,2,675228,1216,124175,2081,0.009631225446711444,0.6311798604792236
6282,0.6324,4,2,4,675230,1214,124179,2077,0.009615384615384616,0.63111516256457
6283,0.6325,4,3,4,675233,1211,124183,2073,0.009591623368394373,0.6312423873325214
6284,0.6326,2,0,2,675233,1211,124185,2071,0.009591623368394373,0.6310176721511274
6285,0.6327,4,2,4,675235,1209,124189,2067,0.009575782537067545,0.6309523809523809
6286,0.6328,1,3,1,675238,1206,124190,2066,0.009552021290077303,0.6314180929095354
6287,0.6329,3,0,3,675238,1206,124193,2063,0.009552021290077303,0.631079840929948
6288,0.633,3,5,3,675243,1201,124196,2060,0.009512419211760234,0.631708065010733
6289,0.6331,3,3,3,675246,1198,124199,2057,0.00948865796476999,0.6319508448540707
6290,0.6332,1,1,1,675247,1197,124200,2056,0.009480737549106577,0.6320319704887796
6291,0.6333,6,1,6,675248,1196,124206,2050,0.009472817133443162,0.6315465187923598
6292,0.6334,1,1,1,675249,1195,124207,2049,0.00946489671777975,0.6316276202219482
6293,0.6335,1,2,1,675251,1193,124208,2048,0.009449055886452921,0.6319037334156125
6294,0.6336,3,4,3,675255,1189,124211,2045,0.009417374223799265,0.6323438466295609
6295,0.6337,1,2,1,675257,1187,124212,2044,0.009401533392472437,0.6326214794181368
6296,0.6338,2,3,2,675260,1184,124214,2042,0.009377772145482195,0.6329820210787352
6297,0.6339,2,1,2,675261,1183,124216,2040,0.00936985172981878,0.63295066708036
6298,0.634,3,1,3,675262,1182,124219,2037,0.009361931314155367,0.6328052190121156
6299,0.6341,2,4,2,675266,1178,124221,2035,0.00933024965150171,0.6333644568938687
6300,0.6342,3,4,3,675270,1174,124224,2032,0.009298567988848054,0.6338116032439176
6301,0.6343,7,1,7,675271,1173,124231,2025,0.009290647573184641,0.6332082551594747
6302,0.6344,4,3,4,675274,1170,124235,2021,0.009266886326194398,0.6333437793795048
6303,0.6345,3,3,3,675277,1167,124238,2018,0.009243125079204157,0.6335949764521193
6304,0.6346,4,0,4,675277,1167,124242,2014,0.009243125079204157,0.6331342345174473
6305,0.6347,0,3,0,675280,1164,124242,2014,0.009219363832213915,0.6337319068596602
6306,0.6348,2,1,2,675281,1163,124244,2012,0.0092114434165505,0.6337007874015748
6307,0.6349,2,1,2,675282,1162,124246,2010,0.009203523000887087,0.6336696090794451
6308,0.635,1,0,1,675282,1162,124247,2009,0.009203523000887087,0.6335540838852097
6309,0.6351,3,0,3,675282,1162,124250,2006,0.009203523000887087,0.6332070707070707
6310,0.6352,1,1,1,675283,1161,124251,2005,0.009195602585223672,0.633291219204043
6311,0.6353,5,2,5,675285,1159,124256,2000,0.009179761753896844,0.6331117442228553
6312,0.6354,1,1,1,675286,1158,124257,1999,0.009171841338233431,0.6331960722204625
6313,0.6355,3,1,3,675287,1157,124260,1996,0.009163920922570016,0.6330478908975579
6314,0.6356,4,2,4,675289,1155,124264,1992,0.009148080091243188,0.6329837940896091
6315,0.6357,1,0,1,675289,1155,124265,1991,0.009148080091243188,0.6328671328671329
6316,0.6358,3,5,3,675294,1150,124268,1988,0.009108478012926118,0.6335245379222435
6317,0.6359,3,3,3,675297,1147,124271,1985,0.009084716765935877,0.6337803320561941
6318,0.636,3,2,3,675299,1145,124274,1982,0.009068875934609049,0.6338343460185482
6319,0.6361,4,2,4,675301,1143,124278,1978,0.00905303510328222,0.6337712271707786
6320,0.6362,4,1,4,675302,1142,124282,1974,0.009045114687618806,0.6335044929396663
6321,0.6363,3,2,3,675304,1140,124285,1971,0.009029273856291977,0.6335583413693346
6322,0.6364,3,3,3,675307,1137,124288,1968,0.009005512609301736,0.633816425120773
6323,0.6366,2,1,2,675308,1136,124290,1966,0.008997592193638323,0.6337846550612508
6324,0.6367,4,4,4,675312,1132,124294,1962,0.008965910530984667,0.6341305753070459
6325,0.6368,2,2,2,675314,1130,124296,1960,0.008950069699657838,0.6343042071197411
6326,0.6369,3,1,3,675315,1129,124299,1957,0.008942149283994423,0.6341542449773169
6327,0.637,4,0,4,675315,1129,124303,1953,0.008942149283994423,0.6336794289422453
6328,0.6371,4,1,4,675316,1128,124307,1949,0.00893422886833101,0.6334091647708807
6329,0.6372,5,1,5,675317,1127,124312,1944,0.008926308452667595,0.6330185607294041
6330,0.6373,3,5,3,675322,1122,124315,1941,0.008886706374350526,0.633692458374143
6331,0.6374,5,0,5,675322,1122,124320,1936,0.008886706374350526,0.6330935251798561
6332,0.6375,3,1,3,675323,1121,124323,1933,0.008878785958687112,0.6329404060248854
6333,0.6376,1,1,1,675324,1120,124324,1932,0.008870865543023698,0.6330275229357798
6334,0.6377,4,4,4,675328,1116,124328,1928,0.008839183880370041,0.633377135348226
6335,0.6378,2,3,2,675331,1113,124330,1926,0.0088154226333798,0.633761105626851
6336,0.6379,3,2,3,675333,1111,124333,1923,0.008799581802052972,0.6338167435728411
6337,0.638,1,4,1,675337,1107,124334,1922,0.008767900139399315,0.6345328491251238
6338,0.6381,4,2,4,675339,1105,124338,1918,0.008752059308072487,0.6344690704598082
6339,0.6382,4,2,4,675341,1103,124342,1914,0.008736218476745659,0.6344050381173351
6340,0.6383,1,0,1,675341,1103,124343,1913,0.008736218476745659,0.6342838196286472
6341,0.6384,4,2,4,675343,1101,124347,1909,0.008720377645418831,0.63421926910299
6342,0.6385,0,2,0,675345,1099,124347,1909,0.008704536814092003,0.6346409574468085
6343,0.6386,8,1,8,675346,1098,124355,1901,0.00869661639842859,0.6338779593197733
6344,0.6387,3,0,3,675346,1098,124358,1898,0.00869661639842859,0.6335113484646195
6345,0.6388,2,4,2,675350,1094,124360,1896,0.008664934735774933,0.6341137123745819
6346,0.6389,5,2,5,675352,1092,124365,1891,0.008649093904448105,0.6339255782769024
6347,0.639,2,0,2,675352,1092,124367,1889,0.008649093904448105,0.633679973163368
6348,0.6391,3,1,3,675353,1091,124370,1886,0.008641173488784692,0.633523681558616
6349,0.6392,2,4,2,675357,1087,124372,1884,0.008609491826131035,0.6341299225849882
6350,0.6393,5,1,5,675358,1086,124377,1879,0.00860157141046762,0.6337268128161889
6351,0.6394,1,3,1,675361,1083,124378,1878,0.00857781016347738,0.6342451874366768
6352,0.6395,3,1,3,675362,1082,124381,1875,0.008569889747813966,0.6340886033141697
6353,0.6396,2,4,2,675366,1078,124383,1873,0.00853820808516031,0.6347001016604541
6354,0.6397,0,1,0,675367,1077,124383,1873,0.008530287669496895,0.6349152542372881
6355,0.6398,2,1,2,675368,1076,124385,1871,0.008522367253833481,0.6348829317950458
6356,0.6399,3,3,3,675371,1073,124388,1868,0.008498606006843238,0.6351581094865691
6357,0.64,4,2,4,675373,1071,124392,1864,0.008482765175516412,0.6350936967632027
6358,0.6401,1,1,1,675374,1070,124393,1863,0.008474844759852997,0.6351858165700648
6359,0.6402,3,3,3,675377,1067,124396,1860,0.008451083512862756,0.6354629313290058
6360,0.6403,4,5,4,675382,1062,124400,1856,0.008411481434545684,0.6360520904729267
6361,0.6404,3,3,3,675385,1059,124403,1853,0.008387720187555443,0.6363324175824175
6362,0.6405,2,5,2,675390,1054,124405,1851,0.008348118109238373,0.6371772805507745
6363,0.6406,3,1,3,675391,1053,124408,1848,0.008340197693574958,0.6370217166494312
6364,0.6407,3,1,3,675392,1052,124411,1845,0.008332277277911545,0.6368657231618916
6365,0.6408,4,0,4,675392,1052,124415,1841,0.008332277277911545,0.6363636363636364
6366,0.6409,1,1,1,675393,1051,124416,1840,0.00832435686224813,0.6364579730197164
6367,0.641,3,1,3,675394,1050,124419,1837,0.008316436446584717,0.6363006581226186
6368,0.6411,2,2,2,675396,1048,124421,1835,0.008300595615257889,0.6364897676031911
6369,0.6412,5,6,5,675402,1042,124426,1830,0.008253073121277404,0.6371866295264624
6370,0.6413,3,0,3,675402,1042,124429,1827,0.008253073121277404,0.6368072499128616
6371,0.6414,2,3,2,675405,1039,124431,1825,0.008229311874287163,0.6372206703910615
6372,0.6415,5,2,5,675407,1037,124436,1820,0.008213471042960335,0.6370318515925796
6373,0.6416,4,2,4,675409,1035,124440,1816,0.008197630211633507,0.6369694843914416
6374,0.6417,2,2,2,675411,1033,124442,1814,0.008181789380306679,0.6371619248331577
6375,0.6418,0,2,0,675413,1031,124442,1814,0.00816594854897985,0.637609841827768
6376,0.6419,1,4,1,675417,1027,124443,1813,0.008134266886326194,0.6383802816901408
6377,0.642,3,4,3,675421,1023,124446,1810,0.008102585223672538,0.6388986939639958
6378,0.6421,1,2,1,675423,1021,124447,1809,0.00808674439234571,0.6392226148409894
6379,0.6422,2,4,2,675427,1017,124449,1807,0.008055062729692055,0.6398725212464589
6380,0.6423,5,1,5,675428,1016,124454,1802,0.00804714231402864,0.6394606103619588
6381,0.6424,6,2,6,675430,1014,124460,1796,0.008031301482701812,0.6391459074733096
6382,0.6425,1,0,1,675430,1014,124461,1795,0.008031301482701812,0.6390174439302243
6383,0.6426,2,2,2,675432,1012,124463,1793,0.008015460651374984,0.6392156862745098
6384,0.6427,1,2,1,675434,1010,124464,1792,0.007999619820048156,0.6395431834403997
6385,0.6428,4,1,4,675435,1009,124468,1788,0.007991699404384742,0.6392563460850912
6386,0.6429,3,1,3,675436,1008,124471,1785,0.007983778988721327,0.6390977443609023
6387,0.643,4,5,4,675441,1003,124475,1781,0.007944176910404258,0.6397270114942529
6388,0.6431,2,1,2,675442,1002,124477,1779,0.007936256494740845,0.639697950377562
6389,0.6432,1,3,1,675445,999,124478,1778,0.007912495247750602,0.640259272596327
6390,0.6433,0,3,0,675448,996,124478,1778,0.00788873400076036,0.6409516943042538
6391,0.6434,0,1,0,675449,995,124478,1778,0.007880813585096945,0.6411828344752976
6392,0.6435,3,1,3,675450,994,124481,1775,0.007872893169433532,0.6410256410256411
6393,0.6436,4,4,4,675454,990,124485,1771,0.007841211506779876,0.6414342629482072
6394,0.6437,1,0,1,675454,990,124486,1770,0.007841211506779876,0.6413043478260869
6395,0.6438,5,3,5,675457,987,124491,1765,0.007817450259789634,0.6413517441860465
6396,0.6439,4,0,4,675457,987,124495,1761,0.007817450259789634,0.6408296943231441
6397,0.644,4,3,4,675460,984,124499,1757,0.007793689012799392,0.6410069317767239
6398,0.6441,5,0,5,675460,984,124504,1752,0.007793689012799392,0.6403508771929824
6399,0.6442,1,5,1,675465,979,124505,1751,0.007754086934482322,0.6413919413919414
6400,0.6443,4,2,4,675467,977,124509,1747,0.0077382461031554935,0.6413362701908958
6401,0.6444,1,3,1,675470,974,124510,1746,0.007714484856165251,0.6419117647058824
6402,0.6445,4,1,4,675471,973,124514,1742,0.007706564440501837,0.6416206261510129
6403,0.6446,6,4,6,675475,969,124520,1736,0.007674882777848182,0.6417744916820702
6404,0.6447,1,3,1,675478,966,124521,1735,0.0076511215308579395,0.6423546834505739
6405,0.6448,2,3,2,675481,963,124523,1733,0.007627360283867697,0.6428041543026706
6406,0.6449,0,1,0,675482,962,124523,1733,0.007619439868204283,0.6430426716141002
6407,0.645,2,2,2,675484,960,124525,1731,0.007603599036877455,0.6432552954292085
6408,0.6451,2,0,2,675484,960,124527,1729,0.007603599036877455,0.6429899590925995
6409,0.6452,1,3,1,675487,957,124528,1728,0.007579837789887214,0.6435754189944134
6410,0.6453,3,0,3,675487,957,124531,1725,0.007579837789887214,0.6431767337807607
6411,0.6454,1,3,1,675490,954,124532,1724,0.007556076542896971,0.643764002987304
6412,0.6455,3,1,3,675491,953,124535,1721,0.007548156127233557,0.643605086013463
6413,0.6456,2,1,2,675492,952,124537,1719,0.007540235711570143,0.6435791838262823
6414,0.6457,3,1,3,675493,951,124540,1716,0.007532315295906729,0.6434195725534309
6415,0.6458,3,0,3,675493,951,124543,1713,0.007532315295906729,0.6430180180180181
6416,0.6459,1,1,1,675494,950,124544,1712,0.007524394880243315,0.6431254695717505
6417,0.646,2,0,2,675494,950,124546,1710,0.007524394880243315,0.6428571428571429
6418,0.6461,3,1,3,675495,949,124549,1707,0.007516474464579901,0.6426957831325302
6419,0.6462,4,2,4,675497,947,124553,1703,0.007500633633253073,0.6426415094339623
6420,0.6463,4,4,4,675501,943,124557,1699,0.007468951970599417,0.6430734292202877
6421,0.6464,1,1,1,675502,942,124558,1698,0.007461031554936003,0.6431818181818182
6422,0.6465,1,1,1,675503,941,124559,1697,0.007453111139272589,0.6432903714935557
6423,0.6466,3,2,3,675505,939,124562,1694,0.007437270307945761,0.643372578807444
6424,0.6467,4,1,4,675506,938,124566,1690,0.007429349892282347,0.6430745814307458
6425,0.6468,3,1,3,675507,937,124569,1687,0.007421429476618933,0.6429115853658537
6426,0.6469,5,0,5,675507,937,124574,1682,0.007421429476618933,0.6422298587247041
6427,0.647,2,1,2,675508,936,124576,1680,0.007413509060955519,0.6422018348623854
6428,0.6471,3,1,3,675509,935,124579,1677,0.007405588645292105,0.6420367534456355
6429,0.6472,2,3,2,675512,932,124581,1675,0.0073818273983018625,0.6425009589566552
6430,0.6473,2,4,2,675516,928,124583,1673,0.007350145735648207,0.6432141484044598
6431,0.6474,1,3,1,675519,925,124584,1672,0.007326384488657965,0.6438197920677705
6432,0.6475,3,3,3,675522,922,124587,1669,0.0073026232416677226,0.6441528367425704
6433,0.6476,2,2,2,675524,920,124589,1667,0.007286782410340894,0.6443757247777349
6434,0.6477,2,2,2,675526,918,124591,1665,0.007270941579014066,0.6445993031358885
6435,0.6478,2,0,2,675526,918,124593,1663,0.007270941579014066,0.6443239054629989
6436,0.6479,2,2,2,675528,916,124595,1661,0.007255100747687239,0.6445479239425689
6437,0.648,0,3,0,675531,913,124595,1661,0.007231339500696997,0.6452991452991453
6438,0.6481,3,0,3,675531,913,124598,1658,0.007231339500696997,0.6448852586542202
6439,0.6482,2,0,2,675531,913,124600,1656,0.007231339500696997,0.6446087971973531
6440,0.6483,2,1,2,675532,912,124602,1654,0.007223419085033583,0.6445830085736555
6441,0.6484,5,2,5,675534,910,124607,1649,0.0072075782537067545,0.6443923407581086
6442,0.6485,2,4,2,675538,906,124609,1647,0.007175896591053098,0.645123384253819
6443,0.6486,2,2,2,675540,904,124611,1645,0.007160055759726271,0.6453511180855237
6444,0.6487,2,3,2,675543,901,124613,1643,0.007136294512736029,0.6458333333333334
6445,0.6488,2,2,2,675545,899,124615,1641,0.0071204536814092004,0.6460629921259843
6446,0.6489,1,3,1,675548,896,124616,1640,0.007096692434418958,0.6466876971608833
6447,0.649,2,1,2,675549,895,124618,1638,0.007088772018755544,0.6466640347414133
6448,0.6491,7,1,7,675550,894,124625,1631,0.00708085160309213,0.645940594059406
6449,0.6492,3,1,3,675551,893,124628,1628,0.007072931187428716,0.6457754859182864
6450,0.6493,1,2,1,675553,891,124629,1627,0.007057090356101888,0.6461477362986497
6451,0.6494,3,1,3,675554,890,124632,1624,0.007049169940438475,0.6459824980111376
6452,0.6495,4,1,4,675555,889,124636,1620,0.0070412495247750605,0.6456755679553607
6453,0.6496,4,2,4,675557,887,124640,1616,0.007025408693448232,0.6456252497003596
6454,0.6497,3,1,3,675558,886,124643,1613,0.007017488277784818,0.6454581832733093
6455,0.6498,1,1,1,675559,885,124644,1612,0.007009567862121404,0.645574689627553
6456,0.6499,0,2,0,675561,883,124644,1612,0.006993727030794576,0.6460921843687375
6457,0.65,3,3,3,675564,880,124647,1609,0.006969965783804334,0.6464443551627159
6458,0.6501,1,1,1,675565,879,124648,1608,0.00696204536814092,0.646562123039807
6459,0.6502,2,3,2,675568,876,124650,1606,0.006938284121150678,0.6470588235294118
6460,0.6503,2,1,2,675569,875,124652,1604,0.006930363705487264,0.6470350947962888
6461,0.6504,4,1,4,675570,874,124656,1600,0.00692244328982385,0.6467259498787389
6462,0.6505,2,0,2,675570,874,124658,1598,0.00692244328982385,0.6464401294498382
6463,0.6506,5,3,5,675573,871,124663,1593,0.006898682042833608,0.6465097402597403
6464,0.6507,1,1,1,675574,870,124664,1592,0.006890761627170194,0.6466287571080422
6465,0.6508,1,1,1,675575,869,124665,1591,0.00688284121150678,0.6467479674796748
6466,0.6509,2,2,2,675577,867,124667,1589,0.006867000380179952,0.6469869706840391
6467,0.651,2,2,2,675579,865,124669,1587,0.0068511595488531234,0.6472267536704731
6468,0.6511,1,0,1,675579,865,124670,1586,0.0068511595488531234,0.6470828233374133
6469,0.6512,4,1,4,675580,864,124674,1582,0.00684323913318971,0.6467702371218316
6470,0.6513,4,0,4,675580,864,124678,1578,0.00684323913318971,0.6461916461916462
6471,0.6514,2,1,2,675581,863,124680,1576,0.006835318717526296,0.6461664616646167
6472,0.6515,1,1,1,675582,862,124681,1575,0.006827398301862882,0.6462864177267131
6473,0.6516,2,0,2,675582,862,124683,1573,0.006827398301862882,0.6459958932238193
6474,0.6517,1,0,1,675582,862,124684,1572,0.006827398301862882,0.6458504519309778
6475,0.6518,6,0,6,675582,862,124690,1566,0.006827398301862882,0.6449752883031301
6476,0.6519,3,1,3,675583,861,124693,1563,0.006819477886199468,0.6448019801980198
6477,0.652,5,1,5,675584,860,124698,1558,0.006811557470536054,0.6443341604631927
6478,0.6521,2,4,2,675588,856,124700,1556,0.006779875807882398,0.6451077943615257
6479,0.6522,2,0,2,675588,856,124702,1554,0.006779875807882398,0.6448132780082988
6480,0.6523,2,3,2,675591,853,124704,1552,0.006756114560892155,0.6453222453222454
6481,0.6524,2,1,2,675592,852,124706,1550,0.006748194145228741,0.6452955870108243
6482,0.6525,2,2,2,675594,850,124708,1548,0.006732353313901914,0.6455379482902419
6483,0.6526,3,2,3,675596,848,124711,1545,0.006716512482575086,0.6456330965315503
6484,0.6527,2,3,2,675599,845,124713,1543,0.0066927512355848436,0.6461474036850922
6485,0.6528,1,1,1,675600,844,124714,1542,0.0066848308199214295,0.6462699077954736
6486,0.6529,1,1,1,675601,843,124715,1541,0.006676910404258015,0.6463926174496645
6487,0.653,2,1,2,675602,842,124717,1539,0.006668989988594601,0.6463670726585469
6488,0.6531,2,1,2,675603,841,124719,1537,0.006661069572931187,0.6463414634146342
6489,0.6532,1,0,1,675603,841,124720,1536,0.006661069572931187,0.6461926798485486
6490,0.6534,0,2,0,675605,839,124720,1536,0.006645228741604359,0.6467368421052632
6491,0.6535,6,2,6,675607,837,124726,1530,0.006629387910277532,0.6463878326996197
6492,0.6536,3,2,3,675609,835,124729,1527,0.006613547078950704,0.6464860287891617
6493,0.6537,1,2,1,675611,833,124730,1526,0.0065977062476238755,0.6468842729970327
6494,0.6538,4,1,4,675612,832,124734,1522,0.006589785831960461,0.6465590484282073
6495,0.6539,4,1,4,675613,831,124738,1518,0.006581865416297047,0.6462324393358876
6496,0.654,1,3,1,675616,828,124739,1517,0.006558104169306805,0.646908315565032
6497,0.6541,2,1,2,675617,827,124741,1515,0.006550183753643391,0.6468830059777968
6498,0.6542,3,2,3,675619,825,124744,1512,0.006534342922316563,0.6469833119383825
6499,0.6543,3,0,3,675619,825,124747,1509,0.006534342922316563,0.6465295629820051
6500,0.6544,1,0,1,675619,825,124748,1508,0.006534342922316563,0.6463780540077154
6501,0.6545,3,0,3,675619,825,124751,1505,0.006534342922316563,0.6459227467811158
6502,0.6546,2,2,2,675621,823,124753,1503,0.0065185020909897355,0.6461736887360275
6503,0.6547,2,4,2,675625,819,124755,1501,0.006486820428336079,0.6469827586206897
6504,0.6548,1,0,1,675625,819,124756,1500,0.006486820428336079,0.6468305304010349
6505,0.6549,4,1,4,675626,818,124760,1496,0.006478900012672665,0.6464995678478824
6506,0.655,2,1,2,675627,817,124762,1494,0.006470979597009251,0.6464733881436607
6507,0.6552,3,0,3,675627,817,124765,1491,0.006470979597009251,0.6460138648180243
6508,0.6553,1,0,1,675627,817,124766,1490,0.006470979597009251,0.6458604247941049
6509,0.6554,5,1,5,675628,816,124771,1485,0.006463059181345837,0.6453715775749674
6510,0.6555,2,2,2,675630,814,124773,1483,0.006447218350019009,0.6456247279059643
6511,0.6556,2,0,2,675630,814,124775,1481,0.006447218350019009,0.6453159041394335
6512,0.6557,1,1,1,675631,813,124776,1480,0.006439297934355595,0.6454426515481901
6513,0.6558,1,1,1,675632,812,124777,1479,0.006431377518692181,0.6455696202531646
6514,0.6559,1,1,1,675633,811,124778,1478,0.0064234571030287665,0.6456968108344255
6515,0.656,7,5,7,675638,806,124785,1471,0.006383855024711697,0.6460254721124287
6516,0.6561,4,1,4,675639,805,124789,1467,0.006375934609048283,0.6456866197183099
6517,0.6562,2,4,2,675643,801,124791,1465,0.006344252946394627,0.646513680494263
6518,0.6563,2,0,2,675643,801,124793,1463,0.006344252946394627,0.6462014134275619
6519,0.6564,5,1,5,675644,800,124798,1458,0.0063363325307312125,0.645704162976085
6520,0.6565,3,2,3,675646,798,124801,1455,0.006320491699404384,0.6458055925432756
6521,0.6566,2,1,2,675647,797,124803,1453,0.006312571283740971,0.6457777777777778
6522,0.6567,2,1,2,675648,796,124805,1451,0.006304650868077557,0.645749888740543
6523,0.6568,3,3,3,675651,793,124808,1448,0.006280889621087315,0.6461401160196341
6524,0.6569,1,1,1,675652,792,124809,1447,0.006272969205423901,0.6462706565430996
6525,0.657,2,0,2,675652,792,124811,1445,0.006272969205423901,0.6459544032185963
6526,0.6571,1,2,1,675654,790,124812,1444,0.006257128374097073,0.6463742166517458
6527,0.6572,0,1,0,675655,789,124812,1444,0.0062492079584336585,0.6466636811464398
6528,0.6573,3,2,3,675657,787,124815,1441,0.00623336712710683,0.6467684021543986
6529,0.6574,2,4,2,675661,783,124817,1439,0.006201685464453175,0.6476147614761476
6530,0.6575,4,0,4,675661,783,124821,1435,0.006201685464453175,0.6469792605951308
6531,0.6576,2,3,2,675664,780,124823,1433,0.006177924217462933,0.6475372797107998
6532,0.6577,4,1,4,675665,779,124827,1429,0.0061700038017995186,0.6471920289855072
6533,0.6578,0,4,0,675669,775,124827,1429,0.006138322139145862,0.6483666061705989
6534,0.6579,2,0,2,675669,775,124829,1427,0.006138322139145862,0.648047229791099
6535,0.658,3,1,3,675670,774,124832,1424,0.006130401723482448,0.6478616924476797
6536,0.6581,2,1,2,675671,773,124834,1422,0.006122481307819034,0.6478359908883827
6537,0.6582,2,3,2,675674,770,124836,1420,0.006098720060828793,0.6484018264840182
6538,0.6583,3,0,3,675674,770,124839,1417,0.006098720060828793,0.6479195244627344
6539,0.6584,3,1,3,675675,769,124842,1414,0.006090799645165379,0.6477324782409528
6540,0.6585,2,2,2,675677,767,124844,1412,0.0060749588138385505,0.6480036714089031
6541,0.6586,5,1,5,675678,766,124849,1407,0.006067038398175136,0.6474919466175794
6542,0.6587,1,3,1,675681,763,124850,1406,0.006043277151184894,0.6482249884739512
6543,0.6588,1,1,1,675682,762,124851,1405,0.00603535673552148,0.6483617904937702
6544,0.6589,2,0,2,675682,762,124853,1403,0.00603535673552148,0.6480369515011547
6545,0.6591,3,1,3,675683,761,124856,1400,0.006027436319858066,0.6478482184173994
6546,0.6592,3,2,3,675685,759,124859,1397,0.006011595488531238,0.6479591836734694
6547,0.6593,4,2,4,675687,757,124863,1393,0.00599575465720441,0.6479069767441861
6548,0.6594,2,1,2,675688,756,124865,1391,0.0059878342415409964,0.647880763856544
6549,0.6595,3,2,3,675690,754,124868,1388,0.005971993410214168,0.6479925303454716
6550,0.6596,3,0,3,675690,754,124871,1385,0.005971993410214168,0.6474988312295465
6551,0.6597,2,2,2,675692,752,124873,1383,0.00595615257888734,0.6477751756440281
6552,0.6598,6,1,6,675693,751,124879,1377,0.005948232163223926,0.6470864661654135
6553,0.6599,0,1,0,675694,750,124879,1377,0.005940311747560512,0.6473906911142454
6554,0.66,1,1,1,675695,749,124880,1376,0.005932391331897098,0.6475294117647059
6555,0.6601,2,0,2,675695,749,124882,1374,0.005932391331897098,0.647197362223269
6556,0.6602,1,1,1,675696,748,124883,1373,0.005924470916233684,0.6473361621876473
6557,0.6603,3,1,3,675697,747,124886,1370,0.00591655050057027,0.6471421823334907
6558,0.6604,2,2,2,675699,745,124888,1368,0.0059007096692434416,0.6474207288215806
6559,0.6605,4,2,4,675701,743,124892,1364,0.005884868837916614,0.6473659231134314
6560,0.6606,3,0,3,675701,743,124895,1361,0.005884868837916614,0.6468631178707225
6561,0.6607,3,2,3,675703,741,124898,1358,0.005869028006589786,0.6469747498808956
6562,0.6608,4,1,4,675704,740,124902,1354,0.005861107590926372,0.6466093600764088
6563,0.6609,0,2,0,675706,738,124902,1354,0.005845266759599544,0.6472275334608031
6564,0.661,2,0,2,675706,738,124904,1352,0.005845266759599544,0.6468899521531101
6565,0.6611,3,0,3,675706,738,124907,1349,0.005845266759599544,0.6463823670340201
6566,0.6612,3,0,3,675706,738,124910,1346,0.005845266759599544,0.6458733205374281
6567,0.6613,2,4,2,675710,734,124912,1344,0.0058135850969458875,0.6467757459095284
6568,0.6614,1,1,1,675711,733,124913,1343,0.0058056646812824735,0.646917148362235
6569,0.6615,2,2,2,675713,731,124915,1341,0.005789823849955645,0.6472007722007722
6570,0.6616,2,2,2,675715,729,124917,1339,0.005773983018628818,0.6474854932301741
6571,0.6617,1,3,1,675718,726,124918,1338,0.005750221771638576,0.6482558139534884
6572,0.6618,2,0,2,675718,726,124920,1336,0.005750221771638576,0.6479146459747818
6573,0.6619,2,0,2,675718,726,124922,1334,0.005750221771638576,0.6475728155339806
6574,0.662,2,1,2,675719,725,124924,1332,0.005742301355975162,0.6475449684005834
6575,0.6621,4,0,4,675719,725,124928,1328,0.005742301355975162,0.6468582562104238
6576,0.6622,0,2,0,675721,723,124928,1328,0.0057264605246483335,0.6474890297415895
6577,0.6623,0,1,0,675722,722,124928,1328,0.0057185401089849194,0.6478048780487805
6578,0.6624,2,0,2,675722,722,124930,1326,0.0057185401089849194,0.6474609375
6579,0.6625,1,2,1,675724,720,124931,1325,0.005702699277658091,0.6479217603911981
6580,0.6626,2,1,2,675725,719,124933,1323,0.005694778861994677,0.6478942213516161
6581,0.6627,1,0,1,675725,719,124934,1322,0.005694778861994677,0.6477217050465458
6582,0.6628,1,1,1,675726,718,124935,1321,0.005686858446331263,0.6478666012751348
6583,0.6629,2,3,2,675729,715,124937,1319,0.005663097199341022,0.6484759095378564
6584,0.663,3,0,3,675729,715,124940,1316,0.005663097199341022,0.6479566715903495
6585,0.6631,3,3,3,675732,712,124943,1313,0.0056393359523507795,0.6483950617283951
6586,0.6632,0,2,0,675734,710,124943,1313,0.005623495121023951,0.6490360850222442
6587,0.6633,3,1,3,675735,709,124946,1310,0.005615574705360537,0.6488360574541853
6588,0.6634,1,2,1,675737,707,124947,1309,0.005599733874033709,0.6493055555555556
6589,0.6635,5,0,5,675737,707,124952,1304,0.005599733874033709,0.6484336151168573
6590,0.6636,3,3,3,675740,704,124955,1301,0.005575972627043467,0.6488778054862843
6591,0.6637,0,1,0,675741,703,124955,1301,0.005568052211380054,0.6492015968063872
6592,0.6638,2,0,2,675741,703,124957,1299,0.005568052211380054,0.6488511488511488
6593,0.6639,1,2,1,675743,701,124958,1298,0.0055522113800532255,0.6493246623311656
6594,0.664,1,0,1,675743,701,124959,1297,0.0055522113800532255,0.6491491491491491
6595,0.6641,2,5,2,675748,696,124961,1295,0.005512609301736155,0.6504269211451532
6596,0.6642,3,0,3,675748,696,124964,1292,0.005512609301736155,0.6498993963782697
6597,0.6643,3,2,3,675750,694,124967,1289,0.005496768470409327,0.6500252143217348
6598,0.6644,4,0,4,675750,694,124971,1285,0.005496768470409327,0.6493178372915613
6599,0.6645,4,0,4,675750,694,124975,1281,0.005496768470409327,0.6486075949367088
6600,0.6646,4,3,4,675753,691,124979,1277,0.005473007223419085,0.6488821138211383
6601,0.6647,1,1,1,675754,690,124980,1276,0.005465086807755671,0.6490335707019329
6602,0.6648,2,2,2,675756,688,124982,1274,0.005449245976428843,0.6493374108053007
6603,0.6649,2,4,2,675760,684,124984,1272,0.005417564313775187,0.6503067484662577
6604,0.665,6,1,6,675761,683,124990,1266,0.005409643898111773,0.6495638789122627
6605,0.6651,1,1,1,675762,682,124991,1265,0.005401723482448359,0.6497175141242938
6606,0.6652,4,0,4,675762,682,124995,1261,0.005401723482448359,0.6489963973237262
6607,0.6653,4,0,4,675762,682,124999,1257,0.005401723482448359,0.6482723053120165
6608,0.6654,2,2,2,675764,680,125001,1255,0.005385882651121531,0.648578811369509
6609,0.6655,3,3,3,675767,677,125004,1252,0.005362121404131288,0.6490409538621047
6610,0.6656,2,2,2,675769,675,125006,1250,0.005346280572804461,0.6493506493506493
6611,0.6657,1,1,1,675770,674,125007,1249,0.005338360157141047,0.6495059802392096
6612,0.6658,2,1,2,675771,673,125009,1247,0.005330439741477633,0.6494791666666667
6613,0.6659,2,0,2,675771,673,125011,1245,0.005330439741477633,0.6491136600625652
6614,0.666,1,3,1,675774,670,125012,1244,0.005306678494487391,0.6499477533960293
6615,0.6661,8,2,8,675776,668,125020,1236,0.0052908376631605625,0.6491596638655462
6616,0.6662,4,3,4,675779,665,125024,1232,0.00526707641617032,0.6494464944649446
6617,0.6663,3,1,3,675780,664,125027,1229,0.005259156000506906,0.6492340200739567
6618,0.6664,4,1,4,675781,663,125031,1225,0.005251235584843493,0.6488347457627118
6619,0.6665,3,2,3,675783,661,125034,1222,0.005235394753516665,0.648964418481147
6620,0.6666,1,0,1,675783,661,125035,1221,0.005235394753516665,0.6487778958554729
6621,0.6667,0,3,0,675786,658,125035,1221,0.005211633506526423,0.6498137307078233
6622,0.6668,2,0,2,675786,658,125037,1219,0.005211633506526423,0.6494405966968567
6623,0.6669,1,1,1,675787,657,125038,1218,0.0052037130908630085,0.6496
6624,0.667,0,5,0,675792,652,125038,1218,0.005164111012545938,0.651336898395722
6625,0.6671,1,3,1,675795,649,125039,1217,0.005140349765555697,0.6521972132904609
6626,0.6672,3,1,3,675796,648,125042,1214,0.005132429349892283,0.6519871106337272
6627,0.6673,2,1,2,675797,647,125044,1212,0.005124508934228869,0.6519634211941904
6628,0.6674,1,1,1,675798,646,125045,1211,0.0051165885185654545,0.6521270866989769
6629,0.6675,4,2,4,675800,644,125049,1207,0.005100747687238626,0.6520799567801189
6630,0.6676,1,1,1,675801,643,125050,1206,0.005092827271575212,0.6522444564629529
6631,0.6677,2,2,2,675803,641,125052,1204,0.005076986440248384,0.6525745257452574
6632,0.6678,1,1,1,675804,640,125053,1203,0.00506906602458497,0.6527400976668475
6633,0.6679,2,0,2,675804,640,125055,1201,0.00506906602458497,0.652362846279196
6634,0.668,1,1,1,675805,639,125056,1200,0.005061145608921556,0.6525285481239804
6635,0.6681,2,0,2,675805,639,125058,1198,0.005061145608921556,0.6521502449646163
6636,0.6682,3,1,3,675806,638,125061,1195,0.005053225193258142,0.651936715766503
6637,0.6683,5,1,5,675807,637,125066,1190,0.005045304777594728,0.6513409961685823
6638,0.6684,4,1,4,675808,636,125070,1186,0.0050373843619313146,0.6509330406147091
6639,0.6685,1,0,1,675808,636,125071,1185,0.0050373843619313146,0.6507413509060955
6640,0.6686,2,2,2,675810,634,125073,1183,0.005021543530604486,0.651073197578426
6641,0.6687,1,2,1,675812,632,125074,1182,0.005005702699277658,0.6515986769570011
6642,0.6688,1,0,1,675812,632,125075,1181,0.005005702699277658,0.6514065085493657
6643,0.6689,1,0,1,675812,632,125076,1180,0.005005702699277658,0.6512141280353201
6644,0.669,2,1,2,675813,631,125078,1178,0.004997782283614244,0.6511885019347706
6645,0.6691,2,0,2,675813,631,125080,1176,0.004997782283614244,0.6508024349750968
6646,0.6692,2,1,2,675814,630,125082,1174,0.00498986186795083,0.6507760532150776
6647,0.6693,0,2,0,675816,628,125082,1174,0.004974021036624002,0.6514983351831298
6648,0.6694,0,1,0,675817,627,125082,1174,0.004966100620960588,0.6518600777345919
6649,0.6695,3,0,3,675817,627,125085,1171,0.004966100620960588,0.6512791991101223
6650,0.6696,2,0,2,675817,627,125087,1169,0.004966100620960588,0.6508908685968819
6651,0.6697,4,1,4,675818,626,125091,1165,0.004958180205297174,0.6504745951982133
6652,0.6698,4,3,4,675821,623,125095,1161,0.0049344189583069315,0.6507847533632287
6653,0.6699,3,0,3,675821,623,125098,1158,0.0049344189583069315,0.6501965188096575
6654,0.67,1,0,1,675821,623,125099,1157,0.0049344189583069315,0.65
6655,0.6701,0,4,0,675825,619,125099,1157,0.004902737295653276,0.651463963963964
6656,0.6702,1,3,1,675828,616,125100,1156,0.004878976048663034,0.6523702031602708
6657,0.6703,2,1,2,675829,615,125102,1154,0.00487105563299962,0.6523459581684568
6658,0.6704,1,0,1,675829,615,125103,1153,0.00487105563299962,0.6521493212669683
6659,0.6705,3,2,3,675831,613,125106,1150,0.004855214801672792,0.6522972206466251
6660,0.6706,1,1,1,675832,612,125107,1149,0.0048472943860093775,0.6524701873935264
6661,0.6707,3,0,3,675832,612,125110,1146,0.0048472943860093775,0.6518771331058021
6662,0.6709,0,2,0,675834,610,125110,1146,0.004831453554682549,0.6526195899772209
6663,0.671,4,1,4,675835,609,125114,1142,0.004823533139019136,0.6521987435751
6664,0.6711,1,3,1,675838,606,125115,1141,0.004799771892028894,0.6531196336576989
6665,0.6712,2,1,2,675839,605,125117,1139,0.00479185147636548,0.6530963302752294
6666,0.6713,2,0,2,675839,605,125119,1137,0.00479185147636548,0.6526980482204363
6667,0.6714,2,3,2,675842,602,125121,1135,0.0047680902293752376,0.6534254461715602
6668,0.6715,3,2,3,675844,600,125124,1132,0.004752249398048409,0.6535796766743649
6669,0.6716,2,3,2,675847,597,125126,1130,0.004728488151058167,0.6543138390272148
6670,0.6718,3,0,3,675847,597,125129,1127,0.004728488151058167,0.6537122969837587
6671,0.6719,2,2,2,675849,595,125131,1125,0.00471264731973134,0.6540697674418605
6672,0.672,2,0,2,675849,595,125133,1123,0.00471264731973134,0.6536670547147846
6673,0.6721,1,2,1,675851,593,125134,1122,0.004696806488404512,0.6542274052478134
6674,0.6722,0,1,0,675852,592,125134,1122,0.004688886072741098,0.6546091015169195
6675,0.6723,1,2,1,675854,590,125135,1121,0.0046730452414142695,0.6551724137931034
6676,0.6725,2,2,2,675856,588,125137,1119,0.004657204410087441,0.655536028119508
6677,0.6726,1,2,1,675858,586,125138,1118,0.004641363578760613,0.6561032863849765
6678,0.6728,3,0,3,675858,586,125141,1115,0.004641363578760613,0.6554967666078777
6679,0.6729,1,0,1,675858,586,125142,1114,0.004641363578760613,0.6552941176470588
6680,0.673,3,2,3,675860,584,125145,1111,0.004625522747433785,0.6554572271386431
6681,0.6731,2,0,2,675860,584,125147,1109,0.004625522747433785,0.655050206733609
6682,0.6732,3,0,3,675860,584,125150,1106,0.004625522747433785,0.6544378698224852
6683,0.6733,1,1,1,675861,583,125151,1105,0.004617602331770371,0.6546208530805687
6684,0.6734,1,1,1,675862,582,125152,1104,0.004609681916106958,0.6548042704626335
6685,0.6735,1,0,1,675862,582,125153,1103,0.004609681916106958,0.6545994065281899
6686,0.6736,1,2,1,675864,580,125154,1102,0.0045938410847801295,0.6551724137931034
6687,0.6737,4,2,4,675866,578,125158,1098,0.004578000253453301,0.6551312649164678
6688,0.6738,2,2,2,675868,576,125160,1096,0.004562159422126473,0.6555023923444976
6689,0.6739,0,1,0,675869,575,125160,1096,0.004554239006463059,0.6558946738479952
6690,0.674,1,1,1,675870,574,125161,1095,0.004546318590799645,0.6560814859197124
6691,0.6741,2,2,2,675872,572,125163,1093,0.004530477759472817,0.6564564564564564
6692,0.6742,4,0,4,675872,572,125167,1089,0.004530477759472817,0.6556291390728477
6693,0.6743,0,2,0,675874,570,125167,1089,0.004514636928145989,0.6564195298372514
6694,0.6744,2,6,2,675880,564,125169,1087,0.004467114434165505,0.658388855239249
6695,0.6745,4,1,4,675881,563,125173,1083,0.004459194018502091,0.6579586877278251
6696,0.6746,3,0,3,675881,563,125176,1080,0.004459194018502091,0.657334144856969
6697,0.6747,1,0,1,675881,563,125177,1079,0.004459194018502091,0.6571254567600487
6698,0.6748,1,1,1,675882,562,125178,1078,0.004451273602838677,0.6573170731707317
6699,0.6749,1,0,1,675882,562,125179,1077,0.004451273602838677,0.6571079926784624
6700,0.675,3,4,3,675886,558,125182,1074,0.004419591940185021,0.6580882352941176
6701,0.6751,0,1,0,675887,557,125182,1074,0.0044116715245216065,0.6584917228694053
6702,0.6752,2,0,2,675887,557,125184,1072,0.0044116715245216065,0.6580724370779619
6703,0.6753,2,1,2,675888,556,125186,1070,0.0044037511088581924,0.6580565805658056
6704,0.6754,1,1,1,675889,555,125187,1069,0.004395830693194779,0.6582512315270936
6705,0.6755,3,0,3,675889,555,125190,1066,0.004395830693194779,0.6576187538556446
6706,0.6756,2,1,2,675890,554,125192,1064,0.004387910277531365,0.657601977750309
6707,0.6757,3,1,3,675891,553,125195,1061,0.004379989861867951,0.6573729863692689
6708,0.6758,2,0,2,675891,553,125197,1059,0.004379989861867951,0.6569478908188585
6709,0.6759,5,0,5,675891,553,125202,1054,0.004379989861867951,0.65588052271313
6710,0.676,1,0,1,675891,553,125203,1053,0.004379989861867951,0.6556662515566625
6711,0.6761,3,0,3,675891,553,125206,1050,0.004379989861867951,0.6550218340611353
6712,0.6762,2,0,2,675891,553,125208,1048,0.004379989861867951,0.6545908806995627
6713,0.6763,2,0,2,675891,553,125210,1046,0.004379989861867951,0.6541588492808005
6714,0.6764,2,2,2,675893,551,125212,1044,0.004364149030541123,0.6545454545454545
6715,0.6765,4,1,4,675894,550,125216,1040,0.004356228614877709,0.6540880503144654
6716,0.6766,3,0,3,675894,550,125219,1037,0.004356228614877709,0.6534341524889729
6717,0.6767,3,2,3,675896,548,125222,1034,0.004340387783550881,0.6536030341340076
6718,0.6768,0,1,0,675897,547,125222,1034,0.004332467367887467,0.6540164452877926
6719,0.6769,2,2,2,675899,545,125224,1032,0.004316626536560638,0.6544071020925808
6720,0.677,0,2,0,675901,543,125224,1032,0.00430078570523381,0.6552380952380953
6721,0.6771,4,0,4,675901,543,125228,1028,0.00430078570523381,0.6543602800763845
6722,0.6772,6,2,6,675903,541,125234,1022,0.004284944873906983,0.653870761356366
6723,0.6773,3,1,3,675904,540,125237,1019,0.004277024458243569,0.6536241180243746
6724,0.6774,1,0,1,675904,540,125238,1018,0.004277024458243569,0.6534017971758665
6725,0.6775,1,1,1,675905,539,125239,1017,0.004269104042580155,0.653598971722365
6726,0.6776,4,0,4,675905,539,125243,1013,0.004269104042580155,0.6527061855670103
6727,0.6777,2,1,2,675906,538,125245,1011,0.004261183626916741,0.6526791478373144
6728,0.6778,3,2,3,675908,536,125248,1008,0.0042453427955899126,0.6528497409326425
6729,0.6779,3,0,3,675908,536,125251,1005,0.0042453427955899126,0.6521739130434783
6730,0.678,2,1,2,675909,535,125253,1003,0.0042374223799264985,0.6521456436931079
6731,0.6781,5,1,5,675910,534,125258,998,0.004229501964263084,0.6514360313315927
6732,0.6782,7,0,7,675910,534,125265,991,0.004229501964263084,0.6498360655737705
6733,0.6783,3,2,3,675912,532,125268,988,0.004213661132936256,0.65
6734,0.6784,1,2,1,675914,530,125269,987,0.004197820301609428,0.6506262359920897
6735,0.6785,1,0,1,675914,530,125270,986,0.004197820301609428,0.6503957783641161
6736,0.6786,2,2,2,675916,528,125272,984,0.004181979470282601,0.6507936507936508
6737,0.6788,2,3,2,675919,525,125274,982,0.0041582182232923585,0.6516257465162575
6738,0.6789,2,1,2,675920,524,125276,980,0.0041502978076289445,0.651595744680851
6739,0.679,1,0,1,675920,524,125277,979,0.0041502978076289445,0.6513639387890885
6740,0.6791,0,1,0,675921,523,125277,979,0.00414237739196553,0.651797603195739
6741,0.6792,2,0,2,675921,523,125279,977,0.00414237739196553,0.6513333333333333
6742,0.6793,1,0,1,675921,523,125280,976,0.00414237739196553,0.6511007338225484
6743,0.6794,2,3,2,675924,520,125282,974,0.004118616144975288,0.6519410977242303
6744,0.6795,2,0,2,675924,520,125284,972,0.004118616144975288,0.6514745308310992
6745,0.6797,0,2,0,675926,518,125284,972,0.00410277531364846,0.6523489932885906
6746,0.6798,3,1,3,675927,517,125287,969,0.004094854897985046,0.652086137281292
6747,0.6799,0,2,0,675929,515,125287,969,0.004079014066658219,0.6529649595687331
6748,0.68,1,1,1,675930,514,125288,968,0.0040710936509948045,0.6531713900134952
6749,0.6801,3,1,3,675931,513,125291,965,0.0040631732353313904,0.6529093369418133
6750,0.6802,1,2,1,675933,511,125292,964,0.004047332404004562,0.6535593220338983
6751,0.6803,1,1,1,675934,510,125293,963,0.004039411988341148,0.6537678207739308
6752,0.6804,2,0,2,675934,510,125295,961,0.004039411988341148,0.6532970768184908
6753,0.6805,3,1,3,675935,509,125298,958,0.004031491572677734,0.6530334014996592
6754,0.6806,0,1,0,675936,508,125298,958,0.00402357115701432,0.6534788540245566
6755,0.6807,1,2,1,675938,506,125299,957,0.004007730325687492,0.6541353383458647
6756,0.6808,0,1,0,675939,505,125299,957,0.003999809910024078,0.6545827633378933
6757,0.6809,1,1,1,675940,504,125300,956,0.003991889494360664,0.6547945205479452
6758,0.681,2,2,2,675942,502,125302,954,0.003976048663033836,0.6552197802197802
6759,0.6811,2,2,2,675944,500,125304,952,0.003960207831707008,0.6556473829201102
6760,0.6812,0,3,0,675947,497,125304,952,0.003936446584716766,0.6570048309178744
6761,0.6815,2,2,2,675949,495,125306,950,0.003920605753389938,0.657439446366782
6762,0.6816,2,2,2,675951,493,125308,948,0.0039047649220631097,0.6578764746703678
6763,0.6817,4,1,4,675952,492,125312,944,0.003896844506399696,0.6573816155988857
6764,0.6818,3,2,3,675954,490,125315,941,0.003881003675072868,0.6575821104122991
6765,0.6819,3,1,3,675955,489,125318,938,0.003873083259409454,0.657323055360897
6766,0.682,3,2,3,675957,487,125321,935,0.0038572424280826256,0.6575246132208158
6767,0.6821,2,1,2,675958,486,125323,933,0.0038493220124192116,0.6575052854122622
6768,0.6822,1,0,1,675958,486,125324,932,0.0038493220124192116,0.6572637517630465
6769,0.6823,1,0,1,675958,486,125325,931,0.0038493220124192116,0.6570218772053634
6770,0.6824,2,1,2,675959,485,125327,929,0.003841401596755798,0.657001414427157
6771,0.6825,2,1,2,675960,484,125329,927,0.003833481181092384,0.6569808646350106
6772,0.6826,2,0,2,675960,484,125331,925,0.003833481181092384,0.6564939673527325
6773,0.6827,3,1,3,675961,483,125334,922,0.0038255607654289698,0.6562277580071174
6774,0.6828,3,1,3,675962,482,125337,919,0.0038176403497655557,0.655960028551035
6775,0.6829,3,0,3,675962,482,125340,916,0.0038176403497655557,0.6552217453505007
6776,0.683,3,3,3,675965,479,125343,913,0.0037938791027753134,0.6558908045977011
6777,0.6831,2,2,2,675967,477,125345,911,0.0037780382714484857,0.6563400576368876
6778,0.6833,1,5,1,675972,472,125346,910,0.0037384361931314157,0.658465991316932
6779,0.6835,2,3,2,675975,469,125348,908,0.0037146749461411735,0.6594045025417574
6780,0.6837,2,0,2,675975,469,125350,906,0.0037146749461411735,0.6589090909090909
6781,0.6838,2,3,2,675978,466,125352,904,0.0036909136991509313,0.6598540145985401
6782,0.6839,0,2,0,675980,464,125352,904,0.0036750728678241035,0.6608187134502924
6783,0.684,1,1,1,675981,463,125353,903,0.0036671524521606894,0.6610541727672035
6784,0.6841,4,1,4,675982,462,125357,899,0.0036592320364972754,0.6605437178545187
6785,0.6842,4,2,4,675984,460,125361,895,0.003643391205170447,0.6605166051660517
6786,0.6843,0,1,0,675985,459,125361,895,0.003635470789507033,0.6610044313146234
6787,0.6844,2,0,2,675985,459,125363,893,0.003635470789507033,0.6605029585798816
6788,0.6845,1,3,1,675988,456,125364,892,0.0036117095425167913,0.6617210682492581
6789,0.6846,2,0,2,675988,456,125366,890,0.0036117095425167913,0.6612184249628529
6790,0.6847,2,2,2,675990,454,125368,888,0.003595868711189963,0.6616989567809239
6791,0.6848,1,1,1,675991,453,125369,887,0.003587948295526549,0.6619402985074627
6792,0.6849,4,1,4,675992,452,125373,883,0.0035800278798631354,0.6614232209737828
6793,0.685,2,3,2,675995,449,125375,881,0.003556266632872893,0.662406015037594
6794,0.6851,2,0,2,675995,449,125377,879,0.003556266632872893,0.6618975903614458
6795,0.6852,1,2,1,675997,447,125378,878,0.003540425801546065,0.6626415094339623
6796,0.6853,1,0,1,675997,447,125379,877,0.003540425801546065,0.6623867069486404
6797,0.6854,0,2,0,675999,445,125379,877,0.0035245849702192373,0.6633888048411498
6798,0.6855,0,1,0,676000,444,125379,877,0.003516664554555823,0.663890991672975
6799,0.6856,1,0,1,676000,444,125380,876,0.003516664554555823,0.6636363636363637
6800,0.6857,3,1,3,676001,443,125383,873,0.003508744138892409,0.6633738601823708
6801,0.6858,3,2,3,676003,441,125386,870,0.003492903307565581,0.6636155606407322
6802,0.6859,4,0,4,676003,441,125390,866,0.003492903307565581,0.6625860749808722
6803,0.686,2,2,2,676005,439,125392,864,0.003477062476238753,0.6630851880276285
6804,0.6861,3,0,3,676005,439,125395,861,0.003477062476238753,0.6623076923076923
6805,0.6862,1,1,1,676006,438,125396,860,0.003469142060575339,0.662557781201849
6806,0.6863,2,1,2,676007,437,125398,858,0.003461221644911925,0.6625482625482626
6807,0.6864,1,1,1,676008,436,125399,857,0.003453301229248511,0.662799690641918
6808,0.6865,4,0,4,676008,436,125403,853,0.003453301229248511,0.6617532971295578
6809,0.6867,3,1,3,676009,435,125406,850,0.003445380813585097,0.6614785992217899
6810,0.6868,1,0,1,676009,435,125407,849,0.003445380813585097,0.6612149532710281
6811,0.6869,0,1,0,676010,434,125407,849,0.003437460397921683,0.661730319563523
6812,0.687,1,1,1,676011,433,125408,848,0.0034295399822582688,0.6619828259172521
6813,0.6871,1,0,1,676011,433,125409,847,0.0034295399822582688,0.66171875
6814,0.6872,1,0,1,676011,433,125410,846,0.0034295399822582688,0.6614542611415168
6815,0.6873,1,0,1,676011,433,125411,845,0.0034295399822582688,0.661189358372457
6816,0.6874,2,0,2,676011,433,125413,843,0.0034295399822582688,0.6606583072100314
6817,0.6875,1,1,1,676012,432,125414,842,0.003421619566594855,0.6609105180533752
6818,0.6876,4,2,4,676014,430,125418,838,0.003405778735268027,0.6608832807570978
6819,0.6878,1,2,1,676016,428,125419,837,0.003389937903941199,0.6616600790513834
6820,0.6879,0,2,0,676018,426,125419,837,0.0033740970726143706,0.66270783847981
6821,0.688,0,1,0,676019,425,125419,837,0.003366176656950957,0.6632329635499208
6822,0.6881,1,0,1,676019,425,125420,836,0.003366176656950957,0.6629659000793021
6823,0.6882,2,0,2,676019,425,125422,834,0.003366176656950957,0.6624305003971406
6824,0.6883,2,1,2,676020,424,125424,832,0.003358256241287543,0.6624203821656051
6825,0.6885,0,1,0,676021,423,125424,832,0.003350335825624129,0.6629482071713148
6826,0.6886,1,3,1,676024,420,125425,831,0.0033265745786338866,0.6642685851318945
6827,0.6887,1,2,1,676026,418,125426,830,0.003310733747307059,0.6650641025641025
6828,0.6889,3,1,3,676027,417,125429,827,0.0033028133316436448,0.6647909967845659
6829,0.6892,0,1,0,676028,416,125429,827,0.0032948929159802307,0.66532582461786
6830,0.6893,1,1,1,676029,415,125430,826,0.0032869725003168166,0.6655922643029815
6831,0.6894,1,1,1,676030,414,125431,825,0.0032790520846534025,0.6658595641646489
6832,0.6895,1,0,1,676030,414,125432,824,0.0032790520846534025,0.6655896607431341
6833,0.6896,2,0,2,676030,414,125434,822,0.0032790520846534025,0.6650485436893204
6834,0.6897,0,1,0,676031,413,125434,822,0.0032711316689899884,0.665587044534413
6835,0.6898,2,3,2,676034,410,125436,820,0.0032473704219997466,0.6666666666666666
6836,0.6899,0,1,0,676035,409,125436,820,0.0032394500063363326,0.6672091131000814
6837,0.69,2,0,2,676035,409,125438,818,0.0032394500063363326,0.6666666666666666
6838,0.6901,5,3,5,676038,406,125443,813,0.0032156887593460903,0.6669401148482362
6839,0.6902,0,1,0,676039,405,125443,813,0.0032077683436826767,0.6674876847290641
6840,0.6903,2,1,2,676040,404,125445,811,0.0031998479280192626,0.6674897119341564
6841,0.6904,2,0,2,676040,404,125447,809,0.0031998479280192626,0.6669414674361088
6842,0.6906,3,2,3,676042,402,125450,806,0.0031840070966924344,0.6672185430463576
6843,0.6907,2,2,2,676044,400,125452,804,0.0031681662653656063,0.6677740863787376
6844,0.6908,1,0,1,676044,400,125453,803,0.0031681662653656063,0.6674979218620116
6845,0.6909,1,2,1,676046,398,125454,802,0.0031523254340387785,0.6683333333333333
6846,0.691,2,0,2,676046,398,125456,800,0.0031523254340387785,0.667779632721202
6847,0.6911,3,2,3,676048,396,125459,797,0.0031364846027119504,0.6680637049455155
6848,0.6912,0,1,0,676049,395,125459,797,0.0031285641870485363,0.6686241610738255
6849,0.6913,3,1,3,676050,394,125462,794,0.003120643771385122,0.6683501683501684
6850,0.6914,0,1,0,676051,393,125462,794,0.003112723355721708,0.6689132266217355
6851,0.6915,1,1,1,676052,392,125463,793,0.003104802940058294,0.6691983122362869
6852,0.6916,2,0,2,676052,392,125465,791,0.003104802940058294,0.6686390532544378
6853,0.6918,1,0,1,676052,392,125466,790,0.003104802940058294,0.6683587140439933
6854,0.6919,0,1,0,676053,391,125466,790,0.0030968825243948804,0.6689246401354784
6855,0.692,4,0,4,676053,391,125470,786,0.0030968825243948804,0.6677994902293968
6856,0.6921,1,0,1,676053,391,125471,785,0.0030968825243948804,0.6675170068027211
6857,0.6922,1,1,1,676054,390,125472,784,0.0030889621087314663,0.6678023850085179
6858,0.6923,1,2,1,676056,388,125473,783,0.003073121277404638,0.6686592655849701
6859,0.6924,0,1,0,676057,387,125473,783,0.003065200861741224,0.6692307692307692
6860,0.6925,1,1,1,676058,386,125474,782,0.00305728044607781,0.6695205479452054
6861,0.6927,1,2,1,676060,384,125475,781,0.0030414396147509823,0.6703862660944206
6862,0.6928,1,2,1,676062,382,125476,780,0.003025598783424154,0.6712564543889845
6863,0.6929,2,0,2,676062,382,125478,778,0.003025598783424154,0.6706896551724137
6864,0.693,3,0,3,676062,382,125481,775,0.003025598783424154,0.6698357821953328
6865,0.6931,2,0,2,676062,382,125483,773,0.003025598783424154,0.6692640692640692
6866,0.6932,1,1,1,676063,381,125484,772,0.00301767836776074,0.6695576756287944
6867,0.6934,1,1,1,676064,380,125485,771,0.003009757952097326,0.6698523023457863
6868,0.6935,1,0,1,676064,380,125486,770,0.003009757952097326,0.6695652173913044
6869,0.6936,2,1,2,676065,379,125488,768,0.003001837536433912,0.6695727986050567
6870,0.6939,2,1,2,676066,378,125490,766,0.0029939171207704982,0.6695804195804196
6871,0.694,1,1,1,676067,377,125491,765,0.002985996705107084,0.669877408056042
6872,0.6941,1,1,1,676068,376,125492,764,0.00297807628944367,0.6701754385964912
6873,0.6942,2,0,2,676068,376,125494,762,0.00297807628944367,0.6695957820738138
6874,0.6943,1,3,1,676071,373,125495,761,0.002954315042453428,0.6710758377425045
6875,0.6944,1,0,1,676071,373,125496,760,0.002954315042453428,0.6707855251544572
6876,0.6945,3,1,3,676072,372,125499,757,0.0029463946267900137,0.6705048715677591
6877,0.6946,0,1,0,676073,371,125499,757,0.0029384742111266,0.6710992907801419
6878,0.6947,3,1,3,676074,370,125502,754,0.002930553795463186,0.6708185053380783
6879,0.6948,2,4,2,676078,366,125504,752,0.0028988721328095297,0.6726296958855098
6880,0.6949,0,1,0,676079,365,125504,752,0.002890951717146116,0.6732318710832588
6881,0.695,2,0,2,676079,365,125506,750,0.002890951717146116,0.672645739910314
6882,0.6951,1,2,1,676081,363,125507,749,0.002875110885819288,0.6735611510791367
6883,0.6952,5,1,5,676082,362,125512,744,0.002867190470155874,0.6726943942133815
6884,0.6956,1,1,1,676083,361,125513,743,0.0028592700544924597,0.6730072463768116
6885,0.6957,6,1,6,676084,360,125519,737,0.0028513496388290456,0.6718322698268003
6886,0.6958,1,0,1,676084,360,125520,736,0.0028513496388290456,0.6715328467153284
6887,0.6959,2,1,2,676085,359,125522,734,0.0028434292231656316,0.6715462031107045
6888,0.696,2,1,2,676086,358,125524,732,0.002835508807502218,0.671559633027523
6889,0.6961,1,1,1,676087,357,125525,731,0.002827588391838804,0.671875
6890,0.6962,4,1,4,676088,356,125529,727,0.0028196679761753897,0.6712834718374885
6891,0.6964,2,0,2,676088,356,125531,725,0.0028196679761753897,0.6706753006475485
6892,0.6965,0,1,0,676089,355,125531,725,0.0028117475605119757,0.6712962962962963
6893,0.6966,2,1,2,676090,354,125533,723,0.0028038271448485616,0.6713091922005571
6894,0.6967,1,2,1,676092,352,125534,722,0.0027879863135217334,0.6722532588454376
6895,0.6968,1,0,1,676092,352,125535,721,0.0027879863135217334,0.6719478098788444
6896,0.6969,1,0,1,676092,352,125536,720,0.0027879863135217334,0.6716417910447762
6897,0.697,3,0,3,676092,352,125539,717,0.0027879863135217334,0.6707202993451824
6898,0.6972,1,0,1,676092,352,125540,716,0.0027879863135217334,0.6704119850187266
6899,0.6973,1,2,1,676094,350,125541,715,0.0027721454821949057,0.6713615023474179
6900,0.6974,2,0,2,676094,350,125543,713,0.0027721454821949057,0.6707431796801505
6901,0.6975,3,0,3,676094,350,125546,710,0.0027721454821949057,0.6698113207547169
6902,0.6976,0,1,0,676095,349,125546,710,0.0027642250665314916,0.6704438149197356
6903,0.6977,1,1,1,676096,348,125547,709,0.0027563046508680775,0.6707663197729423
6904,0.6978,3,0,3,676096,348,125550,706,0.0027563046508680775,0.6698292220113852
6905,0.698,0,2,0,676098,346,125550,706,0.0027404638195412494,0.6711026615969582
6906,0.6982,2,2,2,676100,344,125552,704,0.0027246229882144216,0.6717557251908397
6907,0.6983,2,1,2,676101,343,125554,702,0.0027167025725510076,0.6717703349282297
6908,0.6984,3,1,3,676102,342,125557,699,0.0027087821568875935,0.6714697406340058
6909,0.6985,0,1,0,676103,341,125557,699,0.0027008617412241794,0.6721153846153847
6910,0.6986,3,0,3,676103,341,125560,696,0.0027008617412241794,0.6711668273866924
6911,0.6987,1,0,1,676103,341,125561,695,0.0027008617412241794,0.6708494208494209
6912,0.6988,1,1,1,676104,340,125562,694,0.0026929413255607653,0.6711798839458414
6913,0.6989,0,3,0,676107,337,125562,694,0.0026691800785705235,0.6731328806983511
6914,0.699,2,2,2,676109,335,125564,692,0.0026533392472436954,0.6738072054527751
6915,0.6991,2,1,2,676110,334,125566,690,0.0026454188315802813,0.673828125
6916,0.6993,1,0,1,676110,334,125567,689,0.0026454188315802813,0.6735092864125122
6917,0.6994,2,0,2,676110,334,125569,687,0.0026454188315802813,0.672869735553379
6918,0.6995,3,1,3,676111,333,125572,684,0.002637498415916867,0.672566371681416
6919,0.6996,3,0,3,676111,333,125575,681,0.002637498415916867,0.6715976331360947
6920,0.6997,3,3,3,676114,330,125578,678,0.0026137371689266254,0.6726190476190477
6921,0.6998,0,1,0,676115,329,125578,678,0.0026058167532632113,0.6732869910625621
6922,0.6999,1,2,1,676117,327,125579,677,0.002589975921936383,0.6743027888446215
6923,0.7,4,0,4,676117,327,125583,673,0.002589975921936383,0.673
6924,0.7001,2,1,2,676118,326,125585,671,0.002582055506272969,0.6730190571715146
6925,0.7002,1,1,1,676119,325,125586,670,0.002574135090609555,0.6733668341708543
6926,0.7003,2,1,2,676120,324,125588,668,0.0025662146749461413,0.6733870967741935
6927,0.7004,2,0,2,676120,324,125590,666,0.0025662146749461413,0.6727272727272727
6928,0.7005,1,0,1,676120,324,125591,665,0.0025662146749461413,0.6723963599595552
6929,0.7006,0,1,0,676121,323,125591,665,0.0025582942592827273,0.6730769230769231
6930,0.7007,1,1,1,676122,322,125592,664,0.002550373843619313,0.6734279918864098
6931,0.7008,0,1,0,676123,321,125592,664,0.002542453427955899,0.6741116751269035
6932,0.701,0,1,0,676124,320,125592,664,0.002534533012292485,0.6747967479674797
6933,0.7011,1,1,1,676125,319,125593,663,0.002526612596629071,0.675152749490835
6934,0.7014,1,1,1,676126,318,125594,662,0.0025186921809656573,0.6755102040816326
6935,0.7015,1,1,1,676127,317,125595,661,0.002510771765302243,0.6758691206543967
6936,0.7016,3,0,3,676127,317,125598,658,0.002510771765302243,0.6748717948717948
6937,0.7017,0,1,0,676128,316,125598,658,0.002502851349638829,0.675564681724846
6938,0.7018,1,1,1,676129,315,125599,657,0.002494930933975415,0.6759259259259259
6939,0.7019,5,0,5,676129,315,125604,652,0.002494930933975415,0.6742502585315409
6940,0.702,3,1,3,676130,314,125607,649,0.002487010518312001,0.6739356178608515
6941,0.7021,2,0,2,676130,314,125609,647,0.002487010518312001,0.6732570239334027
6942,0.7022,0,1,0,676131,313,125609,647,0.002479090102648587,0.6739583333333333
6943,0.7023,2,0,2,676131,313,125611,645,0.002479090102648587,0.673277661795407
6944,0.7024,0,1,0,676132,312,125611,645,0.002471169686985173,0.6739811912225705
6945,0.7027,0,1,0,676133,311,125611,645,0.002463249271321759,0.6746861924686193
6946,0.7029,2,0,2,676133,311,125613,643,0.002463249271321759,0.6740041928721174
6947,0.703,2,0,2,676133,311,125615,641,0.002463249271321759,0.6733193277310925
6948,0.7031,2,0,2,676133,311,125617,639,0.002463249271321759,0.6726315789473685
6949,0.7032,1,0,1,676133,311,125618,638,0.002463249271321759,0.672286617492097
6950,0.7033,1,0,1,676133,311,125619,637,0.002463249271321759,0.6719409282700421
6951,0.7034,0,1,0,676134,310,125619,637,0.002455328855658345,0.672650475184794
6952,0.7035,0,1,0,676135,309,125619,637,0.002447408439994931,0.6733615221987315
6953,0.7036,1,0,1,676135,309,125620,636,0.002447408439994931,0.6730158730158731
6954,0.7038,2,2,2,676137,307,125622,634,0.002431567608668103,0.6737513283740701
6955,0.704,2,0,2,676137,307,125624,632,0.002431567608668103,0.6730564430244942
6956,0.7043,1,2,1,676139,305,125625,631,0.0024157267773412747,0.6741452991452992
6957,0.7044,1,0,1,676139,305,125626,630,0.0024157267773412747,0.6737967914438503
6958,0.7045,2,0,2,676139,305,125628,628,0.0024157267773412747,0.6730975348338692
6959,0.7047,1,2,1,676141,303,125629,627,0.002399885946014447,0.6741935483870968
6960,0.7048,1,2,1,676143,301,125630,626,0.0023840451146876188,0.6752966558791802
6961,0.7049,1,1,1,676144,300,125631,625,0.0023761246990242047,0.6756756756756757
6962,0.705,2,0,2,676144,300,125633,623,0.0023761246990242047,0.6749729144095341
6963,0.7052,2,1,2,676145,299,125635,621,0.0023682042833607906,0.675
6964,0.7053,2,2,2,676147,297,125637,619,0.002352363452033963,0.675764192139738
6965,0.7054,3,0,3,676147,297,125640,616,0.002352363452033963,0.6746987951807228
6966,0.7055,3,0,3,676147,297,125643,613,0.002352363452033963,0.6736263736263737
6967,0.7057,0,1,0,676148,296,125643,613,0.002344443036370549,0.6743674367436744
6968,0.7058,1,2,1,676150,294,125644,612,0.0023286022050437206,0.6754966887417219
6969,0.7059,1,1,1,676151,293,125645,611,0.0023206817893803066,0.6758849557522124
6970,0.706,3,0,3,676151,293,125648,608,0.0023206817893803066,0.6748057713651499
6971,0.7061,2,0,2,676151,293,125650,606,0.0023206817893803066,0.6740823136818688
6972,0.7062,1,2,1,676153,291,125651,605,0.002304840958053479,0.6752232142857143
6973,0.7064,1,1,1,676154,290,125652,604,0.0022969205423900648,0.6756152125279642
6974,0.7066,2,0,2,676154,290,125654,602,0.0022969205423900648,0.6748878923766816
6975,0.7067,1,0,1,676154,290,125655,601,0.0022969205423900648,0.6745230078563412
6976,0.7068,1,2,1,676156,288,125656,600,0.0022810797110632366,0.6756756756756757
6977,0.7069,1,1,1,676157,287,125657,599,0.0022731592953998225,0.6760722347629797
6978,0.707,0,1,0,676158,286,125657,599,0.0022652388797364084,0.6768361581920904
6979,0.7071,2,1,2,676159,285,125659,597,0.0022573184640729944,0.6768707482993197
6980,0.7072,1,3,1,676162,282,125660,596,0.0022335572170827525,0.6788154897494305
6981,0.7073,2,1,2,676163,281,125662,594,0.0022256368014193385,0.6788571428571428
6982,0.7074,1,0,1,676163,281,125663,593,0.0022256368014193385,0.6784897025171625
6983,0.7076,0,1,0,676164,280,125663,593,0.0022177163857559244,0.6792668957617412
6984,0.7077,1,1,1,676165,279,125664,592,0.0022097959700925103,0.6796785304247991
6985,0.7078,1,0,1,676165,279,125665,591,0.0022097959700925103,0.6793103448275862
6986,0.708,0,1,0,676166,278,125665,591,0.0022018755544290962,0.6800920598388953
6987,0.7082,0,2,0,676168,276,125665,591,0.0021860347231022685,0.6816608996539792
6988,0.7084,2,0,2,676168,276,125667,589,0.0021860347231022685,0.6809248554913295
6989,0.7085,1,0,1,676168,276,125668,588,0.0021860347231022685,0.6805555555555556
6990,0.7086,0,1,0,676169,275,125668,588,0.0021781143074388544,0.6813441483198146
6991,0.7087,2,0,2,676169,275,125670,586,0.0021781143074388544,0.6806039488966318
6992,0.7088,2,1,2,676170,274,125672,584,0.0021701938917754403,0.6806526806526807
6993,0.7089,1,0,1,676170,274,125673,583,0.0021701938917754403,0.6802800466744457
6994,0.709,1,1,1,676171,273,125674,582,0.0021622734761120263,0.6807017543859649
6995,0.7091,2,0,2,676171,273,125676,580,0.0021622734761120263,0.6799531066822978
6996,0.7092,1,1,1,676172,272,125677,579,0.002154353060448612,0.6803760282021152
6997,0.7093,2,0,2,676172,272,125679,577,0.002154353060448612,0.6796230859835101
6998,0.7094,1,1,1,676173,271,125680,576,0.0021464326447851985,0.680047225501771
6999,0.7096,1,0,1,676173,271,125681,575,0.0021464326447851985,0.6796690307328606
7000,0.7097,3,2,3,676175,269,125684,572,0.0021305918134583704,0.6801426872770512
7001,0.7098,1,2,1,676177,267,125685,571,0.002114750982131542,0.6813842482100239
7002,0.7099,3,0,3,676177,267,125688,568,0.002114750982131542,0.6802395209580838
7003,0.71,1,0,1,676177,267,125689,567,0.002114750982131542,0.6798561151079137
7004,0.7101,1,1,1,676178,266,125690,566,0.002106830566468128,0.6802884615384616
7005,0.7102,1,0,1,676178,266,125691,565,0.002106830566468128,0.6799037304452467
7006,0.7103,2,2,2,676180,264,125693,563,0.0020909897351413004,0.6807738814993954
7007,0.7104,0,2,0,676182,262,125693,563,0.0020751489038144722,0.6824242424242424
7008,0.7105,2,2,2,676184,260,125695,561,0.002059308072487644,0.6833130328867235
7009,0.7106,1,1,1,676185,259,125696,560,0.00205138765682423,0.6837606837606838
7010,0.7107,2,0,2,676185,259,125698,558,0.00205138765682423,0.6829865361077111
7011,0.7108,1,1,1,676186,258,125699,557,0.002043467241160816,0.6834355828220859
7012,0.711,1,0,1,676186,258,125700,556,0.002043467241160816,0.683046683046683
7013,0.7111,1,0,1,676186,258,125701,555,0.002043467241160816,0.6826568265682657
7014,0.7112,0,2,0,676188,256,125701,555,0.002027626409833988,0.6843403205918619
7015,0.7113,0,1,0,676189,255,125701,555,0.002019705994170574,0.6851851851851852
7016,0.7114,2,0,2,676189,255,125703,553,0.002019705994170574,0.6844059405940595
7017,0.7115,1,0,1,676189,255,125704,552,0.002019705994170574,0.6840148698884758
7018,0.7116,1,0,1,676189,255,125705,551,0.002019705994170574,0.6836228287841191
7019,0.7117,0,1,0,676190,254,125705,551,0.00201178557850716,0.684472049689441
7020,0.7118,0,1,0,676191,253,125705,551,0.002003865162843746,0.6853233830845771
7021,0.7119,1,0,1,676191,253,125706,550,0.002003865162843746,0.684931506849315
7022,0.712,0,1,0,676192,252,125706,550,0.001995944747180332,0.685785536159601
7023,0.7122,3,0,3,676192,252,125709,547,0.001995944747180332,0.6846057571964956
7024,0.7123,1,0,1,676192,252,125710,546,0.001995944747180332,0.6842105263157895
7025,0.7124,1,0,1,676192,252,125711,545,0.001995944747180332,0.6838143036386449
7026,0.7125,0,1,0,676193,251,125711,545,0.001988024331516918,0.6846733668341709
7027,0.7126,1,1,1,676194,250,125712,544,0.001980103915853504,0.6851385390428212
7028,0.7127,0,3,0,676197,247,125712,544,0.001956342668863262,0.6877370417193426
7029,0.7128,2,0,2,676197,247,125714,542,0.001956342668863262,0.6869455006337135
7030,0.7129,2,1,2,676198,246,125716,540,0.001948422253199848,0.6870229007633588
7031,0.7131,0,2,0,676200,244,125716,540,0.0019325814218730199,0.6887755102040817
7032,0.7132,1,2,1,676202,242,125717,539,0.001916740590546192,0.6901408450704225
7033,0.7135,1,1,1,676203,241,125718,538,0.0019088201748827778,0.6906290115532734
7034,0.7136,0,2,0,676205,239,125718,538,0.00189297934355595,0.6924066924066924
7035,0.7137,1,0,1,676205,239,125719,537,0.00189297934355595,0.6920103092783505
7036,0.7138,0,1,0,676206,238,125719,537,0.0018850589278925358,0.6929032258064516
7037,0.7139,0,1,0,676207,237,125719,537,0.0018771385122291217,0.6937984496124031
7038,0.714,1,1,1,676208,236,125720,536,0.0018692180965657079,0.694300518134715
7039,0.7141,2,0,2,676208,236,125722,534,0.0018692180965657079,0.6935064935064935
7040,0.7142,0,2,0,676210,234,125722,534,0.0018533772652388797,0.6953125
7041,0.7143,2,1,2,676211,233,125724,532,0.0018454568495754656,0.6954248366013072
7042,0.7144,1,1,1,676212,232,125725,531,0.0018375364339120518,0.6959370904325033
7043,0.7145,3,1,3,676213,231,125728,528,0.0018296160182486377,0.6956521739130435
7044,0.7146,1,1,1,676214,230,125729,527,0.0018216956025852236,0.6961690885072656
7045,0.7147,2,0,2,676214,230,125731,525,0.0018216956025852236,0.695364238410596
7046,0.7148,0,1,0,676215,229,125731,525,0.0018137751869218097,0.6962864721485411
7047,0.7151,1,0,1,676215,229,125732,524,0.0018137751869218097,0.6958831341301461
7048,0.7152,2,1,2,676216,228,125734,522,0.0018058547712583957,0.696
7049,0.7155,1,0,1,676216,228,125735,521,0.0018058547712583957,0.6955941255006676
7050,0.7157,1,2,1,676218,226,125736,520,0.0017900139399315677,0.6970509383378016
7051,0.7158,1,0,1,676218,226,125737,519,0.0017900139399315677,0.6966442953020134
7052,0.7159,0,1,0,676219,225,125737,519,0.0017820935242681536,0.6975806451612904
7053,0.716,1,0,1,676219,225,125738,518,0.0017820935242681536,0.6971736204576043
7054,0.7161,1,0,1,676219,225,125739,517,0.0017820935242681536,0.6967654986522911
7055,0.7162,0,1,0,676220,224,125739,517,0.0017741731086047396,0.6977058029689609
7056,0.7163,1,0,1,676220,224,125740,516,0.0017741731086047396,0.6972972972972973
7057,0.7164,0,1,0,676221,223,125740,516,0.0017662526929413255,0.6982408660351827
7058,0.7165,1,1,1,676222,222,125741,515,0.0017583322772779116,0.6987788331071914
7059,0.7166,0,1,0,676223,221,125741,515,0.0017504118616144975,0.6997282608695652
7060,0.7167,3,0,3,676223,221,125744,512,0.0017504118616144975,0.6984993178717599
7061,0.717,3,0,3,676223,221,125747,509,0.0017504118616144975,0.6972602739726027
7062,0.7172,0,1,0,676224,220,125747,509,0.0017424914459510834,0.6982167352537723
7063,0.7173,0,2,0,676226,218,125747,509,0.0017266506146242555,0.7001375515818432
7064,0.7174,3,0,3,676226,218,125750,506,0.0017266506146242555,0.6988950276243094
7065,0.7175,2,0,2,676226,218,125752,504,0.0017266506146242555,0.6980609418282548
7066,0.7177,1,1,1,676227,217,125753,503,0.0017187301989608414,0.6986111111111111
7067,0.7178,3,0,3,676227,217,125756,500,0.0017187301989608414,0.697350069735007
7068,0.718,1,1,1,676228,216,125757,499,0.0017108097832974276,0.6979020979020979
7069,0.7183,0,2,0,676230,214,125757,499,0.0016949689519705994,0.699859747545582
7070,0.7184,1,0,1,676230,214,125758,498,0.0016949689519705994,0.699438202247191
7071,0.7186,1,1,1,676231,213,125759,497,0.0016870485363071853,0.7
7072,0.7187,0,1,0,676232,212,125759,497,0.0016791281206437714,0.7009873060648801
7073,0.7189,0,1,0,676233,211,125759,497,0.0016712077049803574,0.7019774011299436
7074,0.719,1,1,1,676234,210,125760,496,0.0016632872893169433,0.7025495750708215
7075,0.7193,1,0,1,676234,210,125761,495,0.0016632872893169433,0.7021276595744681
7076,0.7194,1,2,1,676236,208,125762,494,0.0016474464579901153,0.7037037037037037
7077,0.7196,3,0,3,676236,208,125765,491,0.0016474464579901153,0.7024320457796852
7078,0.7197,1,1,1,676237,207,125766,490,0.0016395260423267013,0.703012912482066
7079,0.7198,2,0,2,676237,207,125768,488,0.0016395260423267013,0.702158273381295
7080,0.7199,1,2,1,676239,205,125769,487,0.0016236852109998733,0.703757225433526
7081,0.72,3,3,3,676242,202,125772,484,0.0015999239640096313,0.7055393586005831
7082,0.7202,1,0,1,676242,202,125773,483,0.0015999239640096313,0.7051094890510949
7083,0.7203,0,1,0,676243,201,125773,483,0.0015920035483462172,0.706140350877193
7084,0.7204,1,0,1,676243,201,125774,482,0.0015920035483462172,0.705710102489019
7085,0.7205,2,0,2,676243,201,125776,480,0.0015920035483462172,0.7048458149779736
7086,0.7207,0,1,0,676244,200,125776,480,0.0015840831326828031,0.7058823529411765
7087,0.7208,2,1,2,676245,199,125778,478,0.0015761627170193893,0.7060561299852289
7088,0.721,1,0,1,676245,199,125779,477,0.0015761627170193893,0.7056213017751479
7089,0.7212,1,1,1,676246,198,125780,476,0.0015682423013559752,0.7062314540059347
7090,0.7213,1,1,1,676247,197,125781,475,0.001560321885692561,0.7068452380952381
7091,0.7216,0,1,0,676248,196,125781,475,0.001552401470029147,0.7078986587183308
7092,0.7218,1,0,1,676248,196,125782,474,0.001552401470029147,0.7074626865671642
7093,0.722,1,1,1,676249,195,125783,473,0.0015444810543657332,0.7080838323353293
7094,0.7221,2,0,2,676249,195,125785,471,0.0015444810543657332,0.7072072072072072
7095,0.7222,1,0,1,676249,195,125786,470,0.0015444810543657332,0.706766917293233
7096,0.7223,2,2,2,676251,193,125788,468,0.001528640223038905,0.708018154311649
7097,0.7225,1,0,1,676251,193,125789,467,0.001528640223038905,0.7075757575757575
7098,0.7226,0,1,0,676252,192,125789,467,0.0015207198073754911,0.708649468892261
7099,0.7229,1,1,1,676253,191,125790,466,0.001512799391712077,0.7092846270928462
7100,0.7231,1,0,1,676253,191,125791,465,0.001512799391712077,0.7088414634146342
7101,0.7233,2,1,2,676254,190,125793,463,0.001504878976048663,0.7090352220520674
7102,0.7234,1,1,1,676255,189,125794,462,0.0014969585603852491,0.7096774193548387
7103,0.7236,3,0,3,676255,189,125797,459,0.0014969585603852491,0.7083333333333334
7104,0.7239,1,0,1,676255,189,125798,458,0.0014969585603852491,0.7078825347758887
7105,0.724,0,2,0,676257,187,125798,458,0.001481117729058421,0.710077519379845
7106,0.7241,3,0,3,676257,187,125801,455,0.001481117729058421,0.7087227414330218
7107,0.7243,0,1,0,676258,186,125801,455,0.0014731973133950069,0.7098283931357254
7108,0.7244,3,0,3,676258,186,125804,452,0.0014731973133950069,0.7084639498432602
7109,0.7245,2,0,2,676258,186,125806,450,0.0014731973133950069,0.7075471698113207
7110,0.7246,1,1,1,676259,185,125807,449,0.001465276897731593,0.7082018927444795
7111,0.7251,1,0,1,676259,185,125808,448,0.001465276897731593,0.707740916271722
7112,0.7253,1,1,1,676260,184,125809,447,0.001457356482068179,0.7083993660855784
7113,0.7254,0,1,0,676261,183,125809,447,0.0014494360664047648,0.7095238095238096
7114,0.7255,1,0,1,676261,183,125810,446,0.0014494360664047648,0.7090620031796503
7115,0.7257,2,1,2,676262,182,125812,444,0.001441515650741351,0.7092651757188498
7116,0.7258,1,0,1,676262,182,125813,443,0.001441515650741351,0.7088
7117,0.7259,1,0,1,676262,182,125814,442,0.001441515650741351,0.7083333333333334
7118,0.726,2,0,2,676262,182,125816,440,0.001441515650741351,0.707395498392283
7119,0.7262,0,1,0,676263,181,125816,440,0.001433595235077937,0.7085346215780999
7120,0.7263,1,0,1,676263,181,125817,439,0.001433595235077937,0.7080645161290322
7121,0.7264,0,1,0,676264,180,125817,439,0.0014256748194145228,0.7092084006462036
7122,0.7265,4,0,4,676264,180,125821,435,0.0014256748194145228,0.7073170731707317
7123,0.7267,4,0,4,676264,180,125825,431,0.0014256748194145228,0.7054009819967266
7124,0.7268,3,1,3,676265,179,125828,428,0.001417754403751109,0.7051070840197694
7125,0.7269,1,0,1,676265,179,125829,427,0.001417754403751109,0.7046204620462047
7126,0.727,0,2,0,676267,177,125829,427,0.0014019135724242808,0.706953642384106
7127,0.7271,2,1,2,676268,176,125831,425,0.0013939931567608667,0.7071547420965059
7128,0.7274,2,1,2,676269,175,125833,423,0.0013860727410974528,0.7073578595317725
7129,0.7275,0,1,0,676270,174,125833,423,0.0013781523254340388,0.7085427135678392
7130,0.7277,0,3,0,676273,171,125833,423,0.0013543910784437967,0.7121212121212122
7131,0.7278,2,0,2,676273,171,125835,421,0.0013543910784437967,0.7111486486486487
7132,0.7279,1,1,1,676274,170,125836,420,0.0013464706627803827,0.711864406779661
7133,0.7281,1,1,1,676275,169,125837,419,0.0013385502471169688,0.7125850340136054
7134,0.7282,1,1,1,676276,168,125838,418,0.0013306298314535547,0.7133105802047781
7135,0.7284,1,1,1,676277,167,125839,417,0.0013227094157901406,0.714041095890411
7136,0.7285,0,1,0,676278,166,125839,417,0.0013147890001267266,0.7152658662092625
7137,0.7286,2,0,2,676278,166,125841,415,0.0013147890001267266,0.7142857142857143
7138,0.7288,3,3,3,676281,163,125844,412,0.0012910277531364845,0.7165217391304348
7139,0.7289,0,1,0,676282,162,125844,412,0.0012831073374730707,0.7177700348432056
7140,0.729,0,1,0,676283,161,125844,412,0.0012751869218096566,0.7190226876090751
7141,0.7291,1,0,1,676283,161,125845,411,0.0012751869218096566,0.7185314685314685
7142,0.7292,0,1,0,676284,160,125845,411,0.0012672665061462425,0.7197898423817863
7143,0.7294,2,0,2,676284,160,125847,409,0.0012672665061462425,0.718804920913884
7144,0.7295,0,2,0,676286,158,125847,409,0.0012514256748194146,0.7213403880070547
7145,0.7296,1,1,1,676287,157,125848,408,0.0012435052591560005,0.7221238938053097
7146,0.7297,2,1,2,676288,156,125850,406,0.0012355848434925864,0.7224199288256228
7147,0.7298,3,0,3,676288,156,125853,403,0.0012355848434925864,0.7209302325581395
7148,0.7299,1,1,1,676289,155,125854,402,0.0012276644278291725,0.7217235188509874
7149,0.7301,1,0,1,676289,155,125855,401,0.0012276644278291725,0.7212230215827338
7150,0.7303,2,1,2,676290,154,125857,399,0.0012197440121657585,0.7215189873417721
7151,0.7304,2,0,2,676290,154,125859,397,0.0012197440121657585,0.720508166969147
7152,0.7305,1,0,1,676290,154,125860,396,0.0012197440121657585,0.72
7153,0.7306,1,1,1,676291,153,125861,395,0.0012118235965023444,0.7208029197080292
7154,0.7307,1,1,1,676292,152,125862,394,0.0012039031808389305,0.7216117216117216
7155,0.7308,3,1,3,676293,151,125865,391,0.0011959827651755164,0.7214022140221402
7156,0.731,3,0,3,676293,151,125868,388,0.0011959827651755164,0.7198515769944341
7157,0.7311,3,0,3,676293,151,125871,385,0.0011959827651755164,0.7182835820895522
7158,0.7312,2,0,2,676293,151,125873,383,0.0011959827651755164,0.7172284644194756
7159,0.7313,1,0,1,676293,151,125874,382,0.0011959827651755164,0.7166979362101313
7160,0.7314,0,1,0,676294,150,125874,382,0.0011880623495121023,0.7180451127819549
7161,0.7316,1,1,1,676295,149,125875,381,0.0011801419338486885,0.7188679245283018
7162,0.7317,1,0,1,676295,149,125876,380,0.0011801419338486885,0.718336483931947
7163,0.7318,1,0,1,676295,149,125877,379,0.0011801419338486885,0.7178030303030303
7164,0.7319,1,3,1,676298,146,125878,378,0.0011563806868584462,0.7213740458015268
7165,0.732,1,0,1,676298,146,125879,377,0.0011563806868584462,0.7208413001912046
7166,0.7321,2,0,2,676298,146,125881,375,0.0011563806868584462,0.7197696737044146
7167,0.7322,2,0,2,676298,146,125883,373,0.0011563806868584462,0.7186897880539499
7168,0.7323,2,1,2,676299,145,125885,371,0.0011484602711950324,0.7189922480620154
7169,0.7324,1,0,1,676299,145,125886,370,0.0011484602711950324,0.7184466019417476
7170,0.7325,2,0,2,676299,145,125888,368,0.0011484602711950324,0.7173489278752436
7171,0.7326,0,1,0,676300,144,125888,368,0.0011405398555316183,0.71875
7172,0.7328,1,1,1,676301,143,125889,367,0.0011326194398682042,0.7196078431372549
7173,0.7329,1,1,1,676302,142,125890,366,0.0011246990242047904,0.7204724409448819
7174,0.733,2,0,2,676302,142,125892,364,0.0011246990242047904,0.7193675889328063
7175,0.7331,2,0,2,676302,142,125894,362,0.0011246990242047904,0.7182539682539683
7176,0.7333,2,0,2,676302,142,125896,360,0.0011246990242047904,0.7171314741035857
7177,0.7334,0,1,0,676303,141,125896,360,0.0011167786085413763,0.718562874251497
7178,0.7336,1,0,1,676303,141,125897,359,0.0011167786085413763,0.718
7179,0.7337,2,0,2,676303,141,125899,357,0.0011167786085413763,0.7168674698795181
7180,0.7338,2,0,2,676303,141,125901,355,0.0011167786085413763,0.7157258064516129
7181,0.7341,1,1,1,676304,140,125902,354,0.0011088581928779622,0.7165991902834008
7182,0.7344,0,1,0,676305,139,125902,354,0.0011009377772145481,0.718052738336714
7183,0.7345,0,1,0,676306,138,125902,354,0.0010930173615511342,0.7195121951219512
7184,0.7346,1,0,1,676306,138,125903,353,0.0010930173615511342,0.7189409368635438
7185,0.7347,1,0,1,676306,138,125904,352,0.0010930173615511342,0.7183673469387755
7186,0.7348,1,0,1,676306,138,125905,351,0.0010930173615511342,0.7177914110429447
7187,0.7349,1,0,1,676306,138,125906,350,0.0010930173615511342,0.7172131147540983
7188,0.7351,1,0,1,676306,138,125907,349,0.0010930173615511342,0.7166324435318275
7189,0.7352,2,2,2,676308,136,125909,347,0.001077176530224306,0.7184265010351967
7190,0.7353,1,0,1,676308,136,125910,346,0.001077176530224306,0.7178423236514523
7191,0.7354,0,1,0,676309,135,125910,346,0.0010692561145608922,0.7193347193347194
7192,0.7355,2,1,2,676310,134,125912,344,0.0010613356988974781,0.7196652719665272
7193,0.7356,0,1,0,676311,133,125912,344,0.001053415283234064,0.7211740041928721
7194,0.7358,1,0,1,676311,133,125913,343,0.001053415283234064,0.7205882352941176
7195,0.7359,2,0,2,676311,133,125915,341,0.001053415283234064,0.7194092827004219
7196,0.736,0,1,0,676312,132,125915,341,0.0010454948675706502,0.7209302325581395
7197,0.7361,1,1,1,676313,131,125916,340,0.0010375744519072361,0.721868365180467
7198,0.7362,2,1,2,676314,130,125918,338,0.001029654036243822,0.7222222222222222
7199,0.7364,0,1,0,676315,129,125918,338,0.001021733620580408,0.7237687366167024
7200,0.7366,2,0,2,676315,129,125920,336,0.001021733620580408,0.7225806451612903
7201,0.7367,1,0,1,676315,129,125921,335,0.001021733620580408,0.7219827586206896
7202,0.7368,1,0,1,676315,129,125922,334,0.001021733620580408,0.7213822894168467
7203,0.7369,3,0,3,676315,129,125925,331,0.001021733620580408,0.7195652173913043
7204,0.7372,2,0,2,676315,129,125927,329,0.001021733620580408,0.7183406113537117
7205,0.7373,2,0,2,676315,129,125929,327,0.001021733620580408,0.7171052631578947
7206,0.7374,0,1,0,676316,128,125929,327,0.001013813204916994,0.7186813186813187
7207,0.7376,2,0,2,676316,128,125931,325,0.001013813204916994,0.717439293598234
7208,0.7377,3,0,3,676316,128,125934,322,0.001013813204916994,0.7155555555555555
7209,0.7379,1,1,1,676317,127,125935,321,0.00100589278925358,0.7165178571428571
7210,0.738,1,1,1,676318,126,125936,320,0.000997972373590166,0.7174887892376681
7211,0.7382,1,0,1,676318,126,125937,319,0.000997972373590166,0.7168539325842697
7212,0.7384,0,1,0,676319,125,125937,319,0.000990051957926752,0.7184684684684685
7213,0.7385,2,0,2,676319,125,125939,317,0.000990051957926752,0.7171945701357466
7214,0.7386,1,0,1,676319,125,125940,316,0.000990051957926752,0.7165532879818595
7215,0.7387,1,1,1,676320,124,125941,315,0.000982131542263338,0.7175398633257403
7216,0.7388,2,0,2,676320,124,125943,313,0.000982131542263338,0.7162471395881007
7217,0.7389,1,0,1,676320,124,125944,312,0.000982131542263338,0.7155963302752294
7218,0.739,1,0,1,676320,124,125945,311,0.000982131542263338,0.7149425287356321
7219,0.7391,3,1,3,676321,123,125948,308,0.000974211126599924,0.7146171693735499
7220,0.7392,1,0,1,676321,123,125949,307,0.000974211126599924,0.713953488372093
7221,0.7393,1,0,1,676321,123,125950,306,0.000974211126599924,0.7132867132867133
7222,0.7395,0,1,0,676322,122,125950,306,0.0009662907109365099,0.7149532710280374
7223,0.7396,2,0,2,676322,122,125952,304,0.0009662907109365099,0.7136150234741784
7224,0.7397,1,1,1,676323,121,125953,303,0.000958370295273096,0.714622641509434
7225,0.74,0,1,0,676324,120,125953,303,0.0009504498796096819,0.7163120567375887
7226,0.7401,1,0,1,676324,120,125954,302,0.0009504498796096819,0.7156398104265402
7227,0.7402,1,0,1,676324,120,125955,301,0.0009504498796096819,0.7149643705463183
7228,0.7403,1,0,1,676324,120,125956,300,0.0009504498796096819,0.7142857142857143
7229,0.7405,1,0,1,676324,120,125957,299,0.0009504498796096819,0.7136038186157518
7230,0.7406,1,0,1,676324,120,125958,298,0.0009504498796096819,0.7129186602870813
7231,0.7407,1,0,1,676324,120,125959,297,0.0009504498796096819,0.7122302158273381
7232,0.7408,0,1,0,676325,119,125959,297,0.0009425294639462679,0.7139423076923077
7233,0.7411,0,1,0,676326,118,125959,297,0.0009346090482828539,0.7156626506024096
7234,0.7412,1,0,1,676326,118,125960,296,0.0009346090482828539,0.714975845410628
7235,0.7414,1,0,1,676326,118,125961,295,0.0009346090482828539,0.7142857142857143
7236,0.7415,0,1,0,676327,117,125961,295,0.0009266886326194399,0.7160194174757282
7237,0.7416,0,1,0,676328,116,125961,295,0.0009187682169560259,0.7177615571776156
7238,0.7419,2,0,2,676328,116,125963,293,0.0009187682169560259,0.7163814180929096
7239,0.7425,1,0,1,676328,116,125964,292,0.0009187682169560259,0.7156862745098039
7240,0.7427,1,1,1,676329,115,125965,291,0.0009108478012926118,0.7167487684729064
7241,0.7428,2,0,2,676329,115,125967,289,0.0009108478012926118,0.7153465346534653
7242,0.743,1,0,1,676329,115,125968,288,0.0009108478012926118,0.7146401985111662
7243,0.7432,0,1,0,676330,114,125968,288,0.0009029273856291978,0.7164179104477612
7244,0.7433,3,0,3,676330,114,125971,285,0.0009029273856291978,0.7142857142857143
7245,0.7434,2,0,2,676330,114,125973,283,0.0009029273856291978,0.7128463476070529
7246,0.7435,2,1,2,676331,113,125975,281,0.0008950069699657839,0.7131979695431472
7247,0.7437,1,1,1,676332,112,125976,280,0.0008870865543023698,0.7142857142857143
7248,0.7438,0,2,0,676334,110,125976,280,0.0008712457229755417,0.717948717948718
7249,0.7439,1,1,1,676335,109,125977,279,0.0008633253073121277,0.7190721649484536
7250,0.744,1,1,1,676336,108,125978,278,0.0008554048916487138,0.7202072538860104
7251,0.7441,1,0,1,676336,108,125979,277,0.0008554048916487138,0.7194805194805195
7252,0.7443,0,2,0,676338,106,125979,277,0.0008395640603218857,0.7232375979112271
7253,0.7444,1,1,1,676339,105,125980,276,0.0008316436446584716,0.7244094488188977
7254,0.7445,3,1,3,676340,104,125983,273,0.0008237232289950577,0.7241379310344828
7255,0.7447,1,0,1,676340,104,125984,272,0.0008237232289950577,0.723404255319149
7256,0.7448,2,0,2,676340,104,125986,270,0.0008237232289950577,0.7219251336898396
7257,0.7451,1,0,1,676340,104,125987,269,0.0008237232289950577,0.7211796246648794
7258,0.7454,2,2,2,676342,102,125989,267,0.0008078823976682296,0.7235772357723578
7259,0.7455,1,0,1,676342,102,125990,266,0.0008078823976682296,0.7228260869565217
7260,0.7456,1,0,1,676342,102,125991,265,0.0008078823976682296,0.7220708446866485
7261,0.7457,1,0,1,676342,102,125992,264,0.0008078823976682296,0.7213114754098361
7262,0.7458,1,0,1,676342,102,125993,263,0.0008078823976682296,0.7205479452054795
7263,0.7459,1,0,1,676342,102,125994,262,0.0008078823976682296,0.7197802197802198
7264,0.746,1,0,1,676342,102,125995,261,0.0008078823976682296,0.71900826446281
7265,0.7463,2,1,2,676343,101,125997,259,0.0007999619820048156,0.7194444444444444
7266,0.7464,3,0,3,676343,101,126000,256,0.0007999619820048156,0.7170868347338936
7267,0.7465,1,0,1,676343,101,126001,255,0.0007999619820048156,0.7162921348314607
7268,0.7466,1,0,1,676343,101,126002,254,0.0007999619820048156,0.7154929577464789
7269,0.7468,0,1,0,676344,100,126002,254,0.0007920415663414016,0.7175141242937854
7270,0.7469,1,0,1,676344,100,126003,253,0.0007920415663414016,0.71671388101983
7271,0.747,2,0,2,676344,100,126005,251,0.0007920415663414016,0.7150997150997151
7272,0.7471,1,1,1,676345,99,126006,250,0.0007841211506779876,0.7163323782234957
7273,0.7473,1,0,1,676345,99,126007,249,0.0007841211506779876,0.7155172413793104
7274,0.7474,1,0,1,676345,99,126008,248,0.0007841211506779876,0.7146974063400576
7275,0.7477,1,2,1,676347,97,126009,247,0.0007682803193511595,0.7180232558139535
7276,0.7478,2,0,2,676347,97,126011,245,0.0007682803193511595,0.716374269005848
7277,0.7479,0,1,0,676348,96,126011,245,0.0007603599036877456,0.718475073313783
7278,0.7481,1,0,1,676348,96,126012,244,0.0007603599036877456,0.7176470588235294
7279,0.7483,0,1,0,676349,95,126012,244,0.0007524394880243315,0.7197640117994101
7280,0.7484,1,0,1,676349,95,126013,243,0.0007524394880243315,0.7189349112426036
7281,0.7487,1,0,1,676349,95,126014,242,0.0007524394880243315,0.7181008902077152
7282,0.7488,1,0,1,676349,95,126015,241,0.0007524394880243315,0.7172619047619048
7283,0.7489,1,2,1,676351,93,126016,240,0.0007365986566975034,0.7207207207207207
7284,0.7491,0,1,0,676352,92,126016,240,0.0007286782410340895,0.7228915662650602
7285,0.7492,0,1,0,676353,91,126016,240,0.0007207578253706755,0.7250755287009063
7286,0.7493,0,1,0,676354,90,126016,240,0.0007128374097072614,0.7272727272727273
7287,0.7494,1,0,1,676354,90,126017,239,0.0007128374097072614,0.7264437689969605
7288,0.7496,1,1,1,676355,89,126018,238,0.0007049169940438474,0.72782874617737
7289,0.7497,1,0,1,676355,89,126019,237,0.0007049169940438474,0.7269938650306749
7290,0.7498,2,0,2,676355,89,126021,235,0.0007049169940438474,0.7253086419753086
7291,0.7499,1,0,1,676355,89,126022,234,0.0007049169940438474,0.7244582043343654
7292,0.75,0,1,0,676356,88,126022,234,0.0006969965783804334,0.7267080745341615
7293,0.7504,1,0,1,676356,88,126023,233,0.0006969965783804334,0.7258566978193146
7294,0.7507,0,1,0,676357,87,126023,233,0.0006890761627170194,0.728125
7295,0.7509,1,1,1,676358,86,126024,232,0.0006811557470536054,0.7295597484276729
7296,0.751,1,0,1,676358,86,126025,231,0.0006811557470536054,0.7287066246056783
7297,0.7511,1,0,1,676358,86,126026,230,0.0006811557470536054,0.7278481012658228
7298,0.7513,3,1,3,676359,85,126029,227,0.0006732353313901913,0.7275641025641025
7299,0.7515,1,0,1,676359,85,126030,226,0.0006732353313901913,0.7266881028938906
7300,0.7517,1,1,1,676360,84,126031,225,0.0006653149157267774,0.7281553398058253
7301,0.7519,0,2,0,676362,82,126031,225,0.0006494740843999493,0.7328990228013029
7302,0.752,0,1,0,676363,81,126031,225,0.0006415536687365353,0.7352941176470589
7303,0.7521,2,0,2,676363,81,126033,223,0.0006415536687365353,0.7335526315789473
7304,0.7522,1,0,1,676363,81,126034,222,0.0006415536687365353,0.7326732673267327
7305,0.7525,1,1,1,676364,80,126035,221,0.0006336332530731213,0.7342192691029901
7306,0.7526,0,1,0,676365,79,126035,221,0.0006257128374097073,0.7366666666666667
7307,0.7527,1,0,1,676365,79,126036,220,0.0006257128374097073,0.7357859531772575
7308,0.753,1,0,1,676365,79,126037,219,0.0006257128374097073,0.7348993288590604
7309,0.7532,1,0,1,676365,79,126038,218,0.0006257128374097073,0.734006734006734
7310,0.7533,1,0,1,676365,79,126039,217,0.0006257128374097073,0.7331081081081081
7311,0.7535,1,1,1,676366,78,126040,216,0.0006177924217462932,0.7346938775510204
7312,0.7536,2,0,2,676366,78,126042,214,0.0006177924217462932,0.7328767123287672
7313,0.7537,1,1,1,676367,77,126043,213,0.0006098720060828792,0.7344827586206897
7314,0.7538,2,0,2,676367,77,126045,211,0.0006098720060828792,0.7326388888888888
7315,0.754,2,0,2,676367,77,126047,209,0.0006098720060828792,0.7307692307692307
7316,0.7541,0,1,0,676368,76,126047,209,0.0006019515904194653,0.7333333333333333
7317,0.7542,1,0,1,676368,76,126048,208,0.0006019515904194653,0.7323943661971831
7318,0.7545,1,0,1,676368,76,126049,207,0.0006019515904194653,0.7314487632508834
7319,0.7547,0,1,0,676369,75,126049,207,0.0005940311747560512,0.7340425531914894
7320,0.7548,2,0,2,676369,75,126051,205,0.0005940311747560512,0.7321428571428571
7321,0.755,1,0,1,676369,75,126052,204,0.0005940311747560512,0.7311827956989247
7322,0.7557,0,1,0,676370,74,126052,204,0.0005861107590926372,0.7338129496402878
7323,0.7558,2,0,2,676370,74,126054,202,0.0005861107590926372,0.7318840579710145
7324,0.7559,1,0,1,676370,74,126055,201,0.0005861107590926372,0.730909090909091
7325,0.756,1,0,1,676370,74,126056,200,0.0005861107590926372,0.7299270072992701
7326,0.7561,2,0,2,676370,74,126058,198,0.0005861107590926372,0.7279411764705882
7327,0.7562,0,1,0,676371,73,126058,198,0.0005781903434292231,0.7306273062730627
7328,0.7564,1,0,1,676371,73,126059,197,0.0005781903434292231,0.7296296296296296
7329,0.7565,0,1,0,676372,72,126059,197,0.0005702699277658091,0.7323420074349443
7330,0.7568,1,1,1,676373,71,126060,196,0.0005623495121023952,0.7340823970037453
7331,0.7569,0,1,0,676374,70,126060,196,0.0005544290964389811,0.7368421052631579
7332,0.757,1,1,1,676375,69,126061,195,0.0005465086807755671,0.7386363636363636
7333,0.7571,1,0,1,676375,69,126062,194,0.0005465086807755671,0.7376425855513308
7334,0.7572,0,1,0,676376,68,126062,194,0.000538588265112153,0.7404580152671756
7335,0.7573,1,0,1,676376,68,126063,193,0.000538588265112153,0.7394636015325671
7336,0.7574,0,1,0,676377,67,126063,193,0.0005306678494487391,0.7423076923076923
7337,0.7575,1,1,1,676378,66,126064,192,0.0005227474337853251,0.7441860465116279
7338,0.7576,1,0,1,676378,66,126065,191,0.0005227474337853251,0.7431906614785992
7339,0.7577,1,0,1,676378,66,126066,190,0.0005227474337853251,0.7421875
7340,0.7584,1,0,1,676378,66,126067,189,0.0005227474337853251,0.7411764705882353
7341,0.7588,1,0,1,676378,66,126068,188,0.0005227474337853251,0.7401574803149606
7342,0.759,0,1,0,676379,65,126068,188,0.000514827018121911,0.7430830039525692
7343,0.7595,1,0,1,676379,65,126069,187,0.000514827018121911,0.7420634920634921
7344,0.7598,2,0,2,676379,65,126071,185,0.000514827018121911,0.74
7345,0.76,0,1,0,676380,64,126071,185,0.000506906602458497,0.7429718875502008
7346,0.7602,0,1,0,676381,63,126071,185,0.000498986186795083,0.7459677419354839
7347,0.7606,1,0,1,676381,63,126072,184,0.000498986186795083,0.7449392712550608
7348,0.761,1,0,1,676381,63,126073,183,0.000498986186795083,0.7439024390243902
7349,0.7612,1,0,1,676381,63,126074,182,0.000498986186795083,0.7428571428571429
7350,0.7613,1,1,1,676382,62,126075,181,0.000491065771131669,0.7448559670781894
7351,0.7614,1,1,1,676383,61,126076,180,0.00048314535546825497,0.7468879668049793
7352,0.7616,0,1,0,676384,60,126076,180,0.00047522493980484094,0.75
7353,0.7617,1,0,1,676384,60,126077,179,0.00047522493980484094,0.7489539748953975
7354,0.7618,1,0,1,676384,60,126078,178,0.00047522493980484094,0.7478991596638656
7355,0.7619,0,1,0,676385,59,126078,178,0.00046730452414142697,0.7510548523206751
7356,0.7621,1,0,1,676385,59,126079,177,0.00046730452414142697,0.75
7357,0.7622,1,0,1,676385,59,126080,176,0.00046730452414142697,0.7489361702127659
7358,0.7623,0,1,0,676386,58,126080,176,0.00045938410847801294,0.7521367521367521
7359,0.7626,2,0,2,676386,58,126082,174,0.00045938410847801294,0.75
7360,0.763,1,0,1,676386,58,126083,173,0.00045938410847801294,0.7489177489177489
7361,0.7631,1,0,1,676386,58,126084,172,0.00045938410847801294,0.7478260869565218
7362,0.7635,1,0,1,676386,58,126085,171,0.00045938410847801294,0.7467248908296943
7363,0.7636,0,1,0,676387,57,126085,171,0.0004514636928145989,0.75
7364,0.7638,1,0,1,676387,57,126086,170,0.0004514636928145989,0.748898678414097
7365,0.764,0,1,0,676388,56,126086,170,0.0004435432771511849,0.7522123893805309
7366,0.7641,1,0,1,676388,56,126087,169,0.0004435432771511849,0.7511111111111111
7367,0.7642,0,1,0,676389,55,126087,169,0.00043562286148777086,0.7544642857142857
7368,0.7645,3,1,3,676390,54,126090,166,0.0004277024458243569,0.7545454545454545
7369,0.7648,1,0,1,676390,54,126091,165,0.0004277024458243569,0.7534246575342466
7370,0.7649,0,1,0,676391,53,126091,165,0.00041978203016094286,0.7568807339449541
7371,0.765,1,0,1,676391,53,126092,164,0.00041978203016094286,0.7557603686635944
7372,0.7652,0,1,0,676392,52,126092,164,0.00041186161449752884,0.7592592592592593
7373,0.7654,0,1,0,676393,51,126092,164,0.0004039411988341148,0.7627906976744186
7374,0.7656,1,0,1,676393,51,126093,163,0.0004039411988341148,0.7616822429906542
7375,0.7659,1,0,1,676393,51,126094,162,0.0004039411988341148,0.7605633802816901
7376,0.7668,2,0,2,676393,51,126096,160,0.0004039411988341148,0.7582938388625592
7377,0.7669,1,0,1,676393,51,126097,159,0.0004039411988341148,0.7571428571428571
7378,0.767,0,1,0,676394,50,126097,159,0.0003960207831707008,0.7607655502392344
7379,0.7682,1,0,1,676394,50,126098,158,0.0003960207831707008,0.7596153846153846
7380,0.7683,2,0,2,676394,50,126100,156,0.0003960207831707008,0.7572815533980582
7381,0.7684,1,0,1,676394,50,126101,155,0.0003960207831707008,0.7560975609756098
7382,0.7686,1,0,1,676394,50,126102,154,0.0003960207831707008,0.7549019607843137
7383,0.7688,2,0,2,676394,50,126104,152,0.0003960207831707008,0.7524752475247525
7384,0.769,0,1,0,676395,49,126104,152,0.00038810036750728676,0.7562189054726368
7385,0.7691,1,0,1,676395,49,126105,151,0.00038810036750728676,0.755
7386,0.7692,1,0,1,676395,49,126106,150,0.00038810036750728676,0.7537688442211056
7387,0.7694,1,0,1,676395,49,126107,149,0.00038810036750728676,0.7525252525252525
7388,0.7696,1,0,1,676395,49,126108,148,0.00038810036750728676,0.751269035532995
7389,0.7698,1,0,1,676395,49,126109,147,0.00038810036750728676,0.75
7390,0.7699,1,0,1,676395,49,126110,146,0.00038810036750728676,0.7487179487179487
7391,0.77,0,1,0,676396,48,126110,146,0.0003801799518438728,0.7525773195876289
7392,0.7701,0,1,0,676397,47,126110,146,0.00037225953618045876,0.7564766839378239
7393,0.7702,0,1,0,676398,46,126110,146,0.00036433912051704473,0.7604166666666666
7394,0.7705,1,0,1,676398,46,126111,145,0.00036433912051704473,0.7591623036649214
7395,0.7708,1,0,1,676398,46,126112,144,0.00036433912051704473,0.7578947368421053
7396,0.7714,1,0,1,676398,46,126113,143,0.00036433912051704473,0.7566137566137566
7397,0.7716,2,0,2,676398,46,126115,141,0.00036433912051704473,0.7540106951871658
7398,0.7719,0,1,0,676399,45,126115,141,0.0003564187048536307,0.7580645161290323
7399,0.7724,1,0,1,676399,45,126116,140,0.0003564187048536307,0.7567567567567568
7400,0.773,1,0,1,676399,45,126117,139,0.0003564187048536307,0.7554347826086957
7401,0.7731,0,1,0,676400,44,126117,139,0.0003484982891902167,0.7595628415300546
7402,0.7735,1,0,1,676400,44,126118,138,0.0003484982891902167,0.7582417582417582
7403,0.7737,2,0,2,676400,44,126120,136,0.0003484982891902167,0.7555555555555555
7404,0.7741,1,0,1,676400,44,126121,135,0.0003484982891902167,0.7541899441340782
7405,0.7742,0,1,0,676401,43,126121,135,0.0003405778735268027,0.7584269662921348
7406,0.7744,1,0,1,676401,43,126122,134,0.0003405778735268027,0.7570621468926554
7407,0.7747,1,0,1,676401,43,126123,133,0.0003405778735268027,0.7556818181818182
7408,0.7752,0,1,0,676402,42,126123,133,0.0003326574578633887,0.76
7409,0.7757,1,0,1,676402,42,126124,132,0.0003326574578633887,0.7586206896551724
7410,0.7759,0,1,0,676403,41,126124,132,0.00032473704219997465,0.7630057803468208
7411,0.7761,0,1,0,676404,40,126124,132,0.0003168166265365606,0.7674418604651163
7412,0.7764,0,1,0,676405,39,126124,132,0.0003088962108731466,0.7719298245614035
7413,0.7767,0,1,0,676406,38,126124,132,0.00030097579520973263,0.7764705882352941
7414,0.7769,0,1,0,676407,37,126124,132,0.0002930553795463186,0.7810650887573964
7415,0.777,1,0,1,676407,37,126125,131,0.0002930553795463186,0.7797619047619048
7416,0.7771,1,0,1,676407,37,126126,130,0.0002930553795463186,0.7784431137724551
7417,0.7774,1,0,1,676407,37,126127,129,0.0002930553795463186,0.7771084337349398
7418,0.7777,1,0,1,676407,37,126128,128,0.0002930553795463186,0.7757575757575758
7419,0.7784,1,1,1,676408,36,126129,127,0.0002851349638829046,0.7791411042944786
7420,0.7789,1,0,1,676408,36,126130,126,0.0002851349638829046,0.7777777777777778
7421,0.779,0,1,0,676409,35,126130,126,0.00027721454821949055,0.782608695652174
7422,0.7792,1,0,1,676409,35,126131,125,0.00027721454821949055,0.78125
7423,0.7794,1,0,1,676409,35,126132,124,0.00027721454821949055,0.779874213836478
7424,0.7802,1,1,1,676410,34,126133,123,0.0002692941325560765,0.7834394904458599
7425,0.7803,1,0,1,676410,34,126134,122,0.0002692941325560765,0.782051282051282
7426,0.7804,1,0,1,676410,34,126135,121,0.0002692941325560765,0.7806451612903226
7427,0.7806,0,1,0,676411,33,126135,121,0.00026137371689266255,0.7857142857142857
7428,0.7808,0,1,0,676412,32,126135,121,0.0002534533012292485,0.7908496732026143
7429,0.7809,1,0,1,676412,32,126136,120,0.0002534533012292485,0.7894736842105263
7430,0.781,1,0,1,676412,32,126137,119,0.0002534533012292485,0.7880794701986755
7431,0.7811,1,1,1,676413,31,126138,118,0.0002455328855658345,0.7919463087248322
7432,0.7812,1,0,1,676413,31,126139,117,0.0002455328855658345,0.7905405405405406
7433,0.7813,1,0,1,676413,31,126140,116,0.0002455328855658345,0.7891156462585034
7434,0.7815,2,0,2,676413,31,126142,114,0.0002455328855658345,0.7862068965517242
7435,0.7817,2,0,2,676413,31,126144,112,0.0002455328855658345,0.7832167832167832
7436,0.7822,1,0,1,676413,31,126145,111,0.0002455328855658345,0.7816901408450704
7437,0.7828,1,0,1,676413,31,126146,110,0.0002455328855658345,0.7801418439716312
7438,0.7829,0,1,0,676414,30,126146,110,0.00023761246990242047,0.7857142857142857
7439,0.783,1,0,1,676414,30,126147,109,0.00023761246990242047,0.7841726618705036
7440,0.7832,2,0,2,676414,30,126149,107,0.00023761246990242047,0.781021897810219
7441,0.7834,1,0,1,676414,30,126150,106,0.00023761246990242047,0.7794117647058824
7442,0.7847,1,0,1,676414,30,126151,105,0.00023761246990242047,0.7777777777777778
7443,0.7856,1,0,1,676414,30,126152,104,0.00023761246990242047,0.7761194029850746
7444,0.7859,1,0,1,676414,30,126153,103,0.00023761246990242047,0.7744360902255639
7445,0.7861,0,1,0,676415,29,126153,103,0.00022969205423900647,0.7803030303030303
7446,0.7866,2,0,2,676415,29,126155,101,0.00022969205423900647,0.7769230769230769
7447,0.7868,1,0,1,676415,29,126156,100,0.00022969205423900647,0.7751937984496124
7448,0.7871,1,0,1,676415,29,126157,99,0.00022969205423900647,0.7734375
7449,0.7872,1,0,1,676415,29,126158,98,0.00022969205423900647,0.7716535433070866
7450,0.7876,2,0,2,676415,29,126160,96,0.00022969205423900647,0.768
7451,0.7882,1,0,1,676415,29,126161,95,0.00022969205423900647,0.7661290322580645
7452,0.7883,1,0,1,676415,29,126162,94,0.00022969205423900647,0.7642276422764228
7453,0.7887,1,0,1,676415,29,126163,93,0.00022969205423900647,0.7622950819672131
7454,0.7888,1,0,1,676415,29,126164,92,0.00022969205423900647,0.7603305785123967
7455,0.7891,3,0,3,676415,29,126167,89,0.00022969205423900647,0.7542372881355932
7456,0.7892,1,0,1,676415,29,126168,88,0.00022969205423900647,0.7521367521367521
7457,0.7896,1,0,1,676415,29,126169,87,0.00022969205423900647,0.75
7458,0.7898,1,0,1,676415,29,126170,86,0.00022969205423900647,0.7478260869565218
7459,0.79,1,0,1,676415,29,126171,85,0.00022969205423900647,0.7456140350877193
7460,0.7904,1,1,1,676416,28,126172,84,0.00022177163857559244,0.75
7461,0.7906,1,0,1,676416,28,126173,83,0.00022177163857559244,0.7477477477477478
7462,0.791,1,1,1,676417,27,126174,82,0.00021385122291217844,0.7522935779816514
7463,0.7912,2,0,2,676417,27,126176,80,0.00021385122291217844,0.7476635514018691
7464,0.7925,1,0,1,676417,27,126177,79,0.00021385122291217844,0.7452830188679245
7465,0.7926,0,1,0,676418,26,126177,79,0.00020593080724876442,0.7523809523809524
7466,0.7928,1,0,1,676418,26,126178,78,0.00020593080724876442,0.75
7467,0.7932,0,1,0,676419,25,126178,78,0.0001980103915853504,0.7572815533980582
7468,0.7934,1,1,1,676420,24,126179,77,0.0001900899759219364,0.7623762376237624
7469,0.7937,0,1,0,676421,23,126179,77,0.00018216956025852237,0.77
7470,0.7938,1,0,1,676421,23,126180,76,0.00018216956025852237,0.7676767676767676
7471,0.7939,2,0,2,676421,23,126182,74,0.00018216956025852237,0.7628865979381443
7472,0.794,1,0,1,676421,23,126183,73,0.00018216956025852237,0.7604166666666666
7473,0.7942,1,1,1,676422,22,126184,72,0.00017424914459510834,0.7659574468085106
7474,0.7944,1,0,1,676422,22,126185,71,0.00017424914459510834,0.7634408602150538
7475,0.7946,2,0,2,676422,22,126187,69,0.00017424914459510834,0.7582417582417582
7476,0.7951,1,1,1,676423,21,126188,68,0.00016632872893169434,0.7640449438202247
7477,0.7956,1,0,1,676423,21,126189,67,0.00016632872893169434,0.7613636363636364
7478,0.7959,1,0,1,676423,21,126190,66,0.00016632872893169434,0.7586206896551724
7479,0.7966,1,0,1,676423,21,126191,65,0.00016632872893169434,0.7558139534883721
7480,0.797,1,0,1,676423,21,126192,64,0.00016632872893169434,0.7529411764705882
7481,0.7972,1,0,1,676423,21,126193,63,0.00016632872893169434,0.75
7482,0.7975,1,1,1,676424,20,126194,62,0.0001584083132682803,0.7560975609756098
7483,0.7977,1,0,1,676424,20,126195,61,0.0001584083132682803,0.7530864197530864
7484,0.799,0,1,0,676425,19,126195,61,0.00015048789760486631,0.7625
7485,0.7993,1,1,1,676426,18,126196,60,0.0001425674819414523,0.7692307692307693
7486,0.7996,0,1,0,676427,17,126196,60,0.00013464706627803826,0.7792207792207793
7487,0.7997,1,0,1,676427,17,126197,59,0.00013464706627803826,0.7763157894736842
7488,0.8001,1,0,1,676427,17,126198,58,0.00013464706627803826,0.7733333333333333
7489,0.8004,1,0,1,676427,17,126199,57,0.00013464706627803826,0.7702702702702703
7490,0.8012,1,0,1,676427,17,126200,56,0.00013464706627803826,0.7671232876712328
7491,0.802,1,0,1,676427,17,126201,55,0.00013464706627803826,0.7638888888888888
7492,0.8023,1,0,1,676427,17,126202,54,0.00013464706627803826,0.7605633802816901
7493,0.803,1,1,1,676428,16,126203,53,0.00012672665061462426,0.7681159420289855
7494,0.8031,1,0,1,676428,16,126204,52,0.00012672665061462426,0.7647058823529411
7495,0.8032,1,0,1,676428,16,126205,51,0.00012672665061462426,0.7611940298507462
7496,0.8038,0,1,0,676429,15,126205,51,0.00011880623495121023,0.7727272727272727
7497,0.8039,1,0,1,676429,15,126206,50,0.00011880623495121023,0.7692307692307693
7498,0.8047,1,0,1,676429,15,126207,49,0.00011880623495121023,0.765625
7499,0.806,1,0,1,676429,15,126208,48,0.00011880623495121023,0.7619047619047619
7500,0.8061,1,0,1,676429,15,126209,47,0.00011880623495121023,0.7580645161290323
7501,0.8073,1,0,1,676429,15,126210,46,0.00011880623495121023,0.7540983606557377
7502,0.8076,1,0,1,676429,15,126211,45,0.00011880623495121023,0.75
7503,0.8079,1,0,1,676429,15,126212,44,0.00011880623495121023,0.7457627118644068
7504,0.8082,1,0,1,676429,15,126213,43,0.00011880623495121023,0.7413793103448276
7505,0.8086,1,0,1,676429,15,126214,42,0.00011880623495121023,0.7368421052631579
7506,0.8087,1,0,1,676429,15,126215,41,0.00011880623495121023,0.7321428571428571
7507,0.809,1,0,1,676429,15,126216,40,0.00011880623495121023,0.7272727272727273
7508,0.8097,1,0,1,676429,15,126217,39,0.00011880623495121023,0.7222222222222222
7509,0.8102,1,0,1,676429,15,126218,38,0.00011880623495121023,0.7169811320754716
7510,0.8107,1,0,1,676429,15,126219,37,0.00011880623495121023,0.7115384615384616
7511,0.8117,1,0,1,676429,15,126220,36,0.00011880623495121023,0.7058823529411765
7512,0.8118,1,0,1,676429,15,126221,35,0.00011880623495121023,0.7
7513,0.8119,0,1,0,676430,14,126221,35,0.00011088581928779622,0.7142857142857143
7514,0.812,1,0,1,676430,14,126222,34,0.00011088581928779622,0.7083333333333334
7515,0.8129,1,0,1,676430,14,126223,33,0.00011088581928779622,0.7021276595744681
7516,0.8134,2,0,2,676430,14,126225,31,0.00011088581928779622,0.6888888888888889
7517,0.8135,1,0,1,676430,14,126226,30,0.00011088581928779622,0.6818181818181818
7518,0.8155,0,1,0,676431,13,126226,30,0.00010296540362438221,0.6976744186046512
7519,0.8162,1,2,1,676433,11,126227,29,8.712457229755417e-05,0.725
7520,0.8168,0,1,0,676434,10,126227,29,7.920415663414016e-05,0.7435897435897436
7521,0.8173,1,0,1,676434,10,126228,28,7.920415663414016e-05,0.7368421052631579
7522,0.8181,1,1,1,676435,9,126229,27,7.128374097072614e-05,0.75
7523,0.8185,1,0,1,676435,9,126230,26,7.128374097072614e-05,0.7428571428571429
7524,0.8198,1,0,1,676435,9,126231,25,7.128374097072614e-05,0.7352941176470589
7525,0.8201,1,0,1,676435,9,126232,24,7.128374097072614e-05,0.7272727272727273
7526,0.8208,0,1,0,676436,8,126232,24,6.336332530731213e-05,0.75
7527,0.8224,0,1,0,676437,7,126232,24,5.544290964389811e-05,0.7741935483870968
7528,0.8241,1,0,1,676437,7,126233,23,5.544290964389811e-05,0.7666666666666667
7529,0.8246,1,0,1,676437,7,126234,22,5.544290964389811e-05,0.7586206896551724
7530,0.8257,1,0,1,676437,7,126235,21,5.544290964389811e-05,0.75
7531,0.826,1,0,1,676437,7,126236,20,5.544290964389811e-05,0.7407407407407407
7532,0.8267,0,1,0,676438,6,126236,20,4.75224939804841e-05,0.7692307692307693
7533,0.8271,1,0,1,676438,6,126237,19,4.75224939804841e-05,0.76
7534,0.8273,1,0,1,676438,6,126238,18,4.75224939804841e-05,0.75
7535,0.8277,1,0,1,676438,6,126239,17,4.75224939804841e-05,0.7391304347826086
7536,0.8286,3,0,3,676438,6,126242,14,4.75224939804841e-05,0.7
7537,0.8288,0,1,0,676439,5,126242,14,3.960207831707008e-05,0.7368421052631579
7538,0.8303,1,0,1,676439,5,126243,13,3.960207831707008e-05,0.7222222222222222
7539,0.8318,1,0,1,676439,5,126244,12,3.960207831707008e-05,0.7058823529411765
7540,0.8328,1,0,1,676439,5,126245,11,3.960207831707008e-05,0.6875
7541,0.8329,0,1,0,676440,4,126245,11,3.1681662653656065e-05,0.7333333333333333
7542,0.8333,0,1,0,676441,3,126245,11,2.376124699024205e-05,0.7857142857142857
7543,0.8371,0,1,0,676442,2,126245,11,1.5840831326828033e-05,0.8461538461538461
7544,0.8372,0,1,0,676443,1,126245,11,7.920415663414016e-06,0.9166666666666666
7545,0.8378,1,0,1,676443,1,126246,10,7.920415663414016e-06,0.9090909090909091
7546,0.8398,1,0,1,676443,1,126247,9,7.920415663414016e-06,0.9
7547,0.8417,1,0,1,676443,1,126248,8,7.920415663414016e-06,0.8888888888888888
7548,0.8423,1,0,1,676443,1,126249,7,7.920415663414016e-06,0.875
7549,0.8459,1,0,1,676443,1,126250,6,7.920415663414016e-06,0.8571428571428571
7550,0.8477,1,0,1,676443,1,126251,5,7.920415663414016e-06,0.8333333333333334
7551,0.8492,1,0,1,676443,1,126252,4,7.920415663414016e-06,0.8
7552,0.8521,1,0,1,676443,1,126253,3,7.920415663414016e-06,0.75
7553,0.8523,1,0,1,676443,1,126254,2,7.920415663414016e-06,0.6666666666666666
7554,0.8525,0,1,0,676444,0,126254,2,0.0,1.0
7555,0.8624,1,0,1,676444,0,126255,1,0.0,1.0
7556,0.8839,1,0,1,676444,0,126256,0,0.0,
