,y_proba,y_test,Neg,Pos,TN,FP,FN,TP,FP/P,Prec
0,0.1426,0,1,0,1,605609,0,107956,5.609776205120605,0.1512910526721462
1,0.1433,0,1,0,2,605608,0,107956,5.609766942087517,0.15129126469384666
2,0.1442,0,1,0,3,605607,0,107956,5.60975767905443,0.1512914767161414
3,0.145,0,2,0,5,605605,0,107956,5.609739152988254,0.15129190076251364
4,0.1455,0,1,0,6,605604,0,107956,5.609729889955167,0.1512921127865912
5,0.1464,0,5,0,11,605599,0,107956,5.609683574789729,0.15129317291589295
6,0.1467,0,1,0,12,605598,0,107956,5.609674311756642,0.15129338494353617
7,0.149,0,3,0,15,605595,0,107956,5.609646522657379,0.15129402103003148
8,0.1501,0,1,0,16,605594,0,107956,5.609637259624291,0.15129423306005185
9,0.1517,0,1,0,17,605593,0,107956,5.609627996591204,0.1512944450906665
10,0.1525,0,2,0,19,605591,0,107956,5.609609470525029,0.15129486915367873
11,0.1533,0,1,0,20,605590,0,107956,5.609600207491941,0.1512950811860763
12,0.1561,0,1,0,21,605589,0,107956,5.609590944458853,0.15129529321906818
13,0.1563,0,6,0,27,605583,0,107956,5.609535366260328,0.1512965654295
14,0.157,0,9,0,36,605574,0,107956,5.60945199896254,0.15129847378526481
15,0.1572,0,3,0,39,605571,0,107956,5.609424209863278,0.15129910991455123
16,0.1575,0,3,0,42,605568,0,107956,5.609396420764015,0.15129974604918686
17,0.1579,1,29,1,71,605539,1,107955,5.609127792804476,0.15130470613628144
18,0.1586,0,55,0,126,605484,1,107955,5.6086183259846605,0.1513163704255024
19,0.1589,0,6,0,132,605478,1,107955,5.608562747786135,0.15131764300221603
20,0.159,0,2,0,134,605476,1,107955,5.60854422171996,0.15131806719921057
21,0.1592,0,7,0,141,605469,1,107955,5.6084793804883475,0.1513195519074211
22,0.1596,0,41,0,182,605428,1,107955,5.6080995961317575,0.15132824864063202
23,0.1599,0,2,0,184,605426,1,107955,5.608081070065582,0.15132867289709145
24,0.1616,0,32,0,216,605394,1,107955,5.607784653006781,0.15133546132398026
25,0.162,0,2,0,218,605392,1,107955,5.607766126940605,0.15133588562088296
26,0.1624,0,1,0,219,605391,1,107955,5.607756863907518,0.1513360977702265
27,0.1627,0,2,0,221,605389,1,107955,5.607738337841343,0.151336522070698
28,0.1629,0,28,0,249,605361,1,107955,5.607478972914891,0.15134246252712683
29,0.1636,0,1,0,250,605360,1,107955,5.607469709881804,0.1513426746949104
30,0.1641,0,2,0,252,605358,1,107955,5.607451183815629,0.15134309903226215
31,0.1646,0,1,0,253,605357,1,107955,5.6074419207825414,0.15134331120183034
32,0.1649,0,1,0,254,605356,1,107955,5.607432657749453,0.15134352337199342
33,0.1656,0,21,0,275,605335,1,107955,5.607238134054615,0.15134797908284148
34,0.1658,0,1,0,276,605334,1,107955,5.607228871021527,0.1513481912660927
35,0.166,0,5,0,281,605329,1,107955,5.60718255585609,0.15134925219127304
36,0.1662,2,41,2,322,605288,3,107953,5.6068027714995,0.15135557266057337
37,0.1663,0,7,0,329,605281,3,107953,5.606737930267887,0.15135705813239414
38,0.1666,0,19,0,348,605262,3,107953,5.606561932639224,0.1513610902743212
39,0.1667,0,1,0,349,605261,3,107953,5.606552669606136,0.1513613024982684
40,0.1668,0,1,0,350,605260,3,107953,5.606543406573048,0.15136151472281073
41,0.1671,0,37,0,387,605223,3,107953,5.606200674348809,0.15136936744926918
42,0.1672,0,3,0,390,605220,3,107953,5.6061728852495465,0.15137000419253113
43,0.1674,0,2,0,392,605218,3,107953,5.606154359183371,0.1513704286910152
44,0.1678,0,18,0,410,605200,3,107953,5.605987624587795,0.15137424928451537
45,0.1683,0,14,0,424,605186,3,107953,5.605857942124569,0.15137722099057827
46,0.1685,1,3,1,427,605183,4,107952,5.605830153025306,0.1513766678118449
47,0.1687,0,1,0,428,605182,4,107952,5.605820889992219,0.15137688008144332
48,0.169,0,5,0,433,605177,4,107952,5.605774574826781,0.15137794143836528
49,0.1692,0,3,0,436,605174,4,107952,5.6057467857275185,0.1513785782596624
50,0.1694,0,2,0,438,605172,4,107952,5.605728259661343,0.15137900281017047
51,0.1695,0,3,0,441,605169,4,107952,5.6057004705620805,0.15137963964039763
52,0.1696,1,44,1,485,605125,5,107951,5.605292897106229,0.15138779036175667
53,0.1697,0,1,0,486,605124,5,107951,5.605283634073141,0.15138800266451635
54,0.1698,0,4,0,490,605120,5,107951,5.605246581940791,0.1513888518815097
55,0.1701,0,1,0,491,605119,5,107951,5.605237318907703,0.15138906418724668
56,0.1707,0,5,0,496,605114,5,107951,5.605191003742266,0.1513901257248638
57,0.171,0,5,0,501,605109,5,107951,5.605144688576828,0.15139118727736797
58,0.1712,0,3,0,504,605106,5,107951,5.605116899477565,0.15139182421601638
59,0.1715,1,21,1,525,605085,6,107950,5.604922375782726,0.15139509280750593
60,0.1719,0,1,0,526,605084,6,107950,5.604913112749639,0.15139530513271457
61,0.172,0,1,0,527,605083,6,107950,5.6049038497165515,0.15139551745851876
62,0.1721,0,2,0,529,605081,6,107950,5.604885323650376,0.1513959421119138
63,0.1722,0,1,0,530,605080,6,107950,5.604876060617289,0.15139615443950466
64,0.1724,1,7,1,537,605073,7,107949,5.604811219385676,0.15139645060040224
65,0.1725,0,24,0,561,605049,7,107949,5.604588906591574,0.15140154670840592
66,0.1726,0,2,0,563,605047,7,107949,5.6045703805253995,0.15140197139955905
67,0.1729,0,2,0,565,605045,7,107949,5.604551854459224,0.15140239609309475
68,0.173,0,5,0,570,605040,7,107949,5.604505539293786,0.15140345783735795
69,0.1732,0,1,0,571,605039,7,107949,5.604496276260699,0.15140367018799755
70,0.1734,0,7,0,578,605032,7,107949,5.604431435029086,0.1514051566591536
71,0.1736,0,2,0,580,605030,7,107949,5.604412908962911,0.1514055813705593
72,0.1737,0,3,0,583,605027,7,107949,5.6043851198636485,0.1514062184421355
73,0.1739,0,1,0,584,605026,7,107949,5.60437585683056,0.15140643080051897
74,0.1741,0,3,0,587,605023,7,107949,5.604348067731298,0.15140706787924352
75,0.1743,0,1,0,588,605022,7,107949,5.6043388046982106,0.15140728024000977
76,0.1747,0,11,0,599,605011,7,107949,5.604236911334247,0.15140961624775584
77,0.1748,0,1,0,600,605010,7,107949,5.60422764830116,0.15140982861567076
78,0.175,0,4,0,604,605006,7,107949,5.604190596168809,0.1514106780932878
79,0.1752,1,13,1,617,604993,8,107948,5.604070176738671,0.15141224869940148
80,0.1755,0,5,0,622,604988,8,107948,5.604023861573234,0.15141331059169408
81,0.1756,0,1,0,623,604987,8,107948,5.604014598540146,0.15141352297193994
82,0.1757,0,12,0,635,604975,8,107948,5.603903442143095,0.15141607158136292
83,0.1758,0,30,0,665,604945,8,107948,5.6036255511504685,0.15142244348029787
84,0.1759,0,3,0,668,604942,8,107948,5.603597762051206,0.15142308069968718
85,0.1761,0,4,0,672,604938,8,107948,5.603560709918856,0.15142393033388227
86,0.1762,0,2,0,674,604936,8,107948,5.603542183852681,0.1514243551545553
87,0.1765,0,11,0,685,604925,8,107948,5.6034402904887175,0.15142669171086576
88,0.1767,0,3,0,688,604922,8,107948,5.603412501389455,0.15142732896601063
89,0.1768,0,2,0,690,604920,8,107948,5.6033939753232795,0.15142775380575366
90,0.177,0,15,0,705,604905,8,107948,5.6032550298269665,0.15143094017981268
91,0.1773,0,28,0,733,604877,8,107948,5.602995664900515,0.15143688843685338
92,0.1774,0,3,0,736,604874,8,107948,5.602967875801252,0.1514375257778239
93,0.1777,0,10,0,746,604864,8,107948,5.6028752454703765,0.15143965028647105
94,0.1778,0,4,0,750,604860,8,107948,5.602838193338027,0.15144050010662058
95,0.1779,0,6,0,756,604854,8,107948,5.6027826151395015,0.15144177485472823
96,0.1783,0,1,0,757,604853,8,107948,5.602773352106413,0.1514419873148326
97,0.1784,0,1,0,758,604852,8,107948,5.602764089073326,0.1514421997755331
98,0.1785,0,1,0,759,604851,8,107948,5.602754826040239,0.15144241223682975
99,0.1786,0,1,0,760,604850,8,107948,5.602745563007151,0.1514426246987225
100,0.1788,0,1,0,761,604849,8,107948,5.6027362999740635,0.1514428371612114
101,0.1789,0,2,0,763,604847,8,107948,5.602717773907888,0.15144326208797762
102,0.179,0,37,0,800,604810,8,107948,5.602375041683649,0.15145112366329105
103,0.1792,0,3,0,803,604807,8,107948,5.602347252584386,0.15145176112408892
104,0.1793,0,10,0,813,604797,8,107948,5.60225462225351,0.1514538860321714
105,0.1795,0,15,0,828,604782,8,107948,5.602115676757197,0.15145707350609627
106,0.1797,0,2,0,830,604780,8,107948,5.602097150691022,0.1514574985127566
107,0.1799,0,1,0,831,604779,8,107948,5.602087887657935,0.15145771101698124
108,0.18,0,4,0,835,604775,8,107948,5.602050835525585,0.15145856103984298
109,0.1801,1,15,1,850,604760,9,107947,5.601911890029271,0.15146055812556913
110,0.1802,0,2,0,852,604758,9,107947,5.601893363963096,0.15146098315572362
111,0.1803,0,18,0,870,604740,9,107947,5.60172662936752,0.15146480853446184
112,0.1804,0,13,0,883,604727,9,107947,5.601606209937382,0.15146757142817052
113,0.1805,0,1,0,884,604726,9,107947,5.601596946904294,0.15146778396263083
114,0.1806,0,2,0,886,604724,9,107947,5.601578420838119,0.15146820903334077
115,0.1807,0,1,0,887,604723,9,107947,5.601569157805032,0.15146842156959042
116,0.1808,0,13,0,900,604710,9,107947,5.601448738374893,0.15147118459511377
117,0.1809,3,33,3,933,604677,12,107944,5.601143058283005,0.15147462676513884
118,0.181,0,23,0,956,604654,12,107944,5.60093000852199,0.15147951579993207
119,0.1811,0,3,0,959,604651,12,107944,5.600902219422728,0.15148015352338987
120,0.1812,0,2,0,961,604649,12,107944,5.600883693356552,0.15148057867534484
121,0.1813,0,4,0,965,604645,12,107944,5.600846641224202,0.15148142898641434
122,0.1814,0,7,0,972,604638,12,107944,5.60078179999259,0.15148291705375663
123,0.1815,0,8,0,980,604630,12,107944,5.600707695727889,0.15148461773794722
124,0.1817,0,7,0,987,604623,12,107944,5.600642854496276,0.15148610586793942
125,0.1819,0,36,0,1023,604587,12,107944,5.600309385305124,0.15149375956975908
126,0.182,2,26,2,1049,604561,14,107942,5.600068546444848,0.15149690597793974
127,0.1821,0,13,0,1062,604548,14,107942,5.599948127014709,0.15149967017080943
128,0.1822,0,11,0,1073,604537,14,107942,5.599846233650746,0.15150200918202503
129,0.1823,0,35,0,1108,604502,14,107942,5.599522027492682,0.15150945197096194
130,0.1824,3,30,3,1138,604472,17,107939,5.599244136500055,0.1515122590751687
131,0.1825,1,3,1,1141,604469,18,107938,5.599216347400793,0.1515117060893562
132,0.1828,0,2,0,1143,604467,18,107938,5.599197821334617,0.15151213144208703
133,0.183,0,9,0,1152,604458,18,107938,5.59911445403683,0.1515140455589307
134,0.1831,1,10,1,1162,604448,19,107937,5.599021823705955,0.15151498136541336
135,0.1832,0,1,0,1163,604447,19,107937,5.5990125606728665,0.15151519405264577
136,0.1833,0,5,0,1168,604442,19,107937,5.598966245507429,0.15151625749776454
137,0.1834,0,1,0,1169,604441,19,107937,5.598956982474341,0.15151647018857967
138,0.1835,0,4,0,1173,604437,19,107937,5.598919930341991,0.15151732095781148
139,0.1839,0,8,0,1181,604429,19,107937,5.598845826077291,0.151519022524938
140,0.184,0,1,0,1182,604428,19,107937,5.598836563044204,0.15151923522351604
141,0.1841,1,19,1,1201,604409,20,107936,5.59866056541554,0.15152208550632068
142,0.1842,0,6,0,1207,604403,20,107936,5.598604987217015,0.15152336177016842
143,0.1843,0,5,0,1212,604398,20,107936,5.598558672051577,0.15152442533979846
144,0.1844,0,4,0,1216,604394,20,107936,5.598521619919226,0.15152527620625272
145,0.1847,0,3,0,1219,604391,20,107936,5.598493830819963,0.15152591436236448
146,0.1848,1,10,1,1229,604381,21,107935,5.598401200489088,0.15152685044278102
147,0.1849,0,3,0,1232,604378,21,107935,5.598373411389826,0.15152748861806536
148,0.185,0,4,0,1236,604374,21,107935,5.598336359257475,0.15152833952680647
149,0.1851,1,3,1,1239,604371,22,107934,5.5983085701582125,0.151527786552109
150,0.1852,1,2,1,1241,604369,23,107933,5.598290044092037,0.1515270208422832
151,0.1854,3,8,3,1249,604361,26,107930,5.5982159398273375,0.15152514913146453
152,0.1855,0,9,0,1258,604352,26,107930,5.598132572529549,0.15152706371914496
153,0.1856,0,1,0,1259,604351,26,107930,5.5981233094964615,0.15152727645409605
154,0.1857,0,6,0,1265,604345,26,107930,5.598067731297936,0.15152855287634692
155,0.1858,0,1,0,1266,604344,26,107930,5.598058468264848,0.15152876561547943
156,0.1859,0,1,0,1267,604343,26,107930,5.598049205231761,0.15152897835520932
157,0.186,1,5,1,1272,604338,27,107929,5.598002890066323,0.15152885083823903
158,0.1861,0,2,0,1274,604336,27,107929,5.5979843640001485,0.15152927632271695
159,0.1862,0,23,0,1297,604313,27,107929,5.597771314239134,0.15153416956596213
160,0.1863,0,4,0,1301,604309,27,107929,5.597734262106784,0.15153502059704763
161,0.1864,0,2,0,1303,604307,27,107929,5.597715736040609,0.15153544611617498
162,0.1865,0,3,0,1306,604304,27,107929,5.597687946941346,0.15153608439934685
163,0.1866,0,5,0,1311,604299,27,107929,5.597641631775908,0.15153714821658232
164,0.1867,0,6,0,1317,604293,27,107929,5.597586053577383,0.1515384248169812
165,0.1868,0,4,0,1321,604289,27,107929,5.597549001445033,0.15153927589586336
166,0.1869,0,6,0,1327,604283,27,107929,5.597493423246508,0.15154055253211124
167,0.1871,2,1,2,1328,604282,29,107927,5.59748416021342,0.1515383826938441
168,0.1872,0,3,0,1331,604279,29,107927,5.597456371114157,0.15153902101358316
169,0.1873,0,6,0,1337,604273,29,107927,5.597400792915632,0.15154029766919405
170,0.1874,0,3,0,1340,604270,29,107927,5.59737300381637,0.15154093600506602
171,0.1875,0,3,0,1343,604267,29,107927,5.597345214717107,0.15154157434631574
172,0.1876,1,6,1,1349,604261,30,107926,5.597289636518582,0.1515416597045439
173,0.1877,1,7,1,1356,604254,31,107925,5.5972247952869685,0.15154195785048422
174,0.1878,2,52,2,1408,604202,33,107923,5.596743117566416,0.15155064068808144
175,0.1879,1,9,1,1417,604193,34,107922,5.596659750268628,0.15155136459701032
176,0.1881,0,3,0,1420,604190,34,107922,5.596631961169365,0.1515520030556991
177,0.1882,0,10,0,1430,604180,34,107922,5.59653933083849,0.15155413129018033
178,0.1883,0,8,0,1438,604172,34,107922,5.596465226573789,0.1515558339208026
179,0.1885,1,31,1,1469,604141,35,107921,5.596178072548075,0.15156124045378072
180,0.1886,1,14,1,1483,604127,36,107920,5.5960483900848494,0.15156302884500603
181,0.1887,0,33,0,1516,604094,36,107920,5.59574270999296,0.15157005339782645
182,0.1888,1,11,1,1527,604083,37,107919,5.595640816628997,0.15157120345167568
183,0.189,0,1,0,1528,604082,37,107919,5.59563155359591,0.15157141633228044
184,0.1891,0,6,0,1534,604076,37,107919,5.595575975397384,0.15157269362846648
185,0.1893,0,27,0,1561,604049,37,107919,5.59532587350402,0.1515784417277181
186,0.1894,1,24,1,1585,604025,38,107918,5.595103560709918,0.15158235982374993
187,0.1895,0,5,0,1590,604020,38,107918,5.595057245544481,0.15158342439931566
188,0.1896,1,7,1,1597,604013,39,107917,5.594992404312868,0.15158372311884596
189,0.1897,1,2,1,1599,604011,40,107916,5.594973878246693,0.15158295724140256
190,0.1898,0,8,0,1607,604003,40,107916,5.594899773981993,0.15158466061448
191,0.1901,0,2,0,1609,604001,40,107916,5.594881247915818,0.15158508646373103
192,0.1902,0,9,0,1618,603992,40,107916,5.59479788061803,0.15158700281497048
193,0.1903,0,10,0,1628,603982,40,107916,5.594705250287154,0.1515891321509542
194,0.1904,0,8,0,1636,603974,40,107916,5.594631146022453,0.15159083566281306
195,0.1905,0,4,0,1640,603970,40,107916,5.5945940938901035,0.15159168743310025
196,0.1906,0,1,0,1641,603969,40,107916,5.594584830857015,0.15159190037716766
197,0.1907,0,15,0,1656,603954,40,107916,5.594445885360702,0.15159509460997092
198,0.1908,0,4,0,1660,603950,40,107916,5.594408833228353,0.1515959464281199
199,0.1909,0,35,0,1695,603915,40,107916,5.594084627070288,0.15160340024528293
200,0.191,0,9,0,1704,603906,40,107916,5.5940012597725,0.15160531705960198
201,0.1911,0,11,0,1715,603895,40,107916,5.593899366408537,0.1516076598984843
202,0.1912,0,2,0,1717,603893,40,107916,5.593880840342361,0.1516080858769698
203,0.1913,4,42,4,1759,603851,44,107912,5.593491792952684,0.1516122641946828
204,0.1914,0,5,0,1764,603846,44,107912,5.593445477787247,0.1516133292495483
205,0.1915,0,1,0,1765,603845,44,107912,5.593436214754159,0.15161354226231705
206,0.1916,0,42,0,1807,603803,44,107912,5.593047167364482,0.15162248933913153
207,0.1917,0,3,0,1810,603800,44,107912,5.593019378265219,0.1516231284564543
208,0.1919,0,25,0,1835,603775,44,107912,5.59278780243803,0.15162845464368466
209,0.192,0,1,0,1836,603774,44,107912,5.592778539404943,0.15162866769895714
210,0.1921,0,3,0,1839,603771,44,107912,5.59275075030568,0.15162930686836695
211,0.1922,0,33,0,1872,603738,44,107912,5.592445070213791,0.15163633808754304
212,0.1923,0,36,0,1908,603702,44,107912,5.592111601022639,0.15164400925220695
213,0.1924,0,31,0,1939,603671,44,107912,5.591824446996925,0.15165061559930465
214,0.1925,0,2,0,1941,603669,44,107912,5.591805920930749,0.15165104183501246
215,0.1927,0,40,0,1981,603629,44,107912,5.5914353996072474,0.1516595670523554
216,0.1928,0,11,0,1992,603618,44,107912,5.591333506243284,0.15166191165516563
217,0.1929,0,25,0,2017,603593,44,107912,5.591101930416095,0.1516672405675294
218,0.193,1,11,1,2028,603582,45,107911,5.591000037052132,0.151668393083277
219,0.1931,0,12,0,2040,603570,45,107911,5.590888880655082,0.15167095115681234
220,0.1932,0,4,0,2044,603566,45,107911,5.590851828522731,0.15167180386716647
221,0.1935,0,10,0,2054,603556,45,107911,5.590759198191856,0.15167393568500015
222,0.1936,0,45,0,2099,603511,45,107911,5.590342361702916,0.15168352960689999
223,0.1937,1,3,1,2102,603508,46,107910,5.590314572603654,0.15168297681531814
224,0.1938,0,35,0,2137,603473,46,107910,5.589990366445589,0.15169043960848094
225,0.1939,0,14,0,2151,603459,46,107910,5.589860683982363,0.15169342493136473
226,0.1941,0,5,0,2156,603454,46,107910,5.589814368816925,0.151694491146586
227,0.1942,0,10,0,2166,603444,46,107910,5.58972173848605,0.15169662362199413
228,0.1943,0,4,0,2170,603440,46,107910,5.589684686353699,0.15169747662894498
229,0.1944,0,1,0,2171,603439,46,107910,5.589675423320612,0.1516976898821816
230,0.1945,0,2,0,2173,603437,46,107910,5.589656897254437,0.1516981163904536
231,0.1946,1,29,1,2202,603408,47,107909,5.589388269294898,0.15170310845937887
232,0.1947,0,3,0,2205,603405,47,107909,5.589360480195635,0.15170374827432048
233,0.1948,0,8,0,2213,603397,47,107909,5.589286375930935,0.15170545447388326
234,0.1949,0,7,0,2220,603390,47,107909,5.589221534699322,0.15170694742998372
235,0.195,0,11,0,2231,603379,47,107909,5.589119641335359,0.15170929356322616
236,0.1951,0,28,0,2259,603351,47,107909,5.588860276408908,0.15171526586620926
237,0.1953,0,13,0,2272,603338,47,107909,5.588739856978769,0.15171803888100757
238,0.1954,0,5,0,2277,603333,47,107909,5.588693541813331,0.15171910545215272
239,0.1955,0,12,0,2289,603321,47,107909,5.588582385416281,0.15172166528408532
240,0.1956,0,19,0,2308,603302,47,107909,5.588406387787617,0.15172571852797553
241,0.1957,2,13,2,2321,603289,49,107907,5.588285968357479,0.151726106446043
242,0.1959,0,1,0,2322,603288,49,107907,5.588276705324391,0.15172631978571277
243,0.196,3,13,3,2335,603275,52,107904,5.588156285894253,0.15172551495474415
244,0.1962,1,6,1,2341,603269,53,107903,5.588100707695728,0.15172560224530773
245,0.1963,0,5,0,2346,603264,53,107903,5.58805439253029,0.15172666898210968
246,0.1964,0,19,0,2365,603245,53,107903,5.587878394901627,0.15173072271875895
247,0.1965,0,3,0,2368,603242,53,107903,5.587850605802364,0.15173136280224145
248,0.1966,0,45,0,2413,603197,53,107903,5.587433769313424,0.15174096470257348
249,0.1967,0,2,0,2415,603195,53,107903,5.587415243247249,0.15174139148190544
250,0.1968,0,5,0,2420,603190,53,107903,5.587368928081811,0.15174245844073841
251,0.1969,0,8,0,2428,603182,53,107903,5.5872948238171105,0.15174416560608084
252,0.197,0,5,0,2433,603177,53,107903,5.5872485086516726,0.15174523260392642
253,0.1971,1,62,1,2495,603115,54,107902,5.586674200600244,0.1517572716264168
254,0.1972,0,2,0,2497,603113,54,107902,5.58665567453407,0.15175769850143808
255,0.1973,1,41,1,2538,603072,55,107901,5.58627589017748,0.1517652569084902
256,0.1974,0,6,0,2544,603066,55,107901,5.586220311978955,0.15176653768740322
257,0.1975,0,1,0,2545,603065,55,107901,5.5862110489458665,0.1517667511526571
258,0.1976,0,4,0,2549,603061,55,107901,5.586173996813517,0.15176760501967757
259,0.1977,1,0,1,2549,603061,56,107900,5.586173996813517,0.15176641194102067
260,0.1978,1,26,1,2575,603035,57,107899,5.5859331579532405,0.1517707691571932
261,0.1979,1,14,1,2589,603021,58,107898,5.585803475490015,0.15177256480696114
262,0.198,0,10,0,2599,603011,58,107898,5.585710845159139,0.15177469971543475
263,0.1981,0,1,0,2600,603010,58,107898,5.585701582126052,0.1517749132095855
264,0.1982,1,18,1,2618,602992,59,107897,5.585534847530475,0.15177756302320053
265,0.1983,0,6,0,2624,602986,59,107897,5.58547926933195,0.15177884405732026
266,0.1984,0,2,0,2626,602984,59,107897,5.585460743265775,0.15177927107349895
267,0.1985,1,3,1,2629,602981,60,107896,5.585432954166512,0.15177871839994822
268,0.1986,1,8,1,2637,602973,61,107895,5.585358849901811,0.151779233275376
269,0.1987,0,1,0,2638,602972,61,107895,5.585349586868724,0.15177944678821778
270,0.1988,0,21,0,2659,602951,61,107895,5.585155063173886,0.15178393069666285
271,0.1989,1,20,1,2679,602931,62,107894,5.584969802512134,0.15178700805402173
272,0.199,0,4,0,2683,602927,62,107894,5.584932750379784,0.1517878622044087
273,0.1991,0,7,0,2690,602920,62,107894,5.584867909148172,0.1517893569907177
274,0.1992,0,20,0,2710,602900,62,107894,5.58468264848642,0.15179362797097332
275,0.1993,1,3,1,2713,602897,63,107893,5.584654859387157,0.15179307531056993
276,0.1994,0,2,0,2715,602895,63,107893,5.584636333320983,0.1517935024226633
277,0.1995,2,19,2,2734,602876,65,107891,5.584460335692319,0.15179517338311993
278,0.1996,0,5,0,2739,602871,65,107891,5.584414020526881,0.15179624121717256
279,0.1997,1,15,1,2754,602856,66,107890,5.584275075030568,0.15179825141471073
280,0.1998,6,82,6,2836,602774,72,107884,5.583515506317388,0.15180860554584624
281,0.1999,0,6,0,2842,602768,72,107884,5.583459928118863,0.15180988725846126
282,0.2,1,19,1,2861,602749,73,107883,5.583283930490199,0.1518127525920589
283,0.2001,0,10,0,2871,602739,73,107883,5.583191300159324,0.15181488892829098
284,0.2002,3,65,3,2936,602674,76,107880,5.5825892030086335,0.15182519555163998
285,0.2003,1,6,1,2942,602668,77,107879,5.582533624810107,0.1518252839009946
286,0.2004,0,7,0,2949,602661,77,107879,5.582468783578495,0.15182677963239227
287,0.2005,0,12,0,2961,602649,77,107879,5.582357627181445,0.15182934381192578
288,0.2006,0,36,0,2997,602613,77,107879,5.5820241579902925,0.15183703687022515
289,0.2007,0,3,0,3000,602610,77,107879,5.58199636889103,0.15183767799360723
290,0.2008,1,11,1,3011,602599,78,107878,5.581894475527067,0.15183883503617993
291,0.2009,6,137,6,3148,602462,84,107872,5.580625439994072,0.1518609555504875
292,0.201,0,47,0,3195,602415,84,107872,5.580190077438957,0.1518710042560261
293,0.2011,0,15,0,3210,602400,84,107872,5.580051131942644,0.1518742115696522
294,0.2012,0,9,0,3219,602391,84,107872,5.579967764644855,0.15187613602285352
295,0.2013,3,88,3,3307,602303,87,107869,5.5791526177331505,0.15189137279419634
296,0.2014,0,3,0,3310,602300,87,107869,5.579124828633888,0.15189201443600045
297,0.2015,0,16,0,3326,602284,87,107869,5.578976620104487,0.1518954366171797
298,0.2016,1,6,1,3332,602278,88,107868,5.578921041905962,0.1518955257087979
299,0.2017,0,12,0,3344,602266,88,107868,5.578809885508911,0.15189809247268826
300,0.2018,0,12,0,3356,602254,88,107868,5.578698729111861,0.15190065932332755
301,0.2019,1,10,1,3366,602244,89,107867,5.578606098780985,0.15190160411541295
302,0.202,2,58,2,3424,602186,91,107865,5.5780688428619065,0.15191162324959756
303,0.2021,0,15,0,3439,602171,91,107865,5.5779298973655935,0.15191483248736684
304,0.2022,0,16,0,3455,602155,91,107865,5.577781688836192,0.1519182558237796
305,0.2023,0,25,0,3480,602130,91,107865,5.5775501130090035,0.15192360509581054
306,0.2024,1,32,1,3512,602098,92,107864,5.577253695950202,0.15192925818564937
307,0.2025,0,33,0,3545,602065,92,107864,5.576948015858313,0.15193632039260263
308,0.2026,0,13,0,3558,602052,92,107864,5.576827596428174,0.15193910265439856
309,0.2027,1,17,1,3575,602035,93,107863,5.576670124865686,0.151941546532037
310,0.2028,1,19,1,3594,602016,94,107862,5.576494127237022,0.1519444186184105
311,0.2029,0,3,0,3597,602013,94,107862,5.5764663381377595,0.15194506075013206
312,0.203,2,84,2,3681,601929,96,107860,5.575688243358405,0.1519606530954974
313,0.2031,3,91,3,3772,601838,99,107857,5.574845307347438,0.15197655330811122
314,0.2032,0,17,0,3789,601821,99,107857,5.57468783578495,0.15198019383438685
315,0.2034,1,19,1,3808,601802,100,107856,5.574511838156286,0.15198306790031255
316,0.2035,0,10,0,3818,601792,100,107856,5.57441920782541,0.15198520956868758
317,0.2036,0,50,0,3868,601742,100,107856,5.573956056171033,0.1519959188160057
318,0.2037,0,42,0,3910,601700,100,107856,5.573567008781356,0.15200491575013106
319,0.2038,0,5,0,3915,601695,100,107856,5.573520693615918,0.15200598688466369
320,0.2039,1,6,1,3921,601689,101,107855,5.573465115417393,0.15200607714250278
321,0.204,0,6,0,3927,601683,101,107855,5.573409537218867,0.152007362537313
322,0.2041,0,14,0,3941,601669,101,107855,5.573279854755641,0.15201036187641292
323,0.2042,1,12,1,3953,601657,102,107854,5.57316869835859,0.15201173766157255
324,0.2043,4,30,4,3983,601627,106,107850,5.5728908073659635,0.15201338450717924
325,0.2044,0,7,0,3990,601620,106,107850,5.572825966134351,0.15201488435028965
326,0.2045,0,2,0,3992,601618,106,107850,5.572807440068176,0.15201531288232872
327,0.2046,1,48,1,4040,601570,107,107849,5.572362814479973,0.15202440306786258
328,0.2047,0,1,0,4041,601569,107,107849,5.572353551446886,0.1520246173624013
329,0.2048,1,18,1,4059,601551,108,107848,5.57218681685131,0.1520272794294889
330,0.2049,0,2,0,4061,601549,108,107848,5.572168290785135,0.152027708039363
331,0.205,0,18,0,4079,601531,108,107848,5.572001556189559,0.15203156563698672
332,0.2051,0,25,0,4104,601506,108,107848,5.57176998036237,0.15203692373624453
333,0.2052,0,3,0,4107,601503,108,107848,5.571742191263107,0.1520375667335353
334,0.2053,0,40,0,4147,601463,108,107848,5.571371669939605,0.15204614055047785
335,0.2054,1,3,1,4150,601460,109,107847,5.571343880840343,0.15204558815858296
336,0.2055,0,25,0,4175,601435,109,107847,5.571112305013154,0.1520509472959979
337,0.2056,0,41,0,4216,601394,109,107847,5.570732520656564,0.15205973709923706
338,0.2057,1,30,1,4246,601364,110,107846,5.570454629663937,0.1520649737031345
339,0.2058,0,1,0,4247,601363,110,107846,5.5704453666308495,0.15206518811803008
340,0.2059,0,11,0,4258,601352,110,107846,5.570343473266886,0.15206754672178996
341,0.206,0,29,0,4287,601323,110,107846,5.570074845307348,0.1520737652097032
342,0.2061,0,14,0,4301,601309,110,107846,5.569945162844122,0.1520767674203806
343,0.2062,1,61,1,4362,601248,111,107845,5.569380117825781,0.15208865409755842
344,0.2063,0,7,0,4369,601241,111,107845,5.569315276594168,0.15209015549594831
345,0.2064,5,109,5,4478,601132,116,107840,5.568305605987625,0.1521075585495619
346,0.2065,5,50,5,4528,601082,121,107835,5.567842454333247,0.1521123065182525
347,0.2066,1,8,1,4536,601074,122,107834,5.567768350068547,0.15211282705231144
348,0.2067,0,31,0,4567,601043,122,107834,5.5674811960428325,0.15211947911979087
349,0.2068,4,49,4,4616,600994,126,107830,5.567027307421542,0.15212521020732933
350,0.2069,5,82,5,4698,600912,131,107825,5.566267738708363,0.15213682931750425
351,0.207,0,7,0,4705,600905,131,107825,5.5662028974767495,0.152138331945875
352,0.2071,0,34,0,4739,600871,131,107825,5.565887954351773,0.15214563084877014
353,0.2072,2,10,2,4749,600861,133,107823,5.565795324020898,0.15214538496706573
354,0.2073,0,20,0,4769,600841,133,107823,5.565610063359146,0.1521496788322816
355,0.2074,2,56,2,4825,600785,135,107821,5.565091333506243,0.1521593099691507
356,0.2075,0,9,0,4834,600776,135,107821,5.565007966208455,0.15216124256806055
357,0.2076,1,35,1,4869,600741,136,107820,5.564683760050391,0.15216756214355573
358,0.2077,1,6,1,4875,600735,137,107819,5.564628181851866,0.15216765412375063
359,0.2078,2,6,2,4881,600729,139,107817,5.56457260365334,0.15216654952536604
360,0.2079,0,1,0,4882,600728,139,107817,5.564563340620253,0.15216676428455497
361,0.208,0,67,0,4949,600661,139,107817,5.563942717403386,0.1521811545312628
362,0.2081,0,1,0,4950,600660,139,107817,5.563933454370299,0.15218136933167908
363,0.2082,0,6,0,4956,600654,139,107817,5.563877876171774,0.15218265814691073
364,0.2083,0,30,0,4986,600624,139,107817,5.563599985179147,0.15218910255052998
365,0.2084,0,11,0,4997,600613,139,107817,5.563498091815184,0.15219146563527802
366,0.2085,1,80,1,5077,600533,140,107816,5.562757049168179,0.1522074570585968
367,0.2086,1,43,1,5120,600490,141,107815,5.562358738745415,0.15221550038472126
368,0.2087,0,22,0,5142,600468,141,107815,5.562154952017488,0.15222022835505017
369,0.2088,2,26,2,5168,600442,143,107813,5.561914113157212,0.1522234223549428
370,0.2089,0,14,0,5182,600428,143,107813,5.5617844306939865,0.15222643139835168
371,0.209,3,22,3,5204,600406,146,107810,5.56158064396606,0.15222756899025155
372,0.2091,0,10,0,5214,600396,146,107810,5.561488013635184,0.1522297184717441
373,0.2093,2,49,2,5263,600347,148,107808,5.561034125013895,0.1522378575311902
374,0.2094,1,42,1,5305,600305,149,107807,5.560645077624217,0.15224568994735296
375,0.2095,1,19,1,5324,600286,150,107806,5.560469079995554,0.1522485778684126
376,0.2096,0,26,0,5350,600260,150,107806,5.5602282411352775,0.15225416839673137
377,0.2097,2,99,2,5449,600161,152,107804,5.559311200859609,0.1522730643464013
378,0.2098,0,11,0,5460,600150,152,107804,5.559209307495647,0.1522754303245691
379,0.2099,1,15,1,5475,600135,153,107803,5.559070361999333,0.15227745932553416
380,0.21,0,27,0,5502,600108,153,107803,5.5588202601059695,0.15228326724687144
381,0.2101,1,15,1,5517,600093,154,107802,5.558681314609656,0.1522852965482169
382,0.2102,4,57,4,5574,600036,158,107798,5.558153321723665,0.15229276920859974
383,0.2103,1,26,1,5600,600010,159,107797,5.557912482863388,0.15229716575281116
384,0.2104,0,4,0,5604,600006,159,107797,5.5578754307310385,0.15229802642825757
385,0.2105,4,85,4,5689,599921,163,107793,5.557088072918597,0.15231152697276018
386,0.2106,0,14,0,5703,599907,163,107793,5.556958390455371,0.1523145400593472
387,0.2107,0,8,0,5711,599899,163,107793,5.55688428619067,0.1523162618766356
388,0.2108,1,12,1,5723,599887,164,107792,5.55677312979362,0.15231764684270693
389,0.2109,1,45,1,5768,599842,165,107791,5.556356293304679,0.15232613515763113
390,0.211,0,26,0,5794,599816,165,107791,5.556115454444403,0.15233173216206172
391,0.2111,0,28,0,5822,599788,165,107791,5.555856089517952,0.15233776016529604
392,0.2112,0,4,0,5826,599784,165,107791,5.555819037385602,0.15233862134756032
393,0.2113,0,10,0,5836,599774,165,107791,5.555726407054726,0.15234077434581983
394,0.2114,0,3,0,5839,599771,165,107791,5.555698617955463,0.15234142025716474
395,0.2115,2,32,2,5871,599739,167,107789,5.555402200896662,0.15234591422530275
396,0.2116,5,91,5,5962,599648,172,107784,5.554559264885694,0.15235952006694636
397,0.2117,0,14,0,5976,599634,172,107784,5.554429582422468,0.15236253530444518
398,0.2118,1,18,1,5994,599616,173,107783,5.554262847826893,0.152365213974009
399,0.2119,0,20,0,6014,599596,173,107783,5.554077587165142,0.15236952185462108
400,0.212,0,14,0,6028,599582,173,107783,5.553947904701916,0.15237253751599245
401,0.2121,1,58,1,6086,599524,174,107782,5.553410648782838,0.1523838338710544
402,0.2122,1,20,1,6106,599504,175,107781,5.553225388121087,0.15238694444248074
403,0.2123,1,23,1,6129,599481,176,107780,5.553012338360072,0.1523907015938953
404,0.2124,3,24,3,6153,599457,179,107777,5.5527900255659715,0.1523922775205943
405,0.2125,0,53,0,6206,599404,179,107777,5.552299084812331,0.15240369862878103
406,0.2126,1,51,1,6257,599353,180,107776,5.551826670124866,0.15241349173913105
407,0.2127,0,4,0,6261,599349,180,107776,5.551789617992515,0.1524143538978257
408,0.2128,1,31,1,6292,599318,181,107775,5.551502463966801,0.15241983727741612
409,0.2129,0,23,0,6315,599295,181,107775,5.551289414205788,0.15242479528193814
410,0.213,2,25,2,6340,599270,183,107773,5.551057838378599,0.15242778727743575
411,0.2131,0,7,0,6347,599263,183,107773,5.550992997146986,0.1524292963866055
412,0.2132,1,43,1,6390,599220,184,107772,5.550594686724221,0.15243736845678593
413,0.2133,1,24,1,6414,599196,185,107771,5.55037237393012,0.15244134450405747
414,0.2134,0,2,0,6416,599194,185,107771,5.550353847863945,0.1524417757597618
415,0.2135,1,34,1,6450,599160,186,107770,5.550038904738968,0.15244790856237533
416,0.2136,1,18,1,6468,599142,187,107769,5.5498721701433915,0.15245059137571773
417,0.2137,1,27,1,6495,599115,188,107768,5.549622068250028,0.1524552153609579
418,0.2138,6,121,6,6616,598994,194,107762,5.548501241246433,0.15247412119599976
419,0.2139,0,2,0,6618,598992,194,107762,5.548482715180259,0.15247455267320736
420,0.214,0,58,0,6676,598934,194,107762,5.5479454592611805,0.15248706657459501
421,0.2141,1,22,1,6698,598912,195,107761,5.547741672533254,0.15249061447090803
422,0.2142,0,16,0,6714,598896,195,107761,5.547593464003853,0.15249406713582403
423,0.2143,0,6,0,6720,598890,195,107761,5.547537885805328,0.15249536192547666
424,0.2144,1,19,1,6739,598871,196,107760,5.547361888176664,0.15249826288402293
425,0.2145,0,8,0,6747,598863,196,107760,5.5472877839119645,0.1524999893861366
426,0.2146,2,57,2,6804,598806,198,107758,5.546759791025973,0.15250989294671113
427,0.2147,0,13,0,6817,598793,198,107758,5.546639371595836,0.15251269901252706
428,0.2148,5,94,5,6911,598699,203,107753,5.545768646485605,0.1525269940491357
429,0.2149,1,26,1,6937,598673,204,107752,5.545527807625329,0.15253140814665392
430,0.215,2,16,2,6953,598657,206,107750,5.545379599095928,0.15253246357977768
431,0.2151,0,27,0,6980,598630,206,107750,5.545129497202564,0.15253829383617884
432,0.2152,1,10,1,6990,598620,207,107749,5.545036866871689,0.1525392535629395
433,0.2153,0,4,0,6994,598616,207,107749,5.544999814739338,0.15254011736142079
434,0.2154,2,42,2,7036,598574,209,107747,5.544610767349661,0.15254678821668902
435,0.2155,0,19,0,7055,598555,209,107747,5.544434769720997,0.1525508918281415
436,0.2156,0,15,0,7070,598540,209,107747,5.544295824224684,0.1525541316773493
437,0.2157,0,5,0,7075,598535,209,107747,5.544249509059246,0.15255521165766647
438,0.2158,0,31,0,7106,598504,209,107747,5.543962355033532,0.1525619078769446
439,0.2159,5,108,5,7214,598396,214,107742,5.542961947460077,0.15257924088492616
440,0.216,4,186,4,7400,598210,218,107738,5.541239023305791,0.15261464017179735
441,0.2161,0,23,0,7423,598187,218,107738,5.5410259735447775,0.1526196125650742
442,0.2162,1,8,1,7431,598179,219,107737,5.540951869280077,0.15262014177324215
443,0.2163,2,24,2,7455,598155,221,107735,5.540729556485976,0.1526229299182592
444,0.2164,1,10,1,7465,598145,222,107734,5.5406369261551,0.15262389163015191
445,0.2165,2,15,2,7480,598130,224,107732,5.540497980658787,0.15262473401316404
446,0.2166,4,102,4,7582,598028,228,107728,5.539553151283856,0.15264198958280198
447,0.2167,0,9,0,7591,598019,228,107728,5.5394697839860685,0.15264393614142177
448,0.2168,2,39,2,7630,597980,230,107726,5.539108525695654,0.15264997038426767
449,0.2169,2,96,2,7726,597884,232,107724,5.538219274519249,0.15266833709368374
450,0.217,0,15,0,7741,597869,232,107724,5.538080329022935,0.15267158262624486
451,0.2171,5,82,5,7823,597787,237,107719,5.537320760309756,0.15268332232468612
452,0.2172,0,3,0,7826,597784,237,107719,5.537292971210493,0.1526839715777254
453,0.2173,0,4,0,7830,597780,237,107719,5.5372559190781425,0.15268483725703366
454,0.2174,1,24,1,7854,597756,238,107718,5.537033606284042,0.15268883048843757
455,0.2175,1,45,1,7899,597711,239,107717,5.536616769795102,0.15269736954019403
456,0.2176,0,6,0,7905,597705,239,107717,5.536561191596577,0.15269866831485268
457,0.2177,2,60,2,7965,597645,241,107715,5.536005409611323,0.15270925484858797
458,0.2178,1,66,1,8031,597579,242,107714,5.535394049427545,0.15272234376351387
459,0.2179,0,7,0,8038,597572,242,107714,5.5353292081959315,0.1527238595406686
460,0.218,1,20,1,8058,597552,243,107713,5.535143947534181,0.15272698914592386
461,0.2181,4,80,4,8138,597472,247,107709,5.534402904887176,0.15273950943091205
462,0.2182,1,30,1,8168,597442,248,107708,5.53412501389455,0.15274480606963056
463,0.2183,1,7,1,8175,597435,249,107707,5.534060172662937,0.15274512084090863
464,0.2184,1,23,1,8198,597412,250,107706,5.533847122901923,0.15274890160228502
465,0.2185,0,5,0,8203,597407,250,107706,5.533800807736485,0.1527499847542167
466,0.2186,3,54,3,8257,597353,253,107703,5.533300603949757,0.15275807879090456
467,0.2187,0,6,0,8263,597347,253,107703,5.533245025751232,0.1527593787674633
468,0.2188,0,5,0,8268,597342,253,107703,5.533198710585794,0.15276046209816393
469,0.2189,1,14,1,8282,597328,254,107702,5.5330690281225685,0.15276229380310058
470,0.219,0,44,0,8326,597284,254,107702,5.532661454666716,0.15277182809304016
471,0.2191,1,23,1,8349,597261,255,107701,5.532448404905702,0.1527756106002877
472,0.2192,1,34,1,8383,597227,256,107700,5.532133461780726,0.1527817774039014
473,0.2193,3,59,3,8442,597168,259,107697,5.53158694282856,0.1527909599710583
474,0.2194,2,35,2,8477,597133,261,107695,5.531262736670495,0.1527961431725187
475,0.2195,0,11,0,8488,597122,261,107695,5.531160843306532,0.15279852784481646
476,0.2196,4,96,4,8584,597026,265,107691,5.530271592130127,0.15281453406119053
477,0.2197,1,37,1,8621,596989,266,107690,5.529928859905888,0.15282135553918877
478,0.2198,5,80,5,8701,596909,271,107685,5.529187817258883,0.1528326951407477
479,0.2199,1,62,1,8763,596847,272,107684,5.528613509207455,0.1528449422381698
480,0.22,7,129,7,8892,596718,279,107677,5.5274185779391605,0.15286451493835135
481,0.2201,9,129,9,9021,596589,288,107668,5.526223646670866,0.152881689496874
482,0.2202,1,55,1,9076,596534,289,107667,5.52571417985105,0.15289242702012634
483,0.2203,1,33,1,9109,596501,290,107666,5.525408499759161,0.15289838916052584
484,0.2204,2,31,2,9140,596470,292,107664,5.525121345733447,0.15290271454013016
485,0.2205,4,100,4,9240,596370,296,107660,5.524195042424692,0.15291961990256098
486,0.2206,2,47,2,9287,596323,298,107658,5.523759679869577,0.15292742275714827
487,0.2207,9,113,9,9400,596210,307,107649,5.5227129571306826,0.15294114304143303
488,0.2208,0,34,0,9434,596176,307,107649,5.522398014005706,0.15294853124000996
489,0.2209,6,112,6,9546,596064,313,107643,5.5213605542999,0.15296565189773584
490,0.221,0,9,0,9555,596055,313,107643,5.521277187002112,0.15296760826377223
491,0.2211,0,10,0,9565,596045,313,107643,5.521184556671236,0.15296978206250497
492,0.2212,7,84,7,9649,595961,320,107636,5.5204064618918816,0.15297961759359405
493,0.2213,2,46,2,9695,595915,322,107634,5.5199803623698545,0.15298721197812803
494,0.2214,0,8,0,9703,595907,322,107634,5.519906258105154,0.15298895160338913
495,0.2215,6,80,6,9783,595827,328,107628,5.519165215458149,0.152999125743651
496,0.2216,2,46,2,9829,595781,330,107626,5.518739115936122,0.1530067229925207
497,0.2217,0,40,0,9869,595741,330,107626,5.51836859461262,0.15301542438016
498,0.2218,0,12,0,9881,595729,330,107626,5.518257438215569,0.15301803498944344
499,0.2219,0,7,0,9888,595722,330,107626,5.5181925969839565,0.1530195578859967
500,0.222,2,86,2,9974,595636,332,107624,5.517395976138427,0.1530358615590251
501,0.2221,1,54,1,10028,595582,333,107623,5.516895772351699,0.15304640894191593
502,0.2222,1,18,1,10046,595564,334,107622,5.5167290377561224,0.1530491221383816
503,0.2223,3,29,3,10075,595535,337,107619,5.516460409796584,0.1530518207960134
504,0.2224,3,29,3,10104,595506,340,107616,5.516191781837045,0.15305451969928405
505,0.2225,2,109,2,10213,595397,342,107614,5.5151821112305015,0.15307584091856316
506,0.2226,4,113,4,10326,595284,346,107610,5.514135388491607,0.15309563035109133
507,0.2227,4,29,4,10355,595255,350,107606,5.513866760532069,0.1530971273125127
508,0.2228,1,35,1,10390,595220,351,107605,5.513542554374005,0.15310354640202042
509,0.2229,0,24,0,10414,595196,351,107605,5.513320241579903,0.153108774745625
510,0.223,0,11,0,10425,595185,351,107605,5.51321834821594,0.15311117118911766
511,0.2231,6,133,6,10558,595052,357,107599,5.511986364815295,0.1531329208952951
512,0.2232,13,173,13,10731,594879,370,107586,5.5103838600911486,0.15315496145715446
513,0.2233,0,15,0,10746,594864,370,107586,5.510244914594835,0.15315823190262653
514,0.2234,1,47,1,10793,594817,371,107585,5.5098095520397194,0.15316727458065324
515,0.2235,4,95,4,10888,594722,375,107581,5.508929563896403,0.1531831702270957
516,0.2236,3,78,3,10966,594644,378,107578,5.508207047315573,0.15319656746726817
517,0.2237,1,26,1,10992,594618,379,107577,5.507966208455296,0.1532010339008395
518,0.2238,0,23,0,11015,594595,379,107577,5.507753158694283,0.15320605207840815
519,0.2239,1,22,1,11037,594573,380,107576,5.507549371966356,0.15320964638559623
520,0.224,6,128,6,11165,594445,386,107570,5.50636370373115,0.15323034408096692
521,0.2241,1,8,1,11173,594437,387,107569,5.50628959946645,0.15323088406651794
522,0.2242,1,69,1,11242,594368,388,107568,5.505650450183408,0.1532447402612204
523,0.2243,8,91,8,11333,594277,396,107560,5.50480751417244,0.15325495806006237
524,0.2244,5,91,5,11424,594186,401,107555,5.503964578161473,0.15326879860233333
525,0.2245,0,21,0,11445,594165,401,107555,5.503770054466634,0.1532733853958844
526,0.2246,5,50,5,11495,594115,406,107550,5.503306902812257,0.15327827382012785
527,0.2247,0,41,0,11536,594074,406,107550,5.502927118455667,0.1532872307674766
528,0.2248,6,123,6,11659,593951,412,107544,5.501787765385898,0.15330686605036387
529,0.2249,0,13,0,11672,593938,412,107544,5.5016673459557595,0.15330970716283526
530,0.225,3,64,3,11736,593874,415,107541,5.501074511838156,0.15332007442099185
531,0.2251,7,102,7,11838,593772,422,107534,5.500129682463226,0.1533339227099155
532,0.2252,0,11,0,11849,593761,422,107534,5.500027789099263,0.15333632779358186
533,0.2253,2,51,2,11900,593710,424,107532,5.4995553744117975,0.1533450648991361
534,0.2254,5,134,5,12034,593576,429,107527,5.498314127978065,0.15336833532305524
535,0.2255,1,39,1,12073,593537,430,107526,5.4979528696876505,0.15337565953416454
536,0.2256,2,33,2,12106,593504,432,107524,5.497647189595761,0.15338046411840897
537,0.2257,5,137,5,12243,593367,437,107519,5.496378154062766,0.15340440528131535
538,0.2258,2,48,2,12291,593319,439,107517,5.495933528474564,0.15341249593342807
539,0.2259,3,69,3,12360,593250,442,107514,5.495294379191522,0.15342397725910578
540,0.226,2,41,2,12401,593209,444,107512,5.494914594834933,0.15343053797445774
541,0.2261,3,60,3,12461,593149,447,107509,5.494358812849679,0.15344005206534428
542,0.2262,4,95,4,12556,593054,451,107505,5.4934788247063615,0.15345602583080084
543,0.2263,2,18,2,12574,593036,453,107503,5.493312090110786,0.15345755197069685
544,0.2264,2,33,2,12607,593003,455,107501,5.4930064100188964,0.15346236424060392
545,0.2265,0,39,0,12646,592964,455,107501,5.492645151728482,0.1534709086107086
546,0.2266,6,135,6,12781,592829,461,107495,5.491394642261662,0.1534932402716457
547,0.2267,0,55,0,12836,592774,461,107495,5.490885175441846,0.1535052958220341
548,0.2268,3,121,3,12957,592653,464,107492,5.489764348438253,0.1535281977304701
549,0.2269,1,20,1,12977,592633,465,107491,5.489579087776502,0.15353137444224166
550,0.227,4,129,4,13106,592504,469,107487,5.488384156508207,0.1535548314192611
551,0.2271,0,33,0,13139,592471,469,107487,5.488078476416318,0.15356207086710916
552,0.2272,2,102,2,13241,592369,471,107485,5.487133647041388,0.153582032823989
553,0.2273,0,12,0,13253,592357,471,107485,5.487022490644336,0.15358466625324002
554,0.2274,3,66,3,13319,592291,474,107482,5.486411130460558,0.15359552311964023
555,0.2275,1,71,1,13390,592220,475,107481,5.485753455111341,0.15360989908546652
556,0.2276,3,133,3,13523,592087,478,107478,5.484521471710697,0.15363547347280096
557,0.2277,2,99,2,13622,591988,480,107476,5.483604431435029,0.15365479853144692
558,0.2278,2,50,2,13672,591938,482,107474,5.483141279780652,0.1536633629391546
559,0.2279,6,135,6,13807,591803,488,107468,5.481890770313831,0.15368576703452597
560,0.228,3,68,3,13875,591735,491,107465,5.481260884063878,0.1536970823798627
561,0.2281,3,106,3,13981,591629,494,107462,5.480279002556597,0.15371675504333485
562,0.2282,5,75,5,14056,591554,499,107457,5.47958427507503,0.1537271945648924
563,0.2283,0,24,0,14080,591530,499,107457,5.4793619622809295,0.15373247284999578
564,0.2284,11,132,11,14212,591398,510,107446,5.4781392419133725,0.1537481898678389
565,0.2285,0,76,0,14288,591322,510,107446,5.477435251398718,0.15376491195933414
566,0.2286,2,37,2,14325,591285,512,107444,5.477092519174478,0.1537706321048647
567,0.2287,0,34,0,14359,591251,512,107444,5.476777576049502,0.15377811491423296
568,0.2288,2,75,2,14434,591176,514,107442,5.476082848567935,0.15379220117431844
569,0.2289,5,136,5,14570,591040,519,107437,5.474823076068028,0.15381608843240363
570,0.229,0,23,0,14593,591017,519,107437,5.474610026307014,0.15382115357632714
571,0.2291,3,41,3,14634,590976,522,107434,5.4742302419504245,0.15382654887530248
572,0.2292,1,24,1,14658,590952,523,107433,5.474007929156323,0.1538306235099551
573,0.2293,5,75,5,14733,590877,528,107428,5.473313201674756,0.15384108663119983
574,0.2294,3,113,3,14846,590764,531,107425,5.472266478935863,0.1538623495930185
575,0.2295,1,71,1,14917,590693,532,107424,5.471608803586647,0.1538767856963804
576,0.2296,1,72,1,14989,590621,533,107423,5.470941865204343,0.15389144523840903
577,0.2297,1,37,1,15026,590584,534,107422,5.470599132980103,0.15389839055824736
578,0.2298,5,95,5,15121,590489,539,107417,5.469719144836786,0.153913277719349
579,0.2299,4,26,4,15147,590463,543,107413,5.469478305976509,0.1539141624013435
580,0.23,1,19,1,15166,590444,544,107412,5.469302308347846,0.15391714049889949
581,0.2301,1,36,1,15202,590408,545,107411,5.468968839156694,0.15392386851031573
582,0.2302,5,198,5,15400,590210,550,107406,5.467134758605358,0.15396149170890575
583,0.2303,2,109,2,15509,590101,552,107404,5.466125087998814,0.15398312556899232
584,0.2304,1,4,1,15513,590097,553,107403,5.4660880358664645,0.15398279569892473
585,0.2305,10,118,10,15631,589979,563,107393,5.464994997962132,0.1539967191111774
586,0.2306,0,29,0,15660,589950,563,107393,5.464726370002594,0.15400312328366386
587,0.2307,3,73,3,15733,589877,566,107390,5.464050168587202,0.15401560664709502
588,0.2308,4,99,4,15832,589778,570,107386,5.463133128311535,0.15403262360075964
589,0.2309,4,90,4,15922,589688,574,107382,5.462299455333654,0.15404765661985168
590,0.231,4,66,4,15988,589622,578,107378,5.461688095149876,0.1540573888091822
591,0.2311,5,124,5,16112,589498,583,107373,5.460539479047019,0.15407873193173485
592,0.2312,5,65,5,16177,589433,588,107368,5.459937381896328,0.154087034892315
593,0.2313,2,61,2,16238,589372,590,107366,5.459372336877987,0.15409809713263808
594,0.2314,2,58,2,16296,589314,592,107364,5.4588350809589095,0.15410849775649582
595,0.2315,2,38,2,16334,589276,594,107362,5.458483085701582,0.15411447552387322
596,0.2316,0,66,0,16400,589210,594,107362,5.457871725517804,0.15412907782684346
597,0.2317,2,34,2,16434,589176,596,107360,5.457556782392826,0.1541341725337958
598,0.2318,3,55,3,16489,589121,599,107357,5.4570473155730115,0.1541427008462579
599,0.2319,1,33,1,16522,589088,600,107356,5.456741635481122,0.15414879013962357
600,0.232,7,117,7,16639,588971,607,107349,5.455657860609878,0.15416618795955883
601,0.2321,1,42,1,16681,588929,608,107348,5.455268813220201,0.1541742725955331
602,0.2322,3,132,3,16813,588797,611,107345,5.454046092852644,0.15419986152250548
603,0.2323,3,93,3,16906,588704,614,107342,5.453184630775501,0.15421681900334172
604,0.2324,5,86,5,16992,588618,619,107337,5.4523880099299715,0.1542297993404746
605,0.2325,10,196,10,17188,588422,629,107327,5.450572455444811,0.15426109128435686
606,0.2326,2,89,2,17277,588333,631,107325,5.4497480455000185,0.15427839541843838
607,0.2327,1,58,1,17335,588275,632,107324,5.44921078958094,0.15429004354520348
608,0.2328,7,144,7,17479,588131,639,107317,5.447876912816333,0.1543134785059415
609,0.2329,5,139,5,17618,587992,644,107312,5.446589351217162,0.15433824629226928
610,0.233,4,73,4,17691,587919,648,107308,5.445913149801771,0.15434958653792213
611,0.2331,6,112,6,17803,587807,654,107302,5.444875690095965,0.1543671568056233
612,0.2332,1,59,1,17862,587748,655,107301,5.444329171143799,0.1543790437796472
613,0.2333,0,36,0,17898,587712,655,107301,5.443995701952647,0.15438704024241273
614,0.2334,5,138,5,18036,587574,660,107296,5.442717403386565,0.1544116165613712
615,0.2335,3,74,3,18110,587500,663,107293,5.442031938938086,0.15442441129948056
616,0.2336,5,72,5,18182,587428,668,107288,5.441365000555782,0.15443432999959697
617,0.2337,2,115,2,18297,587313,670,107286,5.440299751750714,0.154457463946824
618,0.2338,0,34,0,18331,587279,670,107286,5.439984808625736,0.1544650248716823
619,0.2339,11,173,11,18504,587106,681,107275,5.43838230390159,0.15449011421683484
620,0.234,3,54,3,18558,587052,684,107272,5.437882100114861,0.15449847621571486
621,0.2341,12,277,12,18835,586775,696,107260,5.435316239949609,0.15454552003861477
622,0.2342,3,77,3,18912,586698,699,107257,5.434602986401868,0.15455901319249807
623,0.2343,3,44,3,18956,586654,702,107254,5.434195412946015,0.15456515849363317
624,0.2344,3,16,3,18972,586638,705,107251,5.434047204416614,0.154565067323448
625,0.2345,2,30,2,19002,586608,707,107249,5.433769313423988,0.1545693132734843
626,0.2346,11,142,11,19144,586466,718,107238,5.432453962725555,0.1545875474265681
627,0.2347,2,43,2,19187,586423,720,107236,5.43205565230279,0.1545946927813234
628,0.2348,1,52,1,19239,586371,721,107235,5.431573974582237,0.15460506397003487
629,0.2349,10,256,10,19495,586115,731,107225,5.429202638111823,0.15464995528889144
630,0.235,4,80,4,19575,586035,735,107221,5.428461595464819,0.15466292394151657
631,0.2351,3,81,3,19656,585954,738,107218,5.427711289784727,0.15467733838066167
632,0.2352,5,128,5,19784,585826,743,107213,5.42652562154952,0.15469980765873204
633,0.2353,0,13,0,19797,585813,743,107213,5.426405202119382,0.15470270956645205
634,0.2354,8,192,8,19989,585621,751,107205,5.424626699766572,0.15473582111525838
635,0.2355,5,111,5,20100,585510,756,107200,5.423598503093853,0.1547545148763552
636,0.2356,3,47,3,20147,585463,759,107197,5.423163140538738,0.15476135477723557
637,0.2357,7,103,7,20250,585360,766,107190,5.42220904813072,0.15477582846003898
638,0.2358,7,207,7,20457,585153,773,107183,5.420291600281597,0.1548135587344873
639,0.2359,12,176,12,20633,584977,785,107171,5.418661306458187,0.15483827158353416
640,0.236,9,221,9,20854,584756,794,107162,5.4166141761458375,0.15487673394824242
641,0.2361,5,117,5,20971,584639,799,107157,5.4155304012745935,0.15489681929354895
642,0.2362,1,19,1,20990,584620,800,107156,5.41535440364593,0.15489985197520584
643,0.2363,1,98,1,21088,584522,801,107155,5.4144466264033495,0.1549205770901736
644,0.2364,6,160,6,21248,584362,807,107149,5.412964541109341,0.15494908974694546
645,0.2365,7,116,7,21364,584246,814,107142,5.411890029271184,0.1549665310939733
646,0.2366,5,111,5,21475,584135,819,107137,5.410861832598466,0.15498530245692
647,0.2367,5,59,5,21534,584076,824,107132,5.410315313646301,0.15499241906922373
648,0.2368,3,51,3,21585,584025,827,107129,5.409842898958835,0.15500018809122135
649,0.2369,4,60,4,21645,583965,831,107125,5.409287116973582,0.15500875428670652
650,0.237,15,229,15,21874,583736,846,107110,5.407165882396532,0.15504178934234258
651,0.2371,4,100,4,21974,583636,850,107106,5.406239579087776,0.15505934198296903
652,0.2372,7,155,7,22129,583481,857,107099,5.404803808959206,0.1550855802369023
653,0.2373,9,130,9,22259,583351,866,107090,5.403599614657823,0.15510376701267742
654,0.2374,5,149,5,22408,583202,871,107085,5.402219422727778,0.1551311266183486
655,0.2375,5,38,5,22446,583164,876,107080,5.401867427470451,0.15513354697759052
656,0.2376,4,96,4,22542,583068,880,107076,5.400978176294045,0.15515022951731813
657,0.2377,12,175,12,22717,582893,892,107064,5.399357145503724,0.15517488771039353
658,0.2378,3,74,3,22791,582819,895,107061,5.398671681055244,0.1551878587580449
659,0.2379,9,120,9,22911,582699,904,107052,5.397560117084738,0.15520383442720634
660,0.238,12,225,12,23136,582474,916,107040,5.3954759346400385,0.15523977758247112
661,0.2381,7,60,7,23196,582414,923,107033,5.394920152654786,0.15524471061589942
662,0.2382,7,138,7,23334,582276,930,107026,5.393641854088703,0.15526721233943902
663,0.2383,6,142,6,23476,582134,936,107020,5.3923265033902705,0.15529185058782216
664,0.2384,4,32,4,23508,582102,940,107016,5.392030086331468,0.15529415862014923
665,0.2385,2,59,2,23567,582043,942,107014,5.391483567379303,0.15530500379504164
666,0.2386,3,45,3,23612,581998,945,107011,5.391066730890363,0.1553114690809554
667,0.2387,7,129,7,23741,581869,952,107004,5.389871799622068,0.15533196975349592
668,0.2388,4,108,4,23849,581761,956,107000,5.388871392048612,0.15535142088474813
669,0.2389,9,123,9,23972,581638,965,106991,5.387732038978843,0.15536813000904695
670,0.239,7,70,7,24042,581568,972,106984,5.387083626662714,0.1553753383912907
671,0.2391,2,71,2,24113,581497,974,106982,5.386425951313498,0.15538890801317107
672,0.2392,7,116,7,24229,581381,981,106975,5.3853514394753415,0.1554065047736927
673,0.2393,7,77,7,24306,581304,988,106968,5.3846381859276,0.15541530092754027
674,0.2394,2,45,2,24351,581259,990,106966,5.38422134943866,0.1554230084638018
675,0.2395,12,249,12,24600,581010,1002,106954,5.381914854199859,0.15546453012076214
676,0.2396,3,109,3,24709,580901,1005,106951,5.380905183593316,0.15548548234213175
677,0.2397,3,146,3,24855,580755,1008,106948,5.379552780762533,0.1555148079912404
678,0.2398,5,184,5,25039,580571,1013,106943,5.377848382674423,0.1555502869759743
679,0.2399,4,77,4,25116,580494,1017,106939,5.377135129126681,0.155562796665275
680,0.24,2,78,2,25194,580416,1019,106937,5.3764126125458525,0.15557799267625222
681,0.2401,5,105,5,25299,580311,1024,106932,5.375439994071659,0.15559561901685431
682,0.2402,8,114,8,25413,580197,1032,106924,5.374384008299677,0.1556116026143867
683,0.2403,5,46,5,25459,580151,1037,106919,5.37395790877765,0.15561587611160435
684,0.2404,6,81,6,25540,580070,1043,106913,5.373207603097558,0.15562684957269685
685,0.2405,8,156,8,25696,579914,1051,106905,5.3717625699359,0.1556523625584033
686,0.2406,9,148,9,25844,579766,1060,106896,5.370391641038942,0.15567484439214635
687,0.2407,5,115,5,25959,579651,1065,106891,5.369326392233873,0.15569477176924354
688,0.2408,9,315,9,26274,579336,1074,106882,5.366408536811294,0.1557551681827058
689,0.2409,3,79,3,26353,579257,1077,106879,5.3656767571973765,0.1557694101460935
690,0.241,0,26,0,26379,579231,1077,106879,5.3654359183371,0.1557753129964583
691,0.2411,4,104,4,26483,579127,1081,106875,5.364472562895995,0.15579400643146812
692,0.2412,11,136,11,26619,578991,1092,106864,5.363212790396087,0.15581135954392691
693,0.2413,3,86,3,26705,578905,1095,106861,5.362416169550557,0.1558272063648533
694,0.2414,2,67,2,26772,578838,1097,106859,5.361795546333692,0.1558399701325804
695,0.2415,2,94,2,26866,578744,1099,106857,5.3609248212234615,0.1558588741848393
696,0.2416,1,44,1,26910,578700,1100,106856,5.360517247767609,0.15586764611497822
697,0.2417,9,175,9,27085,578525,1109,106847,5.358896216977287,0.15589635993299988
698,0.2418,14,207,14,27292,578318,1123,106833,5.356978769128164,0.15592621188613898
699,0.2419,3,68,3,27360,578250,1126,106830,5.356348882878209,0.15593799264319497
700,0.242,8,96,8,27456,578154,1134,106822,5.355459631701804,0.15594998948868283
701,0.2421,6,87,6,27543,578067,1140,106816,5.354653747823187,0.15596240525754035
702,0.2422,9,194,9,27737,577873,1149,106807,5.352856719404202,0.1559955015481685
703,0.2423,15,210,15,27947,577663,1164,106792,5.350911482455816,0.1560248664996238
704,0.2424,5,97,5,28044,577566,1169,106787,5.350012968246323,0.1560408151933286
705,0.2425,10,137,10,28181,577429,1179,106777,5.348743932713328,0.1560597247027942
706,0.2426,1,40,1,28221,577389,1180,106776,5.348373411389826,0.1560676152682467
707,0.2427,6,135,6,28356,577254,1186,106770,5.347122901923005,0.15609101435037367
708,0.2428,2,52,2,28408,577202,1188,106768,5.346641224202453,0.15610041376083747
709,0.2429,12,109,12,28517,577093,1200,106756,5.34563155359591,0.15611048637930303
710,0.243,5,113,5,28630,576980,1205,106751,5.344584830857015,0.1561301154986391
711,0.2431,3,85,3,28715,576895,1208,106748,5.343797473044574,0.15614582464824478
712,0.2432,5,191,5,28906,576704,1213,106743,5.342028233724851,0.15618328853590696
713,0.2433,6,94,6,29000,576610,1219,106737,5.341157508614621,0.15619736385760088
714,0.2434,3,95,3,29095,576515,1222,106734,5.340277520471303,0.15621537682455444
715,0.2435,11,106,11,29201,576409,1233,106723,5.339295638964022,0.15622602952284478
716,0.2436,7,132,7,29333,576277,1240,106716,5.338072918596465,0.15624757501174977
717,0.2437,7,176,7,29509,576101,1247,106709,5.336442624773055,0.15627919919157598
718,0.2438,12,217,12,29726,575884,1259,106697,5.334432546593057,0.1563140491751162
719,0.2439,5,89,5,29815,575795,1264,106692,5.333608136648264,0.15632825240627293
720,0.244,24,346,24,30161,575449,1288,106668,5.33040312719997,0.1563778647944561
721,0.2441,16,187,16,30348,575262,1304,106652,5.328670940012597,0.15640095378596128
722,0.2442,9,117,9,30465,575145,1313,106643,5.327587165141354,0.15641665737736657
723,0.2443,4,82,4,30547,575063,1317,106639,5.326827596428174,0.15643052242768835
724,0.2444,14,317,14,30864,574746,1331,106625,5.32389121493942,0.15648596726306227
725,0.2445,12,308,12,31172,574438,1343,106613,5.321038200748453,0.15654187425023972
726,0.2446,9,163,9,31335,574275,1352,106604,5.319528326355182,0.15656820081101047
727,0.2447,6,136,6,31471,574139,1358,106598,5.318268553855274,0.15659204656130046
728,0.2448,2,77,2,31548,574062,1360,106596,5.317555300307533,0.15660728295267226
729,0.2449,11,194,11,31742,573868,1371,106585,5.315758271888547,0.15663829831009637
730,0.245,3,92,3,31834,573776,1374,106582,5.314906072844492,0.15665576064366113
731,0.2451,7,108,7,31942,573668,1381,106575,5.313905665271037,0.15667195399291137
732,0.2452,10,315,10,32257,573353,1391,106565,5.310987809848457,0.15673213534573288
733,0.2453,4,122,4,32379,573231,1395,106561,5.309857719811776,0.1567553016216725
734,0.2454,3,84,3,32463,573147,1398,106558,5.309079625032421,0.15677095210422168
735,0.2455,7,110,7,32573,573037,1405,106551,5.3080606913927895,0.15678764192422467
736,0.2456,9,153,9,32726,572884,1414,106542,5.306643447330394,0.15681177935492607
737,0.2457,2,39,2,32765,572845,1416,106540,5.30628218903998,0.15681829890268403
738,0.2458,6,93,6,32858,572752,1422,106534,5.305420726962836,0.1568323209958692
739,0.2459,7,176,7,33034,572576,1429,106527,5.303790433139427,0.15686427537501674
740,0.246,10,140,10,33174,572436,1439,106517,5.302493608507169,0.15688420258839714
741,0.2461,5,90,5,33264,572346,1444,106512,5.3016599355292895,0.15689879179445482
742,0.2462,6,64,6,33328,572282,1450,106506,5.301067101411686,0.15690613269533343
743,0.2463,7,176,7,33504,572106,1457,106499,5.299436807588276,0.15693813042933666
744,0.2464,10,276,10,33780,571830,1467,106489,5.296880210456112,0.1569895580103167
745,0.2465,3,118,3,33898,571712,1470,106486,5.295787172551781,0.15701314365421307
746,0.2466,30,351,30,34249,571361,1500,106456,5.292535847938049,0.15705714079168862
747,0.2467,2,111,2,34360,571250,1502,106454,5.291507651265331,0.15708037727385407
748,0.2468,6,158,6,34518,571092,1508,106448,5.290044092037497,0.1571095433479942
749,0.2469,5,133,5,34651,570959,1513,106443,5.2888121086368525,0.15713416848488784
750,0.247,8,125,8,34776,570834,1521,106435,5.287654229500908,0.15715321386332462
751,0.2471,21,211,21,34987,570623,1542,106414,5.2856997295194335,0.15717604798556062
752,0.2472,8,93,8,35080,570530,1550,106406,5.284838267442291,0.15718768096245436
753,0.2473,13,156,13,35236,570374,1563,106393,5.2833932342806325,0.15720772437190347
754,0.2474,13,348,13,35584,570026,1576,106380,5.280169698766164,0.15727240740028917
755,0.2475,7,127,7,35711,569899,1583,106373,5.278993293564045,0.1572932192963778
756,0.2476,18,159,18,35870,569740,1601,106355,5.277520471303124,0.15730777479496225
757,0.2477,3,170,3,36040,569570,1604,106352,5.275945755678239,0.15734359881761506
758,0.2478,1,43,1,36083,569527,1605,106351,5.275547445255475,0.15735236240860037
759,0.2479,13,192,13,36275,569335,1618,106338,5.273768942902664,0.15738086322821837
760,0.248,7,181,7,36456,569154,1625,106331,5.272092333913816,0.1574143023161136
761,0.2481,5,154,5,36610,569000,1630,106326,5.270665826818333,0.15744396039838537
762,0.2482,5,65,5,36675,568935,1635,106321,5.270063729667642,0.15745287713104364
763,0.2483,6,69,6,36744,568866,1641,106315,5.269424580384601,0.15746148069924953
764,0.2484,12,182,12,36926,568684,1653,106303,5.267738708362666,0.15748895904661867
765,0.2485,18,298,18,37224,568386,1671,106285,5.264978324502575,0.1575360434937918
766,0.2486,16,310,16,37534,568076,1687,106269,5.262106784245433,0.1575884747421572
767,0.2487,17,235,17,37769,567841,1704,106252,5.259929971469858,0.15762216786111116
768,0.2488,10,142,10,37911,567699,1714,106242,5.258614620771425,0.1576428797179575
769,0.2489,13,226,13,38137,567473,1727,106229,5.2565211752936385,0.1576795081504879
770,0.249,5,99,5,38236,567374,1732,106224,5.25560413501797,0.15769643021505408
771,0.2491,11,223,11,38459,567151,1743,106213,5.253538478639446,0.1577348952423949
772,0.2492,10,160,10,38619,566991,1753,106203,5.252056393345437,0.1577598730826478
773,0.2493,10,175,10,38794,566816,1763,106193,5.250435362555115,0.15778838024454353
774,0.2494,5,99,5,38893,566717,1768,106188,5.249518322279447,0.1578053365631107
775,0.2495,10,179,10,39072,566538,1778,106178,5.247860239356775,0.15783480696163016
776,0.2496,11,257,11,39329,566281,1789,106167,5.245479639853274,0.15788135290758543
777,0.2497,19,303,19,39632,565978,1808,106148,5.242672940827744,0.15792872169801495
778,0.2498,6,89,6,39721,565889,1814,106142,5.241848530882952,0.15794211874154615
779,0.2499,12,216,12,39937,565673,1826,106130,5.23984771573604,0.15797785958085928
780,0.25,6,134,6,40071,565539,1832,106124,5.238606469302308,0.1580018550969757
781,0.2501,14,207,14,40278,565332,1846,106110,5.236689021453184,0.1580330095525749
782,0.2502,5,86,5,40364,565246,1851,106105,5.235892400607655,0.15804698287483002
783,0.2503,10,352,10,40716,564894,1861,106095,5.232631812960836,0.15811734618600304
784,0.2504,5,134,5,40850,564760,1866,106090,5.231390566527104,0.15814265484087353
785,0.2505,8,113,8,40963,564647,1874,106082,5.23034384378821,0.15815925657009017
786,0.2506,16,220,16,41183,564427,1890,106066,5.228305976508948,0.1581910623973703
787,0.2507,9,192,9,41375,564235,1899,106057,5.226527474156137,0.1582250720581478
788,0.2508,5,157,5,41532,564078,1904,106052,5.2250731779613915,0.15825586080312776
789,0.2509,11,212,11,41744,563866,1915,106041,5.22310941494683,0.15829212114517388
790,0.251,4,81,4,41825,563785,1919,106037,5.222359109266739,0.15830623658225618
791,0.2511,2,58,2,41883,563727,1921,106035,5.22182185334766,0.15831743216246966
792,0.2512,7,166,7,42049,563561,1928,106028,5.220284189855126,0.1583478820589944
793,0.2513,7,70,7,42119,563491,1935,106021,5.219635777538997,0.1583556381364337
794,0.2514,8,182,8,42301,563309,1943,106013,5.217949905517062,0.1583886380546284
795,0.2515,25,292,25,42593,563017,1968,105988,5.215245099855497,0.15842631968370938
796,0.2516,12,124,12,42717,562893,1980,105976,5.21409648375264,0.15844059150596007
797,0.2517,9,203,9,42920,562690,1989,105967,5.212216088035866,0.15847736582433145
798,0.2518,4,103,4,43023,562587,1993,105963,5.211261995627848,0.15849674669059904
799,0.2519,10,226,10,43249,562361,2003,105953,5.2091685501500615,0.1585377532118136
800,0.252,19,360,19,43609,562001,2022,105934,5.205833858238542,0.15859926489853055
801,0.2521,17,264,17,43873,561737,2039,105917,5.203388417503428,0.15864055334050273
802,0.2522,16,263,16,44136,561474,2055,105901,5.200952239801401,0.15868289941936692
803,0.2523,5,163,5,44299,561311,2060,105896,5.199442365408129,0.1587153611997476
804,0.2524,5,70,5,44369,561241,2065,105891,5.198793953092,0.15872570945480055
805,0.2525,14,161,14,44530,561080,2079,105877,5.1973026047649045,0.15874636595762545
806,0.2526,5,92,5,44622,560988,2084,105872,5.196450405720849,0.15876195903188076
807,0.2527,5,138,5,44760,560850,2089,105867,5.195172107154767,0.1587885114673842
808,0.2528,14,231,14,44991,560619,2103,105853,5.193032346511542,0.15882587715612959
809,0.2529,20,318,20,45309,560301,2123,105833,5.190086701989699,0.15887644227737963
810,0.253,2,146,2,45455,560155,2125,105831,5.1887342991589165,0.1589087458294919
811,0.2531,16,269,16,45724,559886,2141,105815,5.1862425432583645,0.15895274304830548
812,0.2532,16,265,16,45989,559621,2157,105799,5.183787839490162,0.15899582218749062
813,0.2533,11,257,11,46246,559364,2168,105788,5.181407239986661,0.15904334648320986
814,0.2534,12,182,12,46428,559182,2180,105776,5.179721367964726,0.15907170076907112
815,0.2535,3,136,3,46564,559046,2183,105773,5.178461595464819,0.15910044688855163
816,0.2536,9,185,9,46749,558861,2192,105764,5.176747934343622,0.15913334587173217
817,0.2537,10,143,10,46892,558718,2202,105754,5.175423320612102,0.1591549380560806
818,0.2538,7,151,7,47043,558567,2209,105747,5.174024602615881,0.15918225417498352
819,0.2539,7,207,7,47250,558360,2216,105740,5.172107154766757,0.15922300858304472
820,0.254,4,109,4,47359,558251,2220,105736,5.171097484160214,0.15924408158593467
821,0.2541,8,173,8,47532,558078,2228,105728,5.169494979436067,0.15927545096006965
822,0.2542,10,143,10,47675,557935,2238,105718,5.168170365704547,0.1592971025520867
823,0.2543,3,108,3,47783,557827,2241,105715,5.16716995813109,0.15931922922738878
824,0.2544,17,299,17,48082,557528,2258,105698,5.1644003112379115,0.15936950602057218
825,0.2545,12,201,12,48283,557327,2270,105686,5.162538441587313,0.1594026059820848
826,0.2546,14,184,14,48467,557143,2284,105672,5.160834043499204,0.15942910163469445
827,0.2547,13,229,13,48696,556914,2297,105659,5.158712808922154,0.15946771148235742
828,0.2548,20,304,20,49000,556610,2317,105639,5.155896846863537,0.15951552965727392
829,0.2549,15,219,15,49219,556391,2332,105624,5.153868242617363,0.15954925492624789
830,0.255,23,396,23,49615,555995,2355,105601,5.150200081514691,0.15961553576502882
831,0.2551,4,61,4,49676,555934,2359,105597,5.149635036496351,0.1596251725164807
832,0.2552,6,140,6,49816,555794,2365,105591,5.148338211864092,0.15965133772311135
833,0.2553,4,73,4,49889,555721,2369,105587,5.147662010448701,0.15966387825340084
834,0.2554,12,211,12,50100,555510,2381,105575,5.145707510467227,0.15969958477351626
835,0.2555,13,228,13,50328,555282,2394,105562,5.143595538923265,0.15973815302855138
836,0.2556,8,93,8,50421,555189,2402,105554,5.142734076846122,0.15975046273664648
837,0.2557,20,331,20,50752,554858,2422,105534,5.139668012894142,0.15980508546439084
838,0.2558,7,192,7,50944,554666,2429,105527,5.137889510541331,0.15984265207295442
839,0.2559,8,182,8,51126,554484,2437,105519,5.1362036385193965,0.15987654601569992
840,0.256,10,154,10,51280,554330,2447,105509,5.134777131423913,0.15990112739622847
841,0.2561,34,532,34,51812,553798,2481,105475,5.1298491978213345,0.15998683398228047
842,0.2562,3,95,3,51907,553703,2484,105472,5.128969209678017,0.16000606819129973
843,0.2563,5,175,5,52082,553528,2489,105467,5.127348178887695,0.160042185449055
844,0.2564,14,238,14,52320,553290,2503,105453,5.1251435770128575,0.1600821564707329
845,0.2565,11,181,11,52501,553109,2514,105442,5.12346696802401,0.16011212495311677
846,0.2566,13,130,13,52631,552979,2527,105429,5.122262773722627,0.16012715519860027
847,0.2567,17,118,17,52749,552861,2544,105412,5.121169735818296,0.16013416925804339
848,0.2568,25,343,25,53092,552518,2569,105387,5.117992515469266,0.1601857411024388
849,0.2569,3,68,3,53160,552450,2572,105384,5.117362629219311,0.16019846952270633
850,0.257,12,167,12,53327,552283,2584,105372,5.11581570269369,0.1602238255620348
851,0.2571,13,172,13,53499,552111,2597,105359,5.114222461002631,0.16024913684274567
852,0.2572,20,306,20,53805,551805,2617,105339,5.111387972877839,0.1602981994813922
853,0.2573,9,146,9,53951,551659,2626,105330,5.1100355700470566,0.1603223189429351
854,0.2574,17,196,17,54147,551463,2643,105313,5.108220015561896,0.16034842929705104
855,0.2575,9,125,9,54272,551338,2652,105304,5.107062136425951,0.16036744527459407
856,0.2576,14,187,14,54459,551151,2666,105290,5.105329949238579,0.16039522211440174
857,0.2577,11,197,11,54656,550954,2677,105279,5.103505131720331,0.16042929873992925
858,0.2578,14,255,14,54911,550699,2691,105265,5.101143058283005,0.16047374551042434
859,0.2579,18,198,18,55109,550501,2709,105247,5.099308977731669,0.16049915516326393
860,0.258,12,175,12,55284,550326,2721,105235,5.097687946941346,0.1605266329144046
861,0.2581,11,156,11,55440,550170,2732,105224,5.096242913779688,0.16055075267701566
862,0.2582,19,242,19,55682,549928,2751,105205,5.0940012597725,0.16058571313000566
863,0.2583,10,104,10,55786,549824,2761,105195,5.0930379043313945,0.16059839485572175
864,0.2584,22,199,22,55985,549625,2783,105173,5.091194560746971,0.16061900005803317
865,0.2585,16,189,16,56174,549436,2799,105157,5.089443847493423,0.1606448587137351
866,0.2586,10,142,10,56316,549294,2809,105147,5.08812849679499,0.16066688975782387
867,0.2587,3,88,3,56404,549206,2812,105144,5.087313349883286,0.16068464888820969
868,0.2588,7,169,7,56573,549037,2819,105137,5.085747897291489,0.1607171792214304
869,0.2589,9,143,9,56716,548894,2828,105128,5.0844232835599685,0.1607407701881588
870,0.259,6,144,6,56860,548750,2834,105122,5.083089406795361,0.16076846844642376
871,0.2591,25,318,25,57178,548432,2859,105097,5.080143762273519,0.1608145927724707
872,0.2592,14,172,14,57350,548260,2873,105083,5.07855052058246,0.16083894677068553
873,0.2593,13,218,13,57568,548042,2886,105070,5.076531179369373,0.16087592939648943
874,0.2594,17,302,17,57870,547740,2903,105053,5.073733743376931,0.16092850260342864
875,0.2595,21,354,21,58224,547386,2924,105032,5.070454629663937,0.16098881391991024
876,0.2596,10,281,10,58505,547105,2934,105022,5.067851717366334,0.16104531785986473
877,0.2597,14,349,14,58854,546756,2948,105008,5.064618918818778,0.1611135318919118
878,0.2598,15,304,15,59158,546452,2963,104993,5.061802956760162,0.16116940033310564
879,0.2599,16,253,16,59411,546199,2979,104977,5.05945940938901,0.16121140828286054
880,0.26,15,135,15,59546,546064,2994,104962,5.058208899922191,0.16122551173071428
881,0.2601,11,157,11,59703,545907,3005,104951,5.056754603727445,0.16125022662393332
882,0.2602,12,274,12,59977,545633,3017,104939,5.054216532661455,0.16130266903586382
883,0.2603,5,108,5,60085,545525,3022,104934,5.0532161250879986,0.16132300421702214
884,0.2604,14,299,14,60384,545226,3036,104920,5.05044647819482,0.16137913637859805
885,0.2605,11,188,11,60572,545038,3047,104909,5.04870502797436,0.16141162279385857
886,0.2606,25,355,25,60927,544683,3072,104884,5.045416651228278,0.16146756223761366
887,0.2607,9,234,9,61161,544449,3081,104875,5.043249101485791,0.16151412853983527
888,0.2608,7,153,7,61314,544296,3088,104868,5.041831857423395,0.16154315396417546
889,0.2609,9,229,9,61543,544067,3097,104859,5.039710622846345,0.1615885324366723
890,0.261,9,173,9,61716,543894,3106,104850,5.038108118122198,0.1616199918611964
891,0.2611,11,129,11,61845,543765,3117,104839,5.036913186853903,0.161637917743338
892,0.2612,12,176,12,62021,543589,3129,104827,5.035282893030494,0.1616662759709816
893,0.2613,11,178,11,62199,543411,3140,104816,5.0336340731409095,0.16169644275847814
894,0.2614,21,269,21,62468,543142,3161,104795,5.0311423172403575,0.16173640338489698
895,0.2615,15,192,15,62660,542950,3176,104780,5.029363814887547,0.1617649329195807
896,0.2616,7,130,7,62790,542820,3183,104773,5.028159620586165,0.16178834545771803
897,0.2617,9,94,9,62884,542726,3192,104764,5.027288895475935,0.16180018224219678
898,0.2618,19,276,19,63160,542450,3211,104745,5.024732298343769,0.16184457543707848
899,0.2619,19,276,19,63436,542174,3230,104726,5.022175701211605,0.16188900912042048
900,0.262,15,198,15,63634,541976,3245,104711,5.020341620660269,0.16191913553233636
901,0.2621,7,62,7,63696,541914,3252,104704,5.019767312608841,0.16192558821437078
902,0.2622,12,106,12,63802,541808,3264,104692,5.01878543110156,0.16193658159319413
903,0.2623,17,206,17,64008,541602,3281,104675,5.016877246285524,0.16196615383187085
904,0.2624,9,179,9,64187,541423,3290,104666,5.015219163362851,0.16199935303031007
905,0.2625,15,152,15,64339,541271,3305,104651,5.013811182333543,0.16201801455903345
906,0.2626,21,252,21,64591,541019,3326,104630,5.01147689799548,0.16205399528226638
907,0.2627,9,194,9,64785,540825,3335,104621,5.009679869576494,0.1620910192332124
908,0.2628,15,179,15,64964,540646,3350,104606,5.008021786653822,0.16211650641919745
909,0.2629,19,370,19,65334,540276,3369,104587,5.004594464411427,0.16218483615899812
910,0.263,22,284,22,65618,539992,3391,104565,5.001963763014562,0.16222770057574426
911,0.2631,9,108,9,65726,539884,3400,104556,5.0009633554411055,0.16224318788405437
912,0.2632,6,174,6,65900,539710,3406,104550,4.999351587683871,0.16227920404805513
913,0.2633,10,108,10,66008,539602,3416,104540,4.998351180110415,0.16229340735427902
914,0.2634,21,274,21,66282,539328,3437,104519,4.995813109044425,0.16233515105296756
915,0.2635,28,275,28,66557,539053,3465,104491,4.993265774945348,0.16236807428862673
916,0.2636,9,159,9,66716,538894,3474,104482,4.991792952684427,0.16239648354927755
917,0.2637,7,124,7,66840,538770,3481,104475,4.99064433658157,0.16241867406664645
918,0.2638,13,274,13,67114,538496,3494,104462,4.98810626551558,0.1624709545569073
919,0.2639,23,255,23,67369,538241,3517,104439,4.985744192078254,0.16250544594510488
920,0.264,17,289,17,67658,537952,3534,104422,4.983067175515951,0.162556392382008
921,0.2641,23,363,23,68021,537589,3557,104399,4.979704694505169,0.1626183043919824
922,0.2642,16,172,16,68193,537417,3573,104383,4.978111452814109,0.16264100966033032
923,0.2643,24,371,24,68564,537046,3597,104359,4.974674867538627,0.16270375191961398
924,0.2644,12,216,12,68780,536830,3609,104347,4.9726740523917154,0.1627428931480699
925,0.2645,7,93,7,68873,536737,3616,104340,4.971812590314572,0.16275735988032639
926,0.2646,19,319,19,69192,536418,3635,104321,4.9688576827596425,0.16281356371314998
927,0.2647,16,270,16,69462,536148,3651,104305,4.966356663826003,0.1628612872451218
928,0.2648,12,200,12,69662,535948,3663,104293,4.964504057208492,0.16289647179733882
929,0.2649,11,196,11,69858,535752,3674,104282,4.962688502723331,0.16293196923913417
930,0.265,15,213,15,70071,535539,3689,104267,4.9607154766756825,0.16296658674660758
931,0.2651,15,249,15,70320,535290,3704,104252,4.9584089814368815,0.1630104043205919
932,0.2652,21,242,21,70562,535048,3725,104231,4.956167327429694,0.1630446174518481
933,0.2653,19,191,19,70753,534857,3744,104212,4.95439808810997,0.1630684636557242
934,0.2654,21,234,21,70987,534623,3765,104191,4.952230538367483,0.16310068345402573
935,0.2655,10,228,10,71215,534395,3775,104181,4.95011856682352,0.1631458119315477
936,0.2656,14,235,14,71450,534160,3789,104167,4.947941754047945,0.16318751987617633
937,0.2657,20,313,20,71763,533847,3809,104147,4.945042424691541,0.16324134709730811
938,0.2658,19,264,19,72027,533583,3828,104128,4.9425969839564265,0.16328399541485092
939,0.2659,12,178,12,72205,533405,3840,104116,4.9409481640668425,0.16331383593638485
940,0.266,17,190,17,72395,533215,3857,104099,4.939188187780207,0.16334020592674883
941,0.2661,13,236,13,72631,532979,3870,104086,4.937002111971544,0.16338364217152096
942,0.2662,8,135,8,72766,532844,3878,104078,4.935751602504724,0.16340776421602646
943,0.2663,18,225,18,72991,532619,3896,104060,4.933667420060025,0.16344186002679528
944,0.2664,33,401,33,73392,532218,3929,104027,4.929952943791915,0.1635014813475941
945,0.2665,15,173,15,73565,532045,3944,104012,4.928350439067768,0.16352622485091745
946,0.2666,23,409,23,73974,531636,3967,103989,4.924561858534958,0.16360117994100296
947,0.2667,4,186,4,74160,531450,3971,103985,4.922838934380674,0.16364380306404275
948,0.2668,12,235,12,74395,531215,3983,103973,4.9206621216050985,0.16368854575338326
949,0.2669,7,144,7,74539,531071,3990,103966,4.91932824484049,0.1637164448685667
950,0.267,24,359,24,74898,530712,4014,103942,4.916002815962059,0.16377742833102762
951,0.2671,13,194,13,75092,530518,4027,103929,4.914205787543073,0.16381037344332938
952,0.2672,5,85,5,75177,530433,4032,103924,4.913418429730631,0.16382573219811558
953,0.2673,11,290,11,75467,530143,4043,103913,4.910732150135241,0.1638861551661052
954,0.2674,16,294,16,75761,529849,4059,103897,4.9080088184075,0.16394107418429466
955,0.2675,19,241,19,76002,529608,4078,103878,4.905776427433398,0.16397836731987764
956,0.2676,11,203,11,76205,529405,4089,103867,4.903896031716625,0.16401641001023257
957,0.2677,12,114,12,76319,529291,4101,103855,4.902840045944644,0.1640300973235241
958,0.2678,18,191,18,76510,529100,4119,103837,4.901070806624921,0.16405582230142968
959,0.2679,11,177,11,76687,528923,4130,103826,4.8994312497684245,0.16408718148902646
960,0.268,20,270,20,76957,528653,4150,103806,4.896930230834784,0.1641307974113737
961,0.2681,11,173,11,77130,528480,4161,103795,4.895327726110637,0.16416116405045272
962,0.2682,3,101,3,77231,528379,4164,103792,4.8943921597687945,0.164183425054297
963,0.2683,26,357,26,77588,528022,4190,103766,4.891085256956538,0.16424180262999613
964,0.2684,16,155,16,77743,527867,4206,103750,4.889649486827967,0.16426093661190247
965,0.2685,14,153,14,77896,527714,4220,103736,4.8882322427655716,0.16428220761738854
966,0.2686,7,101,7,77997,527613,4227,103729,4.887296676423728,0.16429922292513408
967,0.2687,10,160,10,78157,527453,4237,103719,4.885814591129719,0.16432763177073761
968,0.2688,12,156,12,78313,527297,4249,103707,4.8843695579680615,0.16435236543666917
969,0.2689,17,220,17,78533,527077,4266,103690,4.882331690688799,0.16438716673510187
970,0.269,14,138,14,78671,526939,4280,103676,4.881053392122717,0.16440458917088874
971,0.2691,14,280,14,78951,526659,4294,103662,4.878459742858201,0.16445906133541482
972,0.2692,23,263,23,79214,526396,4317,103639,4.876023565156174,0.16449721047243407
973,0.2693,13,171,13,79385,526225,4330,103626,4.874439586498203,0.16452462566543516
974,0.2694,12,114,12,79499,526111,4342,103614,4.873383600726222,0.16453848902298623
975,0.2695,21,292,21,79791,525819,4363,103593,4.870678795064656,0.16458694781796343
976,0.2696,5,141,5,79932,525678,4368,103588,4.869372707399311,0.16461718891533947
977,0.2697,14,202,14,80134,525476,4382,103574,4.867501574715625,0.16465145854860505
978,0.2698,25,193,25,80327,525283,4407,103549,4.865713809329727,0.16466878275914712
979,0.2699,12,200,12,80527,525083,4419,103537,4.863861202712216,0.1647052273233432
980,0.27,11,141,11,80668,524942,4430,103526,4.862555115046871,0.1647275597166443
981,0.2701,22,266,22,80934,524676,4452,103504,4.860091148245582,0.16476806011015951
982,0.2702,23,246,23,81180,524430,4475,103481,4.857812442106043,0.1648020181204024
983,0.2703,31,386,31,81566,524044,4506,103450,4.854236911334247,0.16486213413992803
984,0.2704,8,176,8,81742,523868,4514,103442,4.852606617510838,0.164897737960498
985,0.2705,15,217,15,81959,523651,4529,103427,4.850596539330838,0.16493482469485454
986,0.2706,15,202,15,82161,523449,4544,103412,4.848725406647152,0.16496799130907808
987,0.2707,11,247,11,82408,523202,4555,103401,4.846437437474527,0.1650183609079433
988,0.2708,10,290,10,82698,522912,4565,103391,4.843751157879136,0.16508143821760393
989,0.2709,16,266,16,82964,522646,4581,103375,4.841287191077846,0.16513024323465186
990,0.271,8,163,8,83127,522483,4589,103367,4.839777316684575,0.1651625788927059
991,0.2711,12,212,12,83339,522271,4601,103355,4.8378135536700135,0.16520253314280417
992,0.2712,9,115,9,83454,522156,4610,103346,4.836748304864945,0.16522089457747538
993,0.2713,20,275,20,83729,521881,4630,103326,4.834200970765868,0.16526686361477078
994,0.2714,37,421,37,84150,521460,4667,103289,4.830301233836007,0.16532879604449147
995,0.2715,11,237,11,84387,521223,4678,103278,4.828105894994257,0.16537683686655424
996,0.2716,11,172,11,84559,521051,4689,103267,4.8265126533031975,0.1654076928744646
997,0.2717,14,229,14,84788,520822,4703,103253,4.824391418726147,0.16544966550494733
998,0.2718,13,199,13,84987,520623,4716,103240,4.822548075141724,0.1654850504036944
999,0.2719,20,365,20,85352,520258,4736,103220,4.819167068064767,0.16555515992545045
1000,0.272,12,257,12,85609,520001,4748,103208,4.816786468561266,0.1656073644636069
1001,0.2721,8,190,8,85799,519811,4756,103200,4.81502649227463,0.16564715550768766
1002,0.2722,14,200,14,85999,519611,4770,103186,4.81317388565712,0.16568159448423805
1003,0.2723,26,258,26,86257,519353,4796,103160,4.81078402312053,0.16571541477848656
1004,0.2724,19,281,19,86538,519072,4815,103141,4.808181110822928,0.16576477829939265
1005,0.2725,6,145,6,86683,518927,4821,103135,4.8068379710252325,0.16579537087943003
1006,0.2726,15,168,15,86851,518759,4836,103120,4.805281781466523,0.16582003894648314
1007,0.2727,12,266,12,87117,518493,4848,103108,4.802817814665234,0.16587489402365826
1008,0.2728,16,211,16,87328,518282,4864,103092,4.8008633146837605,0.16590974195894903
1009,0.2729,23,342,23,87670,517940,4887,103069,4.797695357367816,0.16597021943321272
1010,0.273,10,111,10,87781,517829,4897,103059,4.796667160695098,0.16598645810516552
1011,0.2731,23,352,23,88133,517477,4920,103036,4.793406573048279,0.16604970403520958
1012,0.2732,17,223,17,88356,517254,4937,103019,4.791340916669754,0.16608654576291407
1013,0.2733,11,177,11,88533,517077,4948,103008,4.789701359813257,0.1661191610827548
1014,0.2734,29,345,29,88878,516732,4977,102979,4.7865056133980515,0.16617261917248524
1015,0.2735,24,430,24,89308,516302,5001,102955,4.782522509170403,0.16625569028690834
1016,0.2736,22,302,22,89610,516000,5023,102933,4.7797250731779615,0.1663071770288545
1017,0.2737,34,370,34,89980,515630,5057,102899,4.776297750935567,0.16636083352599473
1018,0.2738,9,106,9,90086,515524,5066,102890,4.775315869428286,0.16637721655719306
1019,0.2739,30,307,30,90393,515217,5096,102860,4.772472118270406,0.16641939434730624
1020,0.274,14,179,14,90572,515038,5110,102846,4.770814035347734,0.16644871852969165
1021,0.2741,14,238,14,90810,514800,5124,102832,4.768609433472896,0.16649396404331382
1022,0.2742,17,166,17,90976,514634,5141,102815,4.767071769980363,0.16651577701154266
1023,0.2743,21,360,21,91336,514274,5162,102794,4.763737078068843,0.16658455794175034
1024,0.2744,14,208,14,91544,514066,5176,102780,4.761810367186632,0.16662181484519636
1025,0.2745,17,227,17,91771,513839,5193,102763,4.759707658675757,0.1666601794999043
1026,0.2746,14,151,14,91922,513688,5207,102749,4.7583089406795365,0.1666820778116823
1027,0.2747,20,333,20,92255,513355,5227,102729,4.755224350661381,0.16674511917206095
1028,0.2748,28,245,28,92500,513110,5255,102701,4.75295490755493,0.16677357176146576
1029,0.2749,16,116,16,92616,512994,5271,102685,4.751880395716774,0.16678334001971806
1030,0.275,15,151,15,92767,512843,5286,102670,4.750481677720553,0.16680395052582156
1031,0.2751,18,228,18,92995,512615,5304,102652,4.74836970617659,0.16684138756019745
1032,0.2752,23,259,23,93254,512356,5327,102629,4.745970580606914,0.16688049302015495
1033,0.2753,13,178,13,93432,512178,5340,102616,4.744321760717329,0.16691119301749854
1034,0.2754,16,263,16,93695,511915,5356,102600,4.741885583015303,0.16696093667363693
1035,0.2755,26,229,26,93924,511686,5382,102574,4.739764348438253,0.16698792042457591
1036,0.2756,32,322,32,94246,511364,5414,102542,4.73678165178406,0.16703208634546657
1037,0.2757,30,401,30,94647,510963,5444,102512,4.733067175515951,0.16710053384408494
1038,0.2758,13,202,13,94849,510761,5457,102499,4.731196042832265,0.16713791866418812
1039,0.2759,9,158,9,95007,510603,5466,102490,4.729732483604431,0.1671687655869501
1040,0.276,13,180,13,95187,510423,5479,102477,4.728065137648672,0.16720019579050416
1041,0.2761,23,306,23,95493,510117,5502,102454,4.72523064952388,0.16725244910385897
1042,0.2762,35,258,35,95751,509859,5537,102419,4.722840786987291,0.1672753226475555
1043,0.2763,17,267,17,96018,509592,5554,102402,4.7203675571529145,0.1673251698546064
1044,0.2764,25,400,25,96418,509192,5579,102377,4.716662343917893,0.167400571317382
1045,0.2765,13,177,13,96595,509015,5592,102364,4.715022787061395,0.16743133146542488
1046,0.2766,15,353,15,96948,508662,5607,102349,4.7117529363814885,0.16750762261235885
1047,0.2767,19,157,19,97105,508505,5626,102330,4.710298640186743,0.1675247816513461
1048,0.2768,22,303,22,97408,508202,5648,102308,4.707491941161214,0.1675779266514881
1049,0.2769,15,180,15,97588,508022,5663,102293,4.7058245952054545,0.1676068915232298
1050,0.277,19,318,19,97906,507704,5682,102274,4.702878950683612,0.16766834213692952
1051,0.2771,15,129,15,98035,507575,5697,102259,4.7016840194153176,0.16768333677689337
1052,0.2772,22,247,22,98282,507328,5719,102237,4.699396050242691,0.16772124383781878
1053,0.2773,11,156,11,98438,507172,5730,102226,4.697951017081033,0.1677491557241737
1054,0.2774,13,196,13,98634,506976,5743,102213,4.696135462595873,0.1677853671028203
1055,0.2775,12,178,12,98812,506798,5755,102201,4.694486642706288,0.16781800955338186
1056,0.2776,19,225,19,99037,506573,5774,102182,4.692402460261588,0.16785406280030554
1057,0.2777,11,143,11,99180,506430,5785,102171,4.691077846530068,0.16787846224373604
1058,0.2778,19,186,19,99366,506244,5804,102152,4.689354922375783,0.16790379949901052
1059,0.2779,11,121,11,99487,506123,5815,102141,4.688234095372189,0.1679221522233767
1060,0.278,10,208,10,99695,505915,5825,102131,4.686307384489977,0.16796591047387863
1061,0.2781,22,220,22,99915,505695,5847,102109,4.684269517210716,0.16799659100631126
1062,0.2782,26,280,26,100195,505415,5873,102083,4.6816758679462005,0.16803841329518782
1063,0.2783,9,170,9,100365,505245,5882,102074,4.680101152321316,0.1680731213744342
1064,0.2784,12,229,12,100594,505016,5894,102062,4.677979917744266,0.16812007682703045
1065,0.2785,16,248,16,100842,504768,5910,102046,4.675682685538553,0.16816685178654414
1066,0.2786,19,207,19,101049,504561,5929,102027,4.673765237689429,0.16819818394033512
1067,0.2787,22,198,22,101247,504363,5951,102005,4.6719311571380935,0.1682229273312576
1068,0.2788,11,178,11,101425,504185,5962,101994,4.6702823372485085,0.16825723094993392
1069,0.2789,20,240,20,101665,503945,5982,101974,4.668059209307495,0.16829642245910756
1070,0.279,14,175,14,101840,503770,5996,101960,4.666438178517174,0.16832582173575686
1071,0.2791,13,173,13,102013,503597,6009,101947,4.664835673793027,0.1683560567027334
1072,0.2792,14,186,14,102199,503411,6023,101933,4.663112749638742,0.16838855262462335
1073,0.2793,20,308,20,102507,503103,6043,101913,4.660259735447775,0.16844678487841644
1074,0.2794,28,271,28,102778,502832,6071,101885,4.657749453481048,0.16848377009411014
1075,0.2795,16,318,16,103096,502514,6087,101869,4.654803808959206,0.1685504059511932
1076,0.2796,19,245,19,103341,502269,6106,101850,4.6525343658527545,0.1685926117205385
1077,0.2797,20,206,20,103547,502063,6126,101830,4.650626181036719,0.16862258711394237
1078,0.2798,33,414,33,103961,501649,6159,101797,4.646791285338471,0.16869280764144595
1079,0.2799,30,265,30,104226,501384,6189,101767,4.644336581570269,0.16872557618241535
1080,0.28,23,292,23,104518,501092,6212,101744,4.641631775908704,0.16877558739026866
1081,0.2801,24,345,24,104863,500747,6236,101720,4.638436029493497,0.16883912313869473
1082,0.2802,19,362,19,105225,500385,6255,101701,4.635082811515803,0.1689144075763263
1083,0.2803,21,233,21,105458,500152,6276,101680,4.632924524806403,0.16895080354650469
1084,0.2804,28,276,28,105734,499876,6304,101652,4.6303679276742375,0.16898963971751937
1085,0.2805,8,159,8,105893,499717,6312,101644,4.628895105413316,0.16902326555928968
1086,0.2806,27,331,27,106224,499386,6339,101617,4.625829041461336,0.16907902290005208
1087,0.2807,26,317,26,106541,499069,6365,101591,4.622892659972582,0.16913228781673492
1088,0.2808,17,225,17,106766,498844,6382,101574,4.6208084775278815,0.16917214340675996
1089,0.2809,15,214,15,106980,498630,6397,101559,4.618826188447145,0.16921169831503077
1090,0.281,30,307,30,107287,498323,6427,101529,4.615982437289266,0.16925674999833293
1091,0.2811,18,255,18,107542,498068,6445,101511,4.61362036385194,0.16930379482937194
1092,0.2812,28,431,28,107973,497637,6473,101483,4.609627996591204,0.16938676725864601
1093,0.2813,26,300,26,108273,497337,6499,101457,4.606849086664938,0.1694355654866281
1094,0.2814,23,225,23,108498,497112,6522,101434,4.604764904220238,0.1694673425267231
1095,0.2815,31,338,31,108836,496774,6553,101403,4.601633999036644,0.16952005844423976
1096,0.2816,19,172,19,109008,496602,6572,101384,4.600040757345585,0.16954243075924855
1097,0.2817,6,115,6,109123,496487,6578,101378,4.598975508540517,0.16956670820335695
1098,0.2818,13,196,13,109319,496291,6591,101365,4.597159954055356,0.16960425395210624
1099,0.2819,12,185,12,109504,496106,6603,101353,4.595446292934159,0.16964009245822725
1100,0.282,23,232,23,109736,495874,6626,101330,4.593297269257846,0.16967401423969028
1101,0.2821,29,271,29,110007,495603,6655,101301,4.590786987291119,0.16971070724940693
1102,0.2822,21,177,21,110184,495426,6676,101280,4.589147430434622,0.1697318277342611
1103,0.2823,14,216,14,110400,495210,6690,101266,4.587146615287709,0.16977380481360524
1104,0.2824,9,209,9,110609,495001,6699,101257,4.585210641372411,0.1698207822788122
1105,0.2825,26,292,26,110901,494709,6725,101231,4.582505835710845,0.16986777192334798
1106,0.2826,27,346,27,111247,494363,6752,101204,4.579300826262552,0.1699288241289393
1107,0.2827,24,179,24,111426,494184,6776,101180,4.577642743339879,0.16994645292627703
1108,0.2828,25,280,25,111706,493904,6801,101155,4.575049094075364,0.1699915470566784
1109,0.2829,10,177,10,111883,493727,6811,101145,4.573409537218867,0.17002817412821583
1110,0.283,13,186,13,112069,493541,6824,101132,4.571686613064582,0.17006321121019452
1111,0.2831,23,416,23,112485,493125,6847,101109,4.567833191300159,0.1701501428730096
1112,0.2832,17,160,17,112645,492965,6864,101092,4.566351106006151,0.17017222253083458
1113,0.2833,17,271,17,112916,492694,6881,101075,4.563840824039423,0.17022613171115367
1114,0.2834,16,319,16,113235,492375,6897,101059,4.5608859164844935,0.170295264511302
1115,0.2835,28,243,28,113478,492132,6925,101031,4.558634999444218,0.17032586321129267
1116,0.2836,14,219,14,113697,491913,6939,101017,4.556606395198044,0.17036918354611844
1117,0.2837,29,421,29,114118,491492,6968,100988,4.552706658268184,0.17044963543073183
1118,0.2838,41,321,41,114439,491171,7009,100947,4.5497332246470785,0.17048459935350724
1119,0.2839,19,294,19,114733,490877,7028,100928,4.547009892919338,0.1705426618565237
1120,0.284,23,197,23,114930,490680,7051,100905,4.545185075401089,0.170567205050838
1121,0.2841,22,259,22,115189,490421,7073,100883,4.542785949831413,0.1706110562417978
1122,0.2842,11,201,11,115390,490220,7084,100872,4.540924080180814,0.170653637674
1123,0.2843,23,226,23,115616,489994,7107,100849,4.538830634703027,0.17068662910451676
1124,0.2844,39,344,39,115960,489650,7146,100810,4.535644151320908,0.17073129424516478
1125,0.2845,12,293,12,116253,489357,7158,100798,4.5329300826262555,0.1707991968211741
1126,0.2846,26,254,26,116507,489103,7184,100772,4.530577272222017,0.17083619410892137
1127,0.2847,25,281,25,116788,488822,7209,100747,4.527974359924413,0.17088245820251743
1128,0.2848,15,170,15,116958,488652,7224,100732,4.52639964429953,0.17091064569109443
1129,0.2849,25,228,25,117186,488424,7249,100707,4.524287672755567,0.17094160721469417
1130,0.285,18,173,18,117359,488251,7267,100689,4.52268516803142,0.17096648215437904
1131,0.2851,20,203,20,117562,488048,7287,100669,4.520804772314647,0.17099727033532242
1132,0.2852,16,244,16,117806,487804,7303,100653,4.518544592241284,0.17104563290095962
1133,0.2853,13,301,13,118107,487503,7316,100640,4.51575641928193,0.1711148479196386
1134,0.2854,10,145,10,118252,487358,7326,100630,4.514413279484234,0.17114294849554754
1135,0.2855,25,262,25,118514,487096,7351,100605,4.511986364815295,0.17118398641486063
1136,0.2856,23,189,23,118703,486907,7374,100582,4.510235651561747,0.1712066098258861
1137,0.2857,19,273,19,118976,486634,7393,100563,4.507706843528845,0.17125938994919934
1138,0.2858,27,365,27,119341,486269,7420,100536,4.504325836451888,0.17132778350559386
1139,0.2859,28,280,28,119621,485989,7448,100508,4.501732187187373,0.17137001553290127
1140,0.286,20,287,20,119908,485702,7468,100488,4.499073696691244,0.17142564697453044
1141,0.2861,17,179,17,120087,485523,7485,100471,4.497415613768572,0.1714539739314737
1142,0.2862,28,237,28,120324,485286,7513,100443,4.495220274926822,0.17148374077431713
1143,0.2863,17,226,17,120550,485060,7530,100426,4.493126829449035,0.1715258776469463
1144,0.2864,9,195,9,120745,484865,7539,100417,4.491320537996962,0.17157028577677086
1145,0.2865,36,332,36,121077,484533,7575,100381,4.488245211011893,0.1716166821105325
1146,0.2866,15,187,15,121264,484346,7590,100366,4.486513023824521,0.17165031673712872
1147,0.2867,24,257,24,121521,484089,7614,100342,4.48413242432102,0.1716917822634323
1148,0.2868,26,347,26,121868,483742,7640,100316,4.480918151839639,0.17175691455300673
1149,0.2869,17,260,17,122128,483482,7657,100299,4.478509763236874,0.17180929149801039
1150,0.287,20,240,20,122368,483242,7677,100279,4.476286635295861,0.17185157003775356
1151,0.2871,25,341,25,122709,482901,7702,100254,4.473127941013005,0.17191655734753197
1152,0.2872,12,201,12,122910,482700,7714,100242,4.471266071362407,0.17195878835287215
1153,0.2873,17,269,17,123179,482431,7731,100225,4.468774315461855,0.1720140185632689
1154,0.2874,17,260,17,123439,482171,7748,100208,4.4663659268590905,0.17206664388654125
1155,0.2875,34,276,34,123715,481895,7782,100174,4.463809329726926,0.17209987132109766
1156,0.2876,24,365,24,124080,481530,7806,100150,4.460428322649968,0.17217370375464172
1157,0.2877,36,380,36,124460,481150,7842,100114,4.456908370076698,0.1722349913292411
1158,0.2878,22,311,22,124771,480839,7864,100092,4.454027566786468,0.17229584924887809
1159,0.2879,27,296,27,125067,480543,7891,100065,4.451285708992552,0.17234519675925927
1160,0.288,18,180,18,125247,480363,7909,100047,4.449618363036793,0.17237297772264434
1161,0.2881,59,451,59,125698,479912,7968,99988,4.445440735114306,0.17242283152267632
1162,0.2882,22,274,22,125972,479638,7990,99966,4.442902664048316,0.17247292979344517
1163,0.2883,36,287,36,126259,479351,8026,99930,4.440244173552188,0.17250695258432436
1164,0.2884,20,309,20,126568,479042,8046,99910,4.437381896328134,0.17257043761831722
1165,0.2885,14,179,14,126747,478863,8060,99896,4.4357238134054615,0.17260379536214557
1166,0.2886,17,279,17,127026,478584,8077,99879,4.433139427174034,0.17266272864470156
1167,0.2887,23,176,23,127202,478408,8100,99856,4.431509133350624,0.17268237344880538
1168,0.2888,44,425,44,127627,477983,8144,99812,4.427572344288413,0.17274638929031924
1169,0.2889,20,266,20,127893,477717,8164,99792,4.425108377487124,0.172797307054955
1170,0.289,24,284,24,128177,477433,8188,99768,4.422477676090259,0.1728479333888888
1171,0.2891,14,239,14,128416,477194,8202,99754,4.420263811182333,0.17289946407648524
1172,0.2892,23,343,23,128759,476851,8225,99731,4.417086590833303,0.17296932613227606
1173,0.2893,36,250,36,129009,476601,8261,99695,4.414770832561414,0.17299269819676
1174,0.2894,10,206,10,129215,476395,8271,99685,4.412862647745378,0.17304020274961812
1175,0.2895,15,262,15,129477,476133,8286,99670,4.410435733076438,0.173097396158061
1176,0.2896,23,260,23,129737,475873,8309,99647,4.408027344473674,0.17314254934667778
1177,0.2897,21,284,21,130021,475589,8330,99626,4.405396643076809,0.17319784776127187
1178,0.2898,30,239,30,130260,475350,8360,99596,4.403182778168883,0.1732267030295019
1179,0.2899,28,307,28,130567,475043,8388,99568,4.400339027011005,0.17327896611794763
1180,0.29,15,163,15,130730,474880,8403,99553,4.398829152617733,0.1733065474998825
1181,0.2901,12,188,12,130918,474692,8415,99541,4.397087702397273,0.17334601111395548
1182,0.2902,25,200,25,131118,474492,8440,99516,4.395235095779762,0.173370405987373
1183,0.2903,31,239,31,131357,474253,8471,99485,4.393021230871836,0.17339796213602723
1184,0.2904,28,257,28,131614,473996,8499,99457,4.390640631368335,0.17343531204824109
1185,0.2905,25,263,25,131877,473733,8524,99432,4.388204453666308,0.17347884117139042
1186,0.2906,32,313,32,132190,473420,8556,99400,4.385305124309904,0.17352746063335778
1187,0.2907,33,280,33,132470,473140,8589,99367,4.382711475045389,0.1735646900387244
1188,0.2908,39,289,39,132759,472851,8628,99328,4.3800344584830855,0.1735960250201423
1189,0.2909,22,190,22,132949,472661,8650,99306,4.37827448219645,0.17362190476023967
1190,0.291,27,223,27,133172,472438,8677,99279,4.376208825817926,0.1736505998597208
1191,0.2911,15,201,15,133373,472237,8692,99264,4.374346956167328,0.1736899847944273
1192,0.2912,30,289,30,133662,471948,8722,99234,4.371669939605025,0.1737344664222612
1193,0.2913,17,238,17,133900,471710,8739,99217,4.369465337730186,0.17378228740276777
1194,0.2914,21,282,21,134182,471428,8760,99196,4.366853162399496,0.1738377635711081
1195,0.2915,21,210,21,134392,471218,8781,99175,4.36490792545111,0.1738713483510492
1196,0.2916,18,339,18,134731,470879,8799,99157,4.3617677572344284,0.17394866289146652
1197,0.2917,27,296,27,135027,470583,8826,99130,4.359025899440513,0.17399989117327497
1198,0.2918,26,228,26,135255,470355,8852,99104,4.35691392789655,0.1740318442592004
1199,0.2919,31,365,31,135620,469990,8883,99073,4.353532920819593,0.17409847415839722
1200,0.292,22,185,22,135805,469805,8905,99051,4.351819259698396,0.17412315243225
1201,0.2921,42,407,42,136212,469398,8947,99009,4.348049205231761,0.17418680628493316
1202,0.2922,21,238,21,136450,469160,8968,98988,4.345844603356923,0.17422925012496743
1203,0.2923,27,316,27,136766,468844,8995,98961,4.342917484901256,0.17428694710331893
1204,0.2924,43,381,43,137147,468463,9038,98918,4.339388269294898,0.17434140374809873
1205,0.2925,29,305,29,137452,468158,9067,98889,4.336563044203194,0.17439295155428033
1206,0.2926,28,323,28,137775,467835,9095,98861,4.333571084515914,0.17445155780171379
1207,0.2927,18,205,18,137980,467630,9113,98843,4.331672162732965,0.17448845752577793
1208,0.2928,24,275,24,138255,467355,9137,98819,4.329124828633888,0.17453821616676146
1209,0.2929,29,244,29,138499,467111,9166,98790,4.326864648560525,0.1745711705757721
1210,0.293,30,258,30,138757,466853,9196,98760,4.324474786023936,0.174607019287039
1211,0.2931,23,307,23,139064,466546,9219,98737,4.321631034866057,0.1746682635069514
1212,0.2932,34,402,34,139466,466144,9253,98703,4.31790729556486,0.17474289497864023
1213,0.2933,32,201,32,139667,465943,9285,98671,4.316045425914261,0.17475833047002023
1214,0.2934,30,265,30,139932,465678,9315,98641,4.31359072214606,0.17479652466069723
1215,0.2935,28,269,28,140201,465409,9343,98613,4.311098966245507,0.1748389247227945
1216,0.2936,24,237,24,140438,465172,9367,98589,4.308903627403757,0.17487729729442086
1217,0.2937,30,310,30,140748,464862,9397,98559,4.306032087146615,0.1749295819644635
1218,0.2938,35,426,35,141174,464436,9432,98524,4.3020860350513175,0.17501065795083132
1219,0.2939,28,303,28,141477,464133,9460,98496,4.299279336025788,0.17506385202326932
1220,0.294,25,241,25,141718,463892,9485,98471,4.2970469450516875,0.1751022026698058
1221,0.2941,33,316,33,142034,463576,9518,98438,4.29411982659602,0.1751522204073208
1222,0.2942,46,391,46,142425,463185,9564,98392,4.290497980658787,0.17520660568363733
1223,0.2943,25,271,25,142696,462914,9589,98367,4.28798769869206,0.17525446255975172
1224,0.2944,35,283,35,142979,462631,9624,98332,4.285366260328282,0.17529141850710298
1225,0.2945,31,251,31,143230,462380,9655,98301,4.283041239023306,0.17532429313638237
1226,0.2946,23,228,23,143458,462152,9678,98278,4.280929267479343,0.1753617757793123
1227,0.2947,24,313,24,143771,461839,9702,98254,4.278029938122939,0.17542443844147312
1228,0.2948,16,163,16,143934,461676,9718,98238,4.276520063729667,0.17545194440574802
1229,0.2949,35,278,35,144212,461398,9753,98203,4.273944940531328,0.17548753486859386
1230,0.295,30,285,30,144497,461113,9783,98173,4.271304976101375,0.1755327328057559
1231,0.2951,34,350,34,144847,460763,9817,98139,4.268062914520731,0.17559250101091067
1232,0.2952,32,314,32,145161,460449,9849,98107,4.265154322131239,0.175643981982111
1233,0.2953,29,361,29,145522,460088,9878,98078,4.261810367186632,0.17571475152553184
1234,0.2954,28,374,28,145896,459714,9906,98050,4.258345992811886,0.17579119484226305
1235,0.2955,40,273,40,146169,459441,9946,98010,4.255817184778984,0.17581814365746945
1236,0.2956,32,321,32,146490,459120,9978,97978,4.252843751157879,0.1758721086774679
1237,0.2957,38,358,38,146848,458762,10016,97940,4.249527585312535,0.17592895301256328
1238,0.2958,31,383,31,147231,458379,10047,97909,4.245979843640002,0.17600415612057063
1239,0.2959,31,246,31,147477,458133,10078,97878,4.243701137500463,0.17603608561701117
1240,0.296,26,295,26,147772,457838,10104,97852,4.240968542739635,0.1760909859813925
1241,0.2961,41,358,41,148130,457480,10145,97811,4.237652376894291,0.17614367962023517
1242,0.2962,13,206,13,148336,457274,10158,97798,4.235744192078254,0.17618975556324223
1243,0.2963,18,238,18,148574,457036,10176,97780,4.233539590203416,0.17623860883608258
1244,0.2964,38,365,38,148939,456671,10214,97742,4.2301585831264585,0.17629817482634785
1245,0.2965,15,190,15,149129,456481,10229,97727,4.228398606839824,0.1763363213811421
1246,0.2966,47,342,47,149471,456139,10276,97680,4.22523064952388,0.1763753139563648
1247,0.2967,42,312,42,149783,455827,10318,97638,4.222340583200563,0.17641223925632155
1248,0.2968,31,231,31,150014,455596,10349,97607,4.220200822557338,0.17643975177285734
1249,0.2969,32,307,32,150321,455289,10381,97575,4.2173570713994595,0.17649005903802745
1250,0.297,30,343,30,150664,454946,10411,97545,4.214179851050428,0.17655491220671468
1251,0.2971,31,304,31,150968,454642,10442,97514,4.211363888991811,0.17660588674215258
1252,0.2972,31,346,31,151314,454296,10473,97483,4.208158879543518,0.176670369840099
1253,0.2973,32,387,32,151701,453909,10505,97451,4.204574085738634,0.1767465902495647
1254,0.2974,30,388,30,152089,453521,10535,97421,4.200980028900664,0.17682623579251536
1255,0.2975,52,389,52,152478,453132,10587,97369,4.197376709029605,0.1768734298393645
1256,0.2976,32,264,32,152742,452868,10619,97337,4.19493126829449,0.1769104242963986
1257,0.2977,30,331,30,153073,452537,10649,97307,4.19186520434251,0.1769720138803006
1258,0.2978,31,295,31,153368,452242,10680,97276,4.189132609581681,0.1770205889525002
1259,0.2979,42,328,42,153696,451914,10722,97234,4.186094334728963,0.17706337817856024
1260,0.298,19,300,19,153996,451614,10741,97215,4.183315424802697,0.17713167489327278
1261,0.2981,46,379,46,154375,451235,10787,97169,4.179804735262515,0.17718506794261166
1262,0.2982,22,213,22,154588,451022,10809,97147,4.177831709214865,0.17722089355654916
1263,0.2983,42,353,42,154941,450669,10851,97105,4.174561858534958,0.17727201364066203
1264,0.2984,29,282,29,155223,450387,10880,97076,4.171949683204269,0.17731974580930585
1265,0.2985,31,304,31,155527,450083,10911,97045,4.169133721145652,0.1773716570893831
1266,0.2986,36,351,36,155878,449732,10947,97009,4.16588239653192,0.17743136146731267
1267,0.2987,38,393,38,156271,449339,10985,96971,4.162242024528512,0.17750178470099395
1268,0.2988,26,316,26,156587,449023,11011,96945,4.1593149060728445,0.17756535181549102
1269,0.2989,36,300,36,156887,448723,11047,96909,4.156535996146578,0.1776087179637558
1270,0.299,46,294,46,157181,448429,11093,96863,4.153812664418838,0.17763510192704093
1271,0.2991,36,322,36,157503,448107,11129,96827,4.150829967764645,0.1776857380893833
1272,0.2992,29,246,29,157749,447861,11158,96798,4.148551261625107,0.17772220784013484
1273,0.2993,22,257,22,158006,447604,11180,96776,4.146170662121605,0.17777287923876703
1274,0.2994,29,261,29,158267,447343,11209,96747,4.143753010485754,0.17781433218768955
1275,0.2995,32,296,32,158563,447047,11241,96715,4.141011152691838,0.17786274141995947
1276,0.2996,25,293,25,158856,446754,11266,96690,4.138297083997184,0.17792081612824873
1277,0.2997,41,343,41,159199,446411,11307,96649,4.1351198636481525,0.1779711265790152
1278,0.2998,38,343,38,159542,446068,11345,96611,4.131942643299122,0.1780260522334566
1279,0.2999,41,342,41,159884,445726,11386,96570,4.128774685983179,0.17807617979848644
1280,0.3,31,282,31,160166,445444,11417,96539,4.126162510652488,0.17812182300920879
1281,0.3001,42,369,42,160535,445075,11459,96497,4.122744451443181,0.1781794479773696
1282,0.3002,41,311,41,160846,444764,11500,96456,4.119863648152951,0.17821957799046598
1283,0.3003,25,284,25,161130,444480,11525,96431,4.1172329467560855,0.17827516911284852
1284,0.3004,35,373,35,161503,444107,11560,96396,4.113777835414428,0.1783449860592818
1285,0.3005,32,386,32,161889,443721,11592,96364,4.110202304642632,0.17842376662932685
1286,0.3006,39,535,39,162424,443186,11631,96325,4.105246581940791,0.17854130870362236
1287,0.3007,31,387,31,162811,442799,11662,96294,4.101661788135908,0.17862224143144134
1288,0.3008,23,234,23,163045,442565,11685,96271,4.09949423839342,0.17866475142715038
1289,0.3009,36,318,36,163363,442247,11721,96235,4.096548593871577,0.17871535167377925
1290,0.301,50,432,50,163795,441815,11771,96185,4.092546963577754,0.1787825278810409
1291,0.3011,45,298,45,164093,441517,11816,96140,4.0897865797176625,0.1788128862825184
1292,0.3012,45,388,45,164481,441129,11861,96095,4.086192522879692,0.17887324468005897
1293,0.3013,29,246,29,164727,440883,11890,96066,4.083913816740154,0.17891084628149043
1294,0.3014,30,317,30,165044,440566,11920,96036,4.080977435251398,0.17897063372853622
1295,0.3015,49,460,49,165504,440106,11969,95987,4.076716440031124,0.17904915751558032
1296,0.3016,41,428,41,165932,439678,12010,95946,4.0727518618696505,0.17912938927307215
1297,0.3017,30,287,30,166219,439391,12040,95916,4.070093371373522,0.17917942414352886
1298,0.3018,41,303,41,166522,439088,12081,95875,4.0672866723479935,0.17921800199266116
1299,0.3019,37,365,37,166887,438723,12118,95838,4.063905665271037,0.1792835616515234
1300,0.302,50,388,50,167275,438335,12168,95788,4.060311608433065,0.17933696919997827
1301,0.3021,27,203,27,167478,438132,12195,95761,4.058431212716292,0.17936365526425707
1302,0.3022,42,310,42,167788,437822,12237,95719,4.05555967245915,0.17940326985180147
1303,0.3023,30,351,30,168139,437471,12267,95689,4.052308347845418,0.17947520444144346
1304,0.3024,27,277,27,168416,437194,12294,95662,4.049742487680166,0.17952692659930639
1305,0.3025,52,473,52,168889,436721,12346,95610,4.045361073029753,0.1796062975855248
1306,0.3026,40,295,40,169184,436426,12386,95570,4.042628478268925,0.17964420785118684
1307,0.3027,49,395,49,169579,436031,12435,95521,4.038969580199341,0.17970207994702306
1308,0.3028,40,336,40,169915,435695,12475,95481,4.035857201081923,0.17975397984848712
1309,0.3029,63,472,63,170387,435223,12538,95418,4.031485049464597,0.17981648609888795
1310,0.303,50,300,50,170687,434923,12588,95368,4.028706139538331,0.17984087981881647
1311,0.3031,33,344,33,171031,434579,12621,95335,4.025519656156212,0.1799065508742928
1312,0.3032,61,546,61,171577,434033,12682,95274,4.020462040090408,0.17999761952893123
1313,0.3033,37,295,37,171872,433738,12719,95237,4.017729445329579,0.18004064464294153
1314,0.3034,26,243,26,172115,433495,12745,95211,4.015478528289303,0.18008307074252988
1315,0.3035,37,336,37,172451,433159,12782,95174,4.012366149171885,0.180140176744591
1316,0.3036,53,417,53,172868,432742,12835,95121,4.008503464374375,0.18020016557326426
1317,0.3037,31,325,31,173193,432417,12866,95090,4.00549297862092,0.18026301072781972
1318,0.3038,51,451,51,173644,431966,12917,95039,4.001315350698433,0.18033794745780402
1319,0.3039,58,669,58,174313,431297,12975,94981,3.995118381562859,0.18047685823842152
1320,0.304,30,337,30,174650,430960,13005,94951,3.991996739412353,0.1805457577422796
1321,0.3041,41,407,41,175057,430553,13046,94910,3.9882266849457184,0.18062166127776838
1322,0.3042,48,408,48,175465,430145,13094,94862,3.9844473674459966,0.18068711464799517
1323,0.3043,50,412,50,175877,429733,13144,94812,3.980630997813924,0.18075093652594154
1324,0.3044,49,381,49,176258,429352,13193,94763,3.977101782207566,0.18080573919845835
1325,0.3045,40,454,40,176712,428898,13233,94723,3.9728963651858162,0.18089992570962585
1326,0.3046,45,433,45,177145,428465,13278,94678,3.9688854718589055,0.18097919689262784
1327,0.3047,29,345,29,177490,428120,13307,94649,3.965689725443699,0.18105319940547354
1328,0.3048,64,482,64,177972,427638,13371,94585,3.9612249434954983,0.18111994301285084
1329,0.3049,35,327,35,178299,427311,13406,94550,3.958195931675868,0.18117851305232618
1330,0.305,53,399,53,178698,426912,13459,94497,3.954499981473934,0.18123392576652878
1331,0.3051,25,284,25,178982,426628,13484,94472,3.9518692800770685,0.18129341777010172
1332,0.3052,42,335,42,179317,426293,13526,94430,3.9487661639927376,0.1813440159163317
1333,0.3053,49,427,49,179744,425866,13575,94381,3.944810848864352,0.18141575059539028
1334,0.3054,66,565,66,180309,425301,13641,94315,3.939577235169884,0.18150903744303484
1335,0.3055,40,368,40,180677,424933,13681,94275,3.936168438993664,0.18157462905039984
1336,0.3056,40,389,40,181066,424544,13721,94235,3.9325651191226054,0.18164767656362343
1337,0.3057,73,447,73,181513,424097,13794,94162,3.928424543332469,0.18168907824080238
1338,0.3058,39,337,39,181850,423760,13833,94123,3.925302901181963,0.1817456838706812
1339,0.3059,56,441,56,182291,423319,13889,94067,3.921217903590352,0.18181203202251317
1340,0.306,36,317,36,182608,423002,13925,94031,3.918281522101597,0.18186653463125177
1341,0.3061,69,508,69,183116,422494,13994,93962,3.9135759012931195,0.18193611846894991
1342,0.3062,45,333,45,183449,422161,14039,93917,3.910491311274964,0.1819821809881452
1343,0.3063,47,359,47,183808,421802,14086,93870,3.907165882396532,0.18203431638716083
1344,0.3064,57,472,57,184280,421330,14143,93813,3.9027937307792064,0.18211059841636207
1345,0.3065,38,354,38,184634,420976,14181,93775,3.8995146170662123,0.18217545959114212
1346,0.3066,38,308,38,184942,420668,14219,93737,3.8966616028752457,0.1822241230159116
1347,0.3067,41,370,41,185312,420298,14260,93696,3.8932342806328504,0.1822900656427896
1348,0.3068,45,361,45,185673,419937,14305,93651,3.8898903256882433,0.18234655015304096
1349,0.3069,51,387,51,186060,419550,14356,93600,3.8863055318833597,0.1824028061970184
1350,0.307,58,534,58,186594,419016,14414,93542,3.881359072214606,0.18250032191478818
1351,0.3071,47,329,47,186923,418687,14461,93495,3.878311534328801,0.18254253370872073
1352,0.3072,60,504,60,187427,418183,14521,93435,3.873642965652673,0.1826264908584139
1353,0.3073,48,521,48,187948,417662,14569,93387,3.8688169254140576,0.182735902036791
1354,0.3074,67,520,67,188468,417142,14636,93320,3.8640001482085293,0.1828147834706599
1355,0.3075,60,545,60,189013,416597,14696,93260,3.8589517951758125,0.18291403275820475
1356,0.3076,53,393,53,189406,416204,14749,93207,3.8553114231724037,0.18297013609835672
1357,0.3077,68,481,68,189887,415723,14817,93139,3.85085590425729,0.18303390703176892
1358,0.3078,36,420,36,190307,415303,14853,93103,3.8469654303605174,0.18312726443039617
1359,0.3079,32,361,32,190668,414942,14885,93071,3.8436214754159104,0.18320594158023515
1360,0.308,39,268,39,190936,414674,14924,93032,3.8411389825484457,0.1832399065600958
1361,0.3081,63,530,63,191466,414144,14987,92969,3.836229575012042,0.18332994815751125
1362,0.3082,49,333,49,191799,413811,15036,92920,3.8331449849938863,0.1833714534930762
1363,0.3083,66,545,66,192344,413266,15102,92854,3.8280966319611696,0.1834624199794515
1364,0.3084,43,397,43,192741,412869,15145,92811,3.8244192078254104,0.18353701945894638
1365,0.3085,41,290,41,193031,412579,15186,92770,3.8217329282300194,0.1835761028516926
1366,0.3086,35,377,35,193408,412202,15221,92735,3.8182407647560117,0.1836565749786607
1367,0.3087,34,428,34,193836,411774,15255,92701,3.8142761865945385,0.18375737152485258
1368,0.3088,48,328,48,194164,411446,15303,92653,3.811237911741821,0.18379921404327323
1369,0.3089,40,395,40,194559,411051,15343,92613,3.8075790136722367,0.18387853807300106
1370,0.309,84,569,84,195128,410482,15427,92529,3.8023083478454187,0.1839502515849554
1371,0.3091,48,393,48,195521,410089,15475,92481,3.79866797584201,0.18401615695326023
1372,0.3092,41,323,41,195844,409766,15516,92440,3.79567601615473,0.18406789245847321
1373,0.3093,71,451,71,196295,409315,15587,92369,3.7914983882322426,0.18411789094330294
1374,0.3094,58,537,58,196832,408778,15645,92311,3.786524139464226,0.18422076716910568
1375,0.3095,40,327,40,197159,408451,15685,92271,3.783495127644596,0.18427590559232468
1376,0.3096,64,527,64,197686,407924,15749,92207,3.778613509207455,0.18436569618759885
1377,0.3097,40,395,40,198081,407529,15789,92167,3.774954611137871,0.1844461432550991
1378,0.3098,57,432,57,198513,407097,15846,92110,3.7709529808440476,0.18451263704234916
1379,0.3099,51,457,51,198970,406640,15897,92059,3.766719774723035,0.1845983248412369
1380,0.31,53,486,53,199456,406154,15950,92006,3.762217940642484,0.18469166532840856
1381,0.3101,57,458,57,199914,405696,16007,91949,3.757975471488384,0.18476825849752335
1382,0.3102,29,352,29,200266,405344,16036,91920,3.754714883841565,0.1848515074487596
1383,0.3103,52,329,52,200595,405015,16088,91868,3.75166734595576,0.18488859550437428
1384,0.3104,72,655,72,201250,404360,16160,91796,3.7456000592834116,0.18501439063520345
1385,0.3105,59,480,59,201730,403880,16219,91737,3.7411538034013856,0.18509655641352094
1386,0.3106,43,400,43,202130,403480,16262,91694,3.737448590166364,0.18517531211250995
1387,0.3107,50,372,50,202502,403108,16312,91644,3.734002741857794,0.18523219714119396
1388,0.3108,56,496,56,202998,402612,16368,91588,3.729408277446367,0.1853257790368272
1389,0.3109,52,385,52,203383,402227,16420,91536,3.7258420097076588,0.18538448607935387
1390,0.311,39,404,39,203787,401823,16459,91497,3.722099744340287,0.18547190464607152
1391,0.3111,67,549,67,204336,401274,16526,91430,3.7170143391752197,0.18556780541663961
1392,0.3112,37,311,37,204647,400963,16563,91393,3.71413353588499,0.18562381691296542
1393,0.3113,48,353,48,205000,400610,16611,91345,3.7108636852050836,0.18567755180860038
1394,0.3114,36,339,36,205339,400271,16647,91309,3.707723516988403,0.18574596200008137
1395,0.3115,51,431,51,205770,399840,16698,91258,3.703731149727667,0.18582441793694945
1396,0.3116,41,384,41,206154,399456,16739,91217,3.700174145022046,0.18590181240867135
1397,0.3117,45,309,45,206463,399147,16784,91172,3.6973118677979917,0.1859442526192132
1398,0.3118,46,471,46,206934,398676,16830,91126,3.6929489792137535,0.1860466065879682
1399,0.3119,52,533,52,207467,398143,16882,91074,3.688011782578087,0.18616278665704586
1400,0.312,47,364,47,207831,397779,16929,91027,3.6846400385342175,0.18622316420011212
1401,0.3121,59,475,59,208306,397304,16988,90968,3.6802400978176295,0.1863059933807386
1402,0.3122,58,374,58,208680,396930,17046,90910,3.676775723442884,0.18635208265004918
1403,0.3123,34,342,34,209022,396588,17080,90876,3.6736077661269406,0.18642607454088916
1404,0.3124,41,316,41,209338,396272,17121,90835,3.6706806476712734,0.18647853551683716
1405,0.3125,52,463,52,209801,395809,17173,90783,3.666391863351736,0.18656903524924373
1406,0.3126,81,537,81,210338,395272,17254,90702,3.661417614583719,0.18663961446497138
1407,0.3127,72,526,72,210864,394746,17326,90630,3.6565452591796657,0.18672122231012658
1408,0.3128,42,362,42,211226,394384,17368,90588,3.6531920412019714,0.18679016520541392
1409,0.3129,64,573,64,211799,393811,17432,90524,3.6478843232428027,0.18690369269204166
1410,0.313,60,474,60,212273,393337,17492,90464,3.643493645559302,0.18698597150481294
1411,0.3131,70,383,70,212656,392954,17562,90394,3.6399459038867685,0.18701639398528597
1412,0.3132,42,371,42,213027,392583,17604,90352,3.636509318611286,0.18708935985173988
1413,0.3133,46,382,46,213409,392201,17650,90306,3.6329708399718403,0.187159979026211
1414,0.3134,31,318,31,213727,391883,17681,90275,3.6300251954499982,0.1872311565918226
1415,0.3135,76,595,76,214322,391288,17757,90199,3.624513690762903,0.1873342374768166
1416,0.3136,49,410,49,214732,390878,17806,90150,3.620715847197006,0.18741112783455433
1417,0.3137,55,338,55,215070,390540,17861,90095,3.617584942013413,0.1874499360221374
1418,0.3138,42,382,42,215452,390158,17903,90053,3.6140464633739673,0.18752798249102998
1419,0.3139,32,282,32,215734,389876,17935,90021,3.611434288043277,0.18758400240051512
1420,0.314,71,503,71,216237,389373,18006,89950,3.6067749824002373,0.18766051284832982
1421,0.3141,30,325,30,216562,389048,18036,89920,3.603764496646782,0.1877369678141337
1422,0.3142,48,410,48,216972,388638,18084,89872,3.5999666530808847,0.18781634657582913
1423,0.3143,72,578,72,217550,388060,18156,89800,3.5946126199562785,0.18792114845352195
1424,0.3144,49,402,49,217952,387658,18205,89751,3.590888880655082,0.1879960369410715
1425,0.3145,64,646,64,218598,387012,18269,89687,3.5849049612805217,0.18814178338951834
1426,0.3146,41,324,41,218922,386688,18310,89646,3.581903738560154,0.18819987655720566
1427,0.3147,64,594,64,219516,386094,18374,89582,3.576401496906147,0.18832566705068154
1428,0.3148,60,476,60,219992,385618,18434,89522,3.5719922931564714,0.18841183651134402
1429,0.3149,54,397,54,220389,385221,18488,89468,3.5683148690207123,0.18847708710334557
1430,0.315,61,389,61,220778,384832,18549,89407,3.5647115491496537,0.18852730374347113
1431,0.3151,52,418,52,221196,384414,18601,89355,3.560839601319056,0.1886045731147458
1432,0.3152,72,430,72,221626,383984,18673,89283,3.556856497091408,0.18865249425799813
1433,0.3153,63,567,63,222193,383417,18736,89220,3.5516043573307643,0.18877066332089956
1434,0.3154,72,520,72,222713,382897,18808,89148,3.5467875801252364,0.18885487612409835
1435,0.3155,56,488,56,223201,382409,18864,89092,3.54226721997851,0.18895400009756078
1436,0.3156,76,632,76,223833,381777,18940,89016,3.5364129830671756,0.1890767279887339
1437,0.3157,53,495,53,224328,381282,18993,88963,3.531827781688836,0.18918436134355496
1438,0.3158,50,522,50,224850,380760,19043,88913,3.526992478417133,0.18930830599161544
1439,0.3159,53,508,53,225358,380252,19096,88860,3.5222868576086555,0.18942171592284998
1440,0.316,54,460,54,225818,379792,19150,88806,3.5180258623883804,0.18951425315515644
1441,0.3161,83,582,83,226400,379210,19233,88723,3.512634777131424,0.18960620430702685
1442,0.3162,34,410,34,226810,378800,19267,88689,3.5088369335655267,0.18971355475743815
1443,0.3163,41,330,41,227140,378470,19308,88648,3.505780132646634,0.18977645905317286
1444,0.3164,80,500,80,227640,377970,19388,88568,3.501148616102857,0.18984091328037586
1445,0.3165,78,544,78,228184,377426,19466,88490,3.4961095261032273,0.18992693962001733
1446,0.3166,66,543,66,228727,376883,19532,88424,3.4910796991366855,0.1900336766908729
1447,0.3167,54,407,54,229134,376476,19586,88370,3.487309644670051,0.19010597057950374
1448,0.3168,63,391,63,229525,376085,19649,88307,3.483687798732817,0.19015616117418044
1449,0.3169,82,499,82,230024,375586,19731,88225,3.4790655452221277,0.19021756706934506
1450,0.317,52,549,52,230573,375037,19783,88173,3.4739801400570602,0.19035210811510977
1451,0.3171,72,463,72,231036,374574,19855,88101,3.4696913557375226,0.19041659912465553
1452,0.3172,60,537,60,231573,374037,19915,88041,3.464717106969506,0.19053276719514886
1453,0.3173,66,497,66,232070,373540,19981,87975,3.4601133795249917,0.19062218996132305
1454,0.3174,58,363,58,232433,373177,20039,87917,3.4567508985142097,0.19067044897569693
1455,0.3175,48,556,48,232989,372621,20087,87869,3.4516006521175293,0.19081630437143043
1456,0.3176,58,372,58,233361,372249,20145,87811,3.448154803808959,0.19086858235882276
1457,0.3177,44,388,44,233749,371861,20189,87767,3.4445607469709882,0.19095224833996188
1458,0.3178,47,475,47,234224,371386,20236,87720,3.4401608062544,0.19106698670895175
1459,0.3179,42,464,42,234688,370922,20278,87678,3.435862758901775,0.19118621892716964
1460,0.318,96,553,96,235241,370369,20374,87582,3.430740301604357,0.1912475352166498
1461,0.3181,75,514,75,235755,369855,20449,87507,3.4259791025973545,0.1913298437561494
1462,0.3182,79,470,79,236225,369385,20528,87428,3.421625477046204,0.1913868475722013
1463,0.3183,52,407,52,236632,368978,20580,87376,3.4178554225795694,0.19146539747652042
1464,0.3184,68,459,68,237091,368519,20648,87308,3.413603690392382,0.19153757894990864
1465,0.3185,53,410,53,237501,368109,20701,87255,3.409805846826485,0.1916159380188157
1466,0.3186,87,438,87,237939,367671,20788,87168,3.405748638334136,0.1916458351196797
1467,0.3187,97,661,97,238600,367010,20885,87071,3.3996257734632627,0.19175213232881358
1468,0.3188,71,450,71,239050,366560,20956,87000,3.3954574085738636,0.1918158567774936
1469,0.3189,67,437,67,239487,366123,21023,86933,3.391409463114602,0.19188135683006075
1470,0.319,58,383,58,239870,365740,21081,86875,3.387861721442069,0.19194016990157198
1471,0.3191,69,530,69,240400,365210,21150,86806,3.3829523139056654,0.19204187462390712
1472,0.3192,89,518,89,240918,364692,21239,86717,3.378154062766312,0.19210294876708262
1473,0.3193,103,735,103,241653,363957,21342,86614,3.37134573344696,0.19223163496984938
1474,0.3194,92,697,92,242350,363260,21434,86522,3.3648893993849347,0.19236430092800513
1475,0.3195,53,328,53,242678,362932,21487,86469,3.3618511245322167,0.19240945169236384
1476,0.3196,80,613,80,243291,362319,21567,86389,3.356172885249546,0.19252832577087994
1477,0.3197,58,472,58,243763,361847,21625,86331,3.3518007336322206,0.19262659032795004
1478,0.3198,53,415,53,244178,361432,21678,86278,3.3479565749008855,0.19270956646043197
1479,0.3199,54,449,54,244627,360983,21732,86224,3.3437974730445736,0.19280556878581953
1480,0.32,75,560,75,245187,360423,21807,86149,3.3386101745155434,0.192911781302903
1481,0.3201,79,505,79,245692,359918,21886,86070,3.3339323428063286,0.19298725526247343
1482,0.3202,107,685,107,246377,359233,21993,85963,3.3275871651413538,0.1930902344136066
1483,0.3203,61,422,61,246799,358811,22054,85902,3.323678165178406,0.19316278138934548
1484,0.3204,63,456,63,247255,358355,22117,85839,3.3194542220904815,0.19324664448416684
1485,0.3205,58,482,58,247737,357873,22175,85781,3.31498944014228,0.1933511249757694
1486,0.3206,53,375,53,248112,357498,22228,85728,3.3115158027344473,0.19341825614923314
1487,0.3207,85,480,85,248592,357018,22313,85643,3.3070695468524214,0.1934731092190186
1488,0.3208,81,489,81,249081,356529,22394,85562,3.302539923672607,0.19353933918582372
1489,0.3209,81,578,81,249659,355951,22475,85481,3.297185890548001,0.19364477428007032
1490,0.321,100,766,100,250425,355185,22575,85381,3.2900904072029347,0.1937984320169963
1491,0.3211,79,574,79,250999,354611,22654,85302,3.2847734262106782,0.19390652242602516
1492,0.3212,88,594,88,251593,354017,22742,85214,3.2792711845566713,0.19400725358638166
1493,0.3213,81,654,81,252247,353363,22823,85133,3.2732131609174107,0.1941477231263227
1494,0.3214,54,440,54,252687,352923,22877,85079,3.269137426358887,0.19424340528125442
1495,0.3215,45,429,45,253116,352494,22922,85034,3.265163585164326,0.19435099010806164
1496,0.3216,63,503,63,253619,351991,22985,84971,3.2605042795212866,0.19445855703699635
1497,0.3217,64,494,64,254113,351497,23049,84907,3.2559283411760345,0.19456054481627116
1498,0.3218,69,505,69,254618,350992,23118,84838,3.2512505094668196,0.1946584677511874
1499,0.3219,65,398,65,255016,350594,23183,84773,3.2475638222979732,0.19471618197980095
1500,0.322,54,395,54,255411,350199,23237,84719,3.2439049242283895,0.19479304144689344
1501,0.3221,54,420,54,255831,349779,23291,84665,3.2400144503316164,0.1948812735358297
1502,0.3222,56,510,56,256341,349269,23347,84609,3.235290303456964,0.19500643037904664
1503,0.3223,81,615,81,256956,348654,23428,84528,3.229593538108118,0.19513276174910316
1504,0.3224,48,395,48,257351,348259,23476,84480,3.2259346400385343,0.1952216000868884
1505,0.3225,52,373,52,257724,347886,23528,84428,3.2224795286968764,0.1952932359349917
1506,0.3226,78,500,78,258224,347386,23606,84350,3.2178480121530995,0.19537402486704838
1507,0.3227,95,612,95,258836,346774,23701,84255,3.212179035903516,0.1954740864303794
1508,0.3228,50,314,50,259150,346460,23751,84205,3.2092704435140242,0.1955232024891737
1509,0.3229,106,683,106,259833,345777,23857,84099,3.202943791915225,0.19563548558188873
1510,0.323,90,559,90,260392,345218,23947,84009,3.197765756419282,0.19572161117543863
1511,0.3231,49,393,49,260785,344825,23996,83960,3.194125384415873,0.195809088470912
1512,0.3232,66,470,66,261255,344355,24062,83894,3.1897717588647225,0.19590004880338308
1513,0.3233,68,591,68,261846,343764,24130,83826,3.184297306309978,0.1960429383287729
1514,0.3234,53,356,53,262202,343408,24183,83773,3.1809996665308087,0.19610656841011187
1515,0.3235,74,511,74,262713,342897,24257,83699,3.1762662566230686,0.19620202721075677
1516,0.3236,84,576,84,263289,342321,24341,83615,3.1709307495646373,0.1963088351301604
1517,0.3237,60,426,60,263715,341895,24401,83555,3.1669846974693394,0.19639205547067812
1518,0.3238,54,359,54,264074,341536,24455,83501,3.1636592685909073,0.1964558379623421
1519,0.3239,61,361,61,264435,341175,24516,83440,3.1603153136463003,0.196507424372667
1520,0.324,87,546,87,264981,340629,24603,83353,3.155257697580496,0.19659561019099867
1521,0.3241,79,545,79,265526,340084,24682,83274,3.1502093445477786,0.196698775032006
1522,0.3242,58,365,58,265891,339719,24740,83216,3.1468283374708212,0.1967583671249719
1523,0.3243,35,367,35,266258,339352,24775,83181,3.143428804327689,0.1968627302482883
1524,0.3244,54,482,54,266740,338870,24829,83127,3.138964022379488,0.19698481268824186
1525,0.3245,74,444,74,267184,338426,24903,83053,3.134851235688614,0.19705133589099338
1526,0.3246,89,588,89,267772,337838,24992,82964,3.129404572233132,0.197156857619498
1527,0.3247,88,644,88,268416,337194,25080,82876,3.1234391789247473,0.19729092770252576
1528,0.3248,64,543,64,268959,336651,25144,82812,3.118409351958205,0.1974238490641606
1529,0.3249,70,363,70,269322,336288,25214,82742,3.115046870947423,0.19746080232918883
1530,0.325,96,709,96,270031,335579,25310,82646,3.108479380488347,0.19761133361229002
1531,0.3251,70,421,70,270452,335158,25380,82576,3.1045796435584867,0.19767603307367845
1532,0.3252,62,500,62,270952,334658,25442,82514,3.09994812701471,0.1977937157815002
1533,0.3253,94,620,94,271572,334038,25536,82420,3.0942050465004263,0.19790711188163032
1534,0.3254,60,389,60,271961,333649,25596,82360,3.0906017266293677,0.19797648608563756
1535,0.3255,130,789,130,272750,332860,25726,82230,3.0832931935232875,0.19810161651689995
1536,0.3256,64,467,64,273217,332393,25790,82166,3.0789673570713996,0.19820097983640447
1537,0.3257,67,375,67,273592,332018,25857,82099,3.0754937196635668,0.1982507359031385
1538,0.3258,63,387,63,273979,331631,25920,82036,3.071908925858683,0.19831410288952225
1539,0.3259,68,427,68,274406,331204,25988,81968,3.0679536107302976,0.19838711238902926
1540,0.326,97,630,97,275036,330574,26085,81871,3.0621178998851386,0.19850161839760452
1541,0.3261,78,433,78,275469,330141,26163,81793,3.0581070065582274,0.19855850694528734
1542,0.3262,62,435,62,275904,329706,26225,81731,3.0540775871651413,0.19864766659294134
1543,0.3263,56,422,56,276326,329284,26281,81675,3.0501685872021933,0.19874245362676082
1544,0.3264,63,501,63,276827,328783,26344,81612,3.0455278076253287,0.19886207190633415
1545,0.3265,64,534,64,277361,328249,26408,81548,3.040581347956575,0.19899608830713744
1546,0.3266,76,435,76,277796,327814,26484,81472,3.036551928563489,0.19905884882453834
1547,0.3267,59,509,59,278305,327305,26543,81413,3.031837044721924,0.1991911293361193
1548,0.3268,107,729,107,279034,326576,26650,81306,3.025084293601097,0.19933706317023062
1549,0.3269,104,600,104,279634,325976,26754,81202,3.0195264737485643,0.19942629513382354
1550,0.327,55,334,55,279968,325642,26809,81147,3.016432620697321,0.19948179523045118
1551,0.3271,65,419,65,280387,325223,26874,81082,3.012551409833636,0.19955944425985406
1552,0.3272,59,441,59,280828,324782,26933,81023,3.0084664122420244,0.19965993519054717
1553,0.3273,70,424,70,281252,324358,27003,80953,3.0045388862129014,0.1997305772604247
1554,0.3274,77,595,77,281847,323763,27080,80876,2.999027381525807,0.19987198465792966
1555,0.3275,85,558,85,282405,323205,27165,80791,2.9938586090629515,0.19997970276933436
1556,0.3276,71,550,71,282955,322655,27236,80720,2.988763940864797,0.20011155872327238
1557,0.3277,100,572,100,283527,322083,27336,80620,2.9834654859387157,0.2001971676396749
1558,0.3278,73,453,73,283980,321630,27409,80547,2.9792693319500536,0.20027748976197046
1559,0.3279,52,409,52,284389,321221,27461,80495,2.975480751417244,0.20037787889952105
1560,0.328,88,656,88,285045,320565,27549,80407,2.9694042017118085,0.20053021158584639
1561,0.3281,95,537,95,285582,320028,27644,80312,2.964429952943792,0.2006094819403507
1562,0.3282,81,616,81,286198,319412,27725,80231,2.9587239245618586,0.20075667533273447
1563,0.3283,103,610,103,286808,318802,27828,80128,2.9530734743784506,0.20085729325946908
1564,0.3284,67,459,67,287267,318343,27895,80061,2.9488217421912633,0.2009543076876738
1565,0.3285,90,548,90,287815,317795,27985,79971,2.9437456000592834,0.20105036629576184
1566,0.3286,81,496,81,288311,317299,28066,79890,2.9391511356478563,0.2011385008144737
1567,0.3287,62,435,62,288746,316864,28128,79828,2.9351217162547703,0.20123420689098848
1568,0.3288,68,506,68,289252,316358,28196,79760,2.930434621512468,0.20135414194760148
1569,0.3289,63,428,63,289680,315930,28259,79697,2.926470043350995,0.20144479522378403
1570,0.329,76,552,76,290232,315378,28335,79621,2.921356849086665,0.20157266220927142
1571,0.3291,73,572,73,290804,314806,28408,79548,2.9160583941605838,0.2017172388260294
1572,0.3292,73,443,73,291247,314363,28481,79475,2.9119548705027976,0.20179616999883201
1573,0.3293,113,641,113,291888,313722,28594,79362,2.9060172662936754,0.2018957780016485
1574,0.3294,75,529,75,292417,313193,28669,79287,2.901117121790359,0.202015389319201
1575,0.3295,88,700,88,293117,312493,28757,79199,2.894632998629071,0.2021971344832164
1576,0.3296,84,638,84,293755,311855,28841,79115,2.8887231835192115,0.2023556794638975
1577,0.3297,57,404,57,294159,311451,28898,79058,2.8849809181518395,0.2024485991359994
1578,0.3298,43,416,43,294575,311035,28941,79015,2.881127496387417,0.20257659274451995
1579,0.3299,86,587,86,295162,310448,29027,78929,2.8756900959650227,0.202705860900875
1580,0.33,95,790,95,295952,309658,29122,78834,2.868372299825855,0.20292309751552157
1581,0.3301,68,416,68,296368,309242,29190,78766,2.8645188780614323,0.20300096905218448
1582,0.3302,79,582,79,296950,308660,29269,78687,2.859127792804476,0.20314343469808724
1583,0.3303,95,584,95,297534,308076,29364,78592,2.8537181814813444,0.20325447153630505
1584,0.3304,60,388,60,297922,307688,29424,78532,2.850124124643373,0.20333488685205323
1585,0.3305,126,667,126,298589,307021,29550,78406,2.8439456815739748,0.20342632975894268
1586,0.3306,68,436,68,299025,306585,29618,78338,2.839906999147801,0.20351602788090087
1587,0.3307,75,522,75,299547,306063,29693,78263,2.8350716958760978,0.203637016491208
1588,0.3308,89,649,89,300196,305414,29782,78174,2.829059987402275,0.20379678196398218
1589,0.3309,53,404,53,300600,305010,29835,78121,2.825317722034903,0.20390153759419102
1590,0.331,72,515,72,301115,304495,29907,78049,2.8205472599948127,0.2040262035216864
1591,0.3311,87,605,87,301720,303890,29994,77962,2.8149431249768426,0.2041681070152834
1592,0.3312,76,501,76,302221,303389,30070,77886,2.8103023453999776,0.20427775227853912
1593,0.3313,52,296,52,302517,303093,30122,77834,2.807560487606062,0.2043278633438953
1594,0.3314,74,509,74,303026,302584,30196,77760,2.8028456037644967,0.20444650106219633
1595,0.3315,64,533,64,303559,302051,30260,77696,2.7979084071288303,0.2045993780069362
1596,0.3316,85,494,85,304053,301557,30345,77611,2.7933324687835785,0.20468763186766817
1597,0.3317,79,557,79,304610,301000,30424,77532,2.788172959353811,0.20482284192617797
1598,0.3318,64,525,64,305135,300475,30488,77468,2.7833098669828447,0.20497270752467964
1599,0.3319,76,578,76,305713,299897,30564,77392,2.7779558338582384,0.2051265740586129
1600,0.332,105,637,105,306350,299260,30669,77287,2.7720552817814665,0.20525193402151656
1601,0.3321,65,419,65,306769,298841,30734,77222,2.768174070917781,0.20534325365696704
1602,0.3322,62,494,62,307263,298347,30796,77160,2.7635981325725294,0.20548218808171353
1603,0.3323,79,494,79,307757,297853,30875,77081,2.7590221942272777,0.20558551638421696
1604,0.3324,60,420,60,308177,297433,30935,77021,2.755131720330505,0.20568881624979304
1605,0.3325,83,549,83,308726,296884,31018,76938,2.750046315165438,0.2058145320500131
1606,0.3326,99,561,99,309287,296323,31117,76839,2.74484975360332,0.20591324947341905
1607,0.3327,60,385,60,309672,295938,31177,76779,2.7412834858646113,0.20599811653345568
1608,0.3328,88,504,88,310176,295434,31265,76691,2.736614917188484,0.2060893516963386
1609,0.3329,58,427,58,310603,295007,31323,76633,2.7326596020600986,0.20620223872564847
1610,0.333,68,517,68,311120,294490,31391,76565,2.727870613953833,0.20634407298109445
1611,0.3331,72,458,72,311578,294032,31463,76493,2.7236281447997333,0.20644490925038797
1612,0.3332,82,505,82,312083,293527,31545,76411,2.7189503130905184,0.20655082743594871
1613,0.3333,70,466,70,312549,293061,31615,76341,2.714633739671718,0.2066610359445807
1614,0.3334,99,553,99,313102,292508,31714,76242,2.709511282374301,0.20675796610169492
1615,0.3335,100,680,100,313782,291828,31814,76142,2.7032124198747636,0.2069244775389298
1616,0.3336,92,519,92,314301,291309,31906,76050,2.6984049057023234,0.20701820290233805
1617,0.3337,74,454,74,314755,290855,31980,75976,2.6941994886805736,0.20711444779748714
1618,0.3338,79,599,79,315354,290256,32059,75897,2.6886509318611287,0.20728220170256695
1619,0.3339,86,434,86,315788,289822,32145,75811,2.6846307755011303,0.2073417880771156
1620,0.334,50,339,50,316127,289483,32195,75761,2.681490607284449,0.20742572088795436
1621,0.3341,78,646,78,316773,288837,32273,75683,2.6755066879098894,0.20762372434982992
1622,0.3342,93,579,93,317352,288258,32366,75590,2.6701433917521955,0.2077515885754491
1623,0.3343,116,670,116,318022,287588,32482,75474,2.663937159583534,0.20788184938109744
1624,0.3344,67,497,67,318519,287091,32549,75407,2.6593334321390194,0.20802045804390645
1625,0.3345,59,379,59,318898,286712,32608,75348,2.6558227425988368,0.2081091531790311
1626,0.3346,69,418,69,319316,286294,32677,75279,2.651950794768239,0.2081986210253531
1627,0.3347,81,528,81,319844,285766,32758,75198,2.64705991329801,0.2083254839817821
1628,0.3348,63,390,63,320234,285376,32821,75135,2.6434473303938644,0.20841250336328157
1629,0.3349,57,407,57,320641,284969,32878,75078,2.63967727592723,0.20852277619310813
1630,0.335,95,556,95,321197,284413,32973,74983,2.6345270295305494,0.20863615621765405
1631,0.3351,79,513,79,321710,283900,33052,74904,2.629775093556634,0.20876021449036242
1632,0.3352,74,459,74,322169,283441,33126,74830,2.6255233613694466,0.20886423963982573
1633,0.3353,96,489,96,322658,282952,33222,74734,2.620993738189633,0.20893744792918928
1634,0.3354,62,400,62,323058,282552,33284,74672,2.617288524954611,0.20903410745078718
1635,0.3355,58,472,58,323530,282080,33342,74614,2.6129163733372858,0.20918210006335963
1636,0.3356,78,615,78,324145,281465,33420,74536,2.6072196079884398,0.2093701983983191
1637,0.3357,58,363,58,324508,281102,33478,74478,2.6038571269776574,0.20945497497047078
1638,0.3358,65,514,65,325022,280588,33543,74413,2.5990959279706547,0.20961349404649565
1639,0.3359,83,546,83,325568,280042,33626,74330,2.5940383119048502,0.2097513347555676
1640,0.336,87,479,87,326047,279563,33713,74243,2.5896013190559115,0.2098409863032283
1641,0.3361,85,588,85,326635,278975,33798,74158,2.58415465560043,0.21000019822559773
1642,0.3362,81,515,81,327150,278460,33879,74077,2.5793841935603394,0.2101254620082431
1643,0.3363,84,441,84,327591,278019,33963,73993,2.575299195968728,0.2102002204470302
1644,0.3364,48,364,48,327955,277655,34011,73945,2.571927451924858,0.21031001137656427
1645,0.3365,83,447,83,328402,277208,34094,73862,2.5677868761347216,0.21039109009599224
1646,0.3366,89,578,89,328980,276630,34183,73773,2.5624328430101153,0.2105375810138612
1647,0.3367,75,528,75,329508,276102,34258,73698,2.5575419615398864,0.21068610634648371
1648,0.3368,64,492,64,330000,275610,34322,73634,2.55298454926081,0.21083826780130796
1649,0.3369,72,405,72,330405,275205,34394,73562,2.5492330208603504,0.21092018453580758
1650,0.337,87,590,87,330995,274615,34481,73475,2.5437678313386933,0.2110804676951363
1651,0.3371,72,480,72,331475,274135,34553,73403,2.5393215754566674,0.21120855848856815
1652,0.3372,69,447,69,331922,273688,34622,73334,2.535180999666531,0.21132377774319783
1653,0.3373,51,498,51,332420,273190,34673,73283,2.530568009188929,0.2115114309051499
1654,0.3374,85,569,85,332989,272621,34758,73198,2.5252973433621104,0.21166564011809647
1655,0.3375,103,590,103,333579,272031,34861,73095,2.5198321538404533,0.21179221501712417
1656,0.3376,102,518,102,334097,271513,34963,72993,2.5150339027011004,0.21187729676696487
1657,0.3377,98,514,98,334611,270999,35061,72895,2.5102727036940977,0.21196938591542744
1658,0.3378,92,603,92,335214,270396,35153,72803,2.5046870947423026,0.21213057147602413
1659,0.3379,97,516,97,335730,269880,35250,72706,2.4999073696691245,0.21222700285475762
1660,0.338,63,378,63,336108,269502,35313,72643,2.496405943162029,0.21231641555480862
1661,0.3381,81,487,81,336595,269015,35394,72562,2.4918948460483903,0.2124323359008364
1662,0.3382,81,458,81,337053,268557,35475,72481,2.48765237689429,0.2125305684410535
1663,0.3383,101,553,101,337606,268004,35576,72380,2.482529919596873,0.2126421923474664
1664,0.3384,84,479,84,338085,267525,35660,72296,2.478092926747934,0.2127472993134621
1665,0.3385,75,436,75,338521,267089,35735,72221,2.474054244321761,0.21284665939701158
1666,0.3386,88,499,88,339020,266590,35823,72133,2.469431990811071,0.21295571897981536
1667,0.3387,85,459,85,339479,266131,35908,72048,2.465180258623884,0.2130469366814616
1668,0.3388,71,426,71,339905,265705,35979,71977,2.461234206528586,0.21315024194360374
1669,0.3389,89,504,89,340409,265201,36068,71888,2.4565656378524583,0.21326118621491655
1670,0.339,79,463,79,340872,264738,36147,71809,2.4522768535329207,0.21336990078651719
1671,0.3391,66,438,66,341310,264300,36213,71743,2.448219645040572,0.21349351124707255
1672,0.3392,64,428,64,341738,263872,36277,71679,2.4442550668790988,0.21361581398952767
1673,0.3393,61,377,61,342115,263495,36338,71618,2.440762903405091,0.21371298636579303
1674,0.3394,89,452,89,342567,263043,36427,71529,2.4365760124495166,0.21379254689573546
1675,0.3395,86,466,86,343033,262577,36513,71443,2.4322594390307164,0.21388838991677145
1676,0.3396,59,359,59,343392,262218,36572,71384,2.4289340101522843,0.21397953249680757
1677,0.3397,107,591,107,343983,261627,36679,71277,2.42345955759754,0.21410676951914065
1678,0.3398,78,390,78,344373,261237,36757,71199,2.4198469746933937,0.214173555210627
1679,0.3399,106,406,106,344779,260831,36863,71093,2.416086183259847,0.21418457237198876
1680,0.34,52,320,52,345099,260511,36915,71041,2.4131220126718294,0.21426804845092173
1681,0.3401,95,583,95,345682,259928,37010,70946,2.407721664381785,0.21441999069132056
1682,0.3402,116,639,116,346321,259289,37126,70830,2.401802586238838,0.21455899236335987
1683,0.3403,98,529,98,346850,258760,37224,70732,2.396902441735522,0.2146698554137885
1684,0.3404,77,515,77,347365,258245,37301,70655,2.3921319796954315,0.2148221343873518
1685,0.3405,96,541,96,347906,257704,37397,70559,2.3871206787950645,0.21494655200251017
1686,0.3406,86,426,86,348332,257278,37483,70473,2.3831746266997667,0.21501993891704374
1687,0.3407,83,499,83,348831,256779,37566,70390,2.378552373189077,0.21514874575525186
1688,0.3408,78,529,78,349360,256250,37644,70312,2.373652228685761,0.21530980334515346
1689,0.3409,109,532,109,349892,255718,37753,70203,2.368724295083182,0.21539882364131185
1690,0.341,58,360,58,350252,255358,37811,70145,2.3653896031716624,0.21549724580111396
1691,0.3411,71,463,71,350715,254895,37882,70074,2.3611008188521247,0.2156328757512255
1692,0.3412,106,606,106,351321,254289,37988,69968,2.355487420801067,0.21577945888600708
1693,0.3413,57,345,57,351666,253944,38045,69911,2.352291674385861,0.21587130042766053
1694,0.3414,65,409,65,352075,253535,38110,69846,2.348503093853051,0.21598671536051903
1695,0.3415,82,537,82,352612,252998,38192,69764,2.3435288450850345,0.21614688222281433
1696,0.3416,89,565,89,353177,252433,38281,69675,2.3382952313905667,0.21630943658648652
1697,0.3417,65,397,65,353574,252036,38346,69610,2.3346178072548076,0.21641804965707642
1698,0.3418,77,404,77,353978,251632,38423,69533,2.3308755418874356,0.21650242087400556
1699,0.3419,56,355,56,354333,251277,38479,69477,2.3275871651413538,0.21660524888232102
1700,0.342,69,432,69,354765,250845,38548,69408,2.3235855348475303,0.21672864891195398
1701,0.3421,81,441,81,355206,250404,38629,69327,2.319500537255919,0.2168291470016983
1702,0.3422,70,474,70,355680,249930,38699,69257,2.315109859572418,0.21697938825829372
1703,0.3423,47,351,47,356031,249579,38746,69210,2.3118585349586867,0.21710284859264278
1704,0.3424,82,436,82,356467,249143,38828,69128,2.3078198525325133,0.21719855092044202
1705,0.3425,67,384,67,356851,248759,38895,69061,2.3042628478268923,0.2172959536844755
1706,0.3426,118,544,118,357395,248215,39013,68943,2.2992237578272627,0.21737745855378077
1707,0.3427,81,438,81,357833,247777,39094,68862,2.295166549334914,0.217477948073358
1708,0.3428,97,630,97,358463,247147,39191,68765,2.289330838489755,0.21767137683911975
1709,0.3429,60,329,60,358792,246818,39251,68705,2.28628330060395,0.21774957768530345
1710,0.343,74,428,74,359220,246390,39325,68631,2.2823187224424766,0.21786166636509946
1711,0.3431,73,396,73,359616,245994,39398,68558,2.278650561339805,0.21795442406978816
1712,0.3432,116,585,116,360201,245409,39514,68442,2.273231686983586,0.218071632717436
1713,0.3433,94,475,94,360676,244934,39608,68348,2.2688317462669976,0.21816765725448636
1714,0.3434,58,298,58,360974,244636,39666,68290,2.2660713624069064,0.21823050817126094
1715,0.3435,74,495,74,361469,244141,39740,68216,2.261486161028567,0.21839113578373465
1716,0.3436,76,483,76,361952,243658,39816,68140,2.2570121160472785,0.21853892584301374
1717,0.3437,75,426,75,362378,243232,39891,68065,2.2530660639519806,0.21864971393877872
1718,0.3438,138,652,138,363030,242580,40029,67927,2.2470265663788953,0.21876157381315076
1719,0.3439,63,386,63,363416,242194,40092,67864,2.2434510356070994,0.2188751781924672
1720,0.344,78,433,78,363849,241761,40170,67786,2.239440142280188,0.21898451608317962
1721,0.3441,103,542,103,364391,241219,40273,67683,2.234419578346734,0.2191083256178335
1722,0.3442,99,486,99,364877,240733,40372,67584,2.2299177442661824,0.21920296318399568
1723,0.3443,81,473,81,365350,240260,40453,67503,2.2255363296157693,0.2193343579312653
1724,0.3444,55,341,55,365691,239919,40508,67448,2.222377635332913,0.21943800082637369
1725,0.3445,89,473,89,366164,239446,40597,67359,2.2179962206825,0.2195498769576767
1726,0.3446,104,531,104,366695,238915,40701,67255,2.213077550113009,0.21966554528529902
1727,0.3447,67,319,67,367014,238596,40768,67188,2.2101226425580793,0.21972372655207598
1728,0.3448,51,299,51,367313,238297,40819,67137,2.2073529956649005,0.2198085347407296
1729,0.3449,111,654,111,367967,237643,40930,67026,2.2012949720256403,0.2199961269443232
1730,0.345,89,515,89,368482,237128,41019,66937,2.1965245099855495,0.22014043050005755
1731,0.3451,83,499,83,368981,236629,41102,66854,2.1919022564748603,0.22028911009842397
1732,0.3452,57,310,57,369291,236319,41159,66797,2.1890307162177183,0.2203677799918183
1733,0.3453,96,624,96,369915,235695,41255,66701,2.1832505835710845,0.22057500760592072
1734,0.3454,73,460,73,370375,235235,41328,66628,2.1789895883508095,0.22072264570351452
1735,0.3455,97,509,97,370884,234726,41425,66531,2.1742747045092443,0.22084466087095073
1736,0.3456,78,462,78,371346,234264,41503,66453,2.1699951832227944,0.22098185337044463
1737,0.3457,60,405,60,371751,233859,41563,66393,2.166243654822335,0.22112425562527477
1738,0.3458,79,417,79,372168,233442,41642,66314,2.162380970024825,0.2212265976327413
1739,0.3459,64,442,64,372610,233000,41706,66250,2.158286709400126,0.22138680033416874
1740,0.346,85,562,85,373172,232438,41791,66165,2.1530808848049205,0.22158183273443335
1741,0.3461,90,444,90,373616,231994,41881,66075,2.1489680981140467,0.2216768600558931
1742,0.3462,72,423,72,374039,231571,41953,66003,2.145049835118011,0.22180365220079712
1743,0.3463,53,357,53,374396,231214,42006,65950,2.141742932305754,0.22193132411732241
1744,0.3464,98,527,98,374923,230687,42104,65852,2.136861313868613,0.22206859805961443
1745,0.3465,101,546,101,375469,230141,42205,65751,2.1318036978028085,0.22221283441255593
1746,0.3466,96,475,96,375944,229666,42301,65655,2.12740375708622,0.2223174105464901
1747,0.3467,72,421,72,376365,229245,42373,65583,2.12350402015636,0.2224449509544548
1748,0.3468,89,468,89,376833,228777,42462,65494,2.1191689206713846,0.22256355536223413
1749,0.3469,55,337,55,377170,228440,42517,65439,2.116047278520879,0.22267327709703655
1750,0.347,71,413,71,377583,228027,42588,65368,2.112221645855719,0.2227986162000034
1751,0.3471,64,474,64,378057,227553,42652,65304,2.1078309681722183,0.22298937706798883
1752,0.3472,68,389,68,378446,227164,42720,65236,2.1042276483011597,0.22310533515731873
1753,0.3473,94,452,94,378898,226712,42814,65142,2.1000407573455853,0.2232006414165987
1754,0.3474,86,454,86,379352,226258,42900,65056,2.0958353403238354,0.22331916763355006
1755,0.3475,87,469,87,379821,225789,42987,64969,2.0914909778057726,0.22344699028057696
1756,0.3476,88,423,88,380244,225366,43075,64881,2.0875727148097374,0.22353719418288562
1757,0.3477,72,437,72,380681,224929,43147,64809,2.083524769350476,0.22368139491540634
1758,0.3478,62,351,62,381032,224578,43209,64747,2.080273444736745,0.22378639937786227
1759,0.3479,92,613,92,381645,223965,43301,64655,2.0745952054540737,0.22401427482502945
1760,0.348,69,385,69,382030,223580,43370,64586,2.0710289377153654,0.22412775969406523
1761,0.3481,85,421,85,382451,223159,43455,64501,2.067129200785505,0.22422651741639435
1762,0.3482,74,429,74,382880,222730,43529,64427,2.0631553595909446,0.2243615861706314
1763,0.3483,68,314,68,383194,222416,43597,64359,2.0602467672014524,0.22442332839333973
1764,0.3484,87,448,87,383642,221968,43684,64272,2.056096928378228,0.22453884851872555
1765,0.3485,88,445,88,384087,221523,43772,64184,2.0519748786542666,0.2246497285680785
1766,0.3486,96,473,96,384560,221050,43868,64088,2.0475934640038536,0.22476134363010192
1767,0.3487,91,461,91,385021,220589,43959,63997,2.043323205750491,0.22487754141103217
1768,0.3488,76,403,76,385424,220186,44035,63921,2.0395902034162066,0.22498917661303663
1769,0.3489,116,576,116,386000,219610,44151,63805,2.0342546963577752,0.22512922745796798
1770,0.349,61,276,61,386276,219334,44212,63744,2.0316980992256104,0.22518175202594337
1771,0.3491,77,419,77,386695,218915,44289,63667,2.0278168883619254,0.22530451338018698
1772,0.3492,107,448,107,387143,218467,44396,63560,2.023667049538701,0.22536849308754126
1773,0.3493,55,359,55,387502,218108,44451,63505,2.020341620660269,0.22550450440853229
1774,0.3494,80,393,80,387895,217715,44531,63425,2.0167012486568603,0.22559934552180408
1775,0.3495,62,352,62,388247,217363,44593,63363,2.013440661010041,0.22571119169581727
1776,0.3496,52,310,52,388557,217053,44645,63311,2.0105691207528995,0.2258171519881297
1777,0.3497,63,369,63,388926,216684,44708,63248,2.007151061543592,0.22594058557078148
1778,0.3498,71,319,71,389245,216365,44779,63177,2.004196153988662,0.22600181725822954
1779,0.3499,71,417,71,389662,215948,44850,63106,2.000333469191152,0.22614261039082043
1780,0.35,67,329,67,389991,215619,44917,63039,1.9972859313053466,0.22622354283745666
1781,0.3501,80,470,80,390461,215149,44997,62959,1.992932305754196,0.22638327556201188
1782,0.3502,66,413,66,390874,214736,45063,62893,1.9891066730890363,0.22653613275270235
1783,0.3503,99,465,99,391339,214271,45162,62794,1.9847993627033236,0.22663995813256818
1784,0.3504,90,433,90,391772,213838,45252,62704,1.9807884693764126,0.22674313485835787
1785,0.3505,89,474,89,392246,213364,45341,62615,1.9763977916929119,0.22688320488153085
1786,0.3506,77,432,77,392678,212932,45418,62538,1.9723961613990886,0.2270229063055868
1787,0.3507,90,401,90,393079,212531,45508,62448,1.9686816851309792,0.22710097862018555
1788,0.3508,90,439,90,393518,212092,45598,62358,1.964615213605543,0.22721078520677718
1789,0.3509,59,502,59,394020,211590,45657,62299,1.9599651709955908,0.22746075965080745
1790,0.351,65,370,65,394390,211220,45722,62234,1.9565378487531957,0.22758489544859464
1791,0.3511,58,386,58,394776,210834,45780,62176,1.9529623179813997,0.22774257353210506
1792,0.3512,101,425,101,395201,210409,45881,62075,1.9490255289191893,0.22781154122810882
1793,0.3513,100,447,100,395648,209962,45981,61975,1.9448849531290526,0.2279020508426584
1794,0.3514,52,357,52,396005,209605,46033,61923,1.9415780503167956,0.2280538287027489
1795,0.3515,89,399,89,396404,209206,46122,61834,1.9378821001148616,0.22813606847697757
1796,0.3516,100,488,100,396892,208718,46222,61734,1.933361739968135,0.22826231641844025
1797,0.3517,72,363,72,397255,208355,46294,61662,1.929999258957353,0.22836339934152294
1798,0.3518,96,438,96,397693,207917,46390,61566,1.9259420504650042,0.22845968020246174
1799,0.3519,56,368,56,398061,207549,46446,61510,1.9225332542887843,0.22861156846639585
1800,0.352,82,421,82,398482,207128,46528,61428,1.918633517358924,0.22873441665797822
1801,0.3521,81,386,81,398868,206742,46609,61347,1.915057986587128,0.22883072412519723
1802,0.3522,87,474,87,399342,206268,46696,61260,1.9106673089036275,0.2289853772315421
1803,0.3523,75,375,75,399717,205893,46771,61185,1.9071936714957947,0.22909037809179342
1804,0.3524,96,441,96,400158,205452,46867,61089,1.9031086739041831,0.22919175661530497
1805,0.3525,49,295,49,400453,205157,46916,61040,1.9003760791433546,0.22930386142593642
1806,0.3526,104,499,104,400952,204658,47020,60936,1.8957538256326651,0.22943289381537232
1807,0.3527,90,397,90,401349,204261,47110,60846,1.8920764014969063,0.22951487512589255
1808,0.3528,89,398,89,401747,203863,47199,60757,1.8883897143280597,0.22960093719295593
1809,0.3529,75,485,75,402232,203378,47274,60682,1.8838971432805958,0.22980383246231917
1810,0.353,59,383,59,402615,202995,47333,60623,1.8803494016080626,0.22996532861944177
1811,0.3531,47,283,47,402898,202712,47380,60576,1.8777279632442847,0.2300750508948376
1812,0.3532,72,361,72,403259,202351,47452,60504,1.8743840082996777,0.23018013733807613
1813,0.3533,69,374,69,403633,201977,47521,60435,1.8709196339249323,0.23030577869914487
1814,0.3534,87,356,87,403989,201621,47608,60348,1.867621994145763,0.23036313456935745
1815,0.3535,122,624,122,404613,200997,47730,60226,1.8618418614991292,0.2305539711281166
1816,0.3536,106,543,106,405156,200454,47836,60120,1.8568120345325874,0.2307214073545327
1817,0.3537,101,515,101,405671,199939,47937,60019,1.852041572492497,0.23087960362827842
1818,0.3538,68,426,68,406097,199513,48005,59951,1.848095520397199,0.23105710233404247
1819,0.3539,50,287,50,406384,199226,48055,59901,1.8454370299010707,0.23116464127628536
1820,0.354,91,442,91,406826,198784,48146,59810,1.8413427692763717,0.23128920237901884
1821,0.3541,77,391,77,407217,198393,48223,59733,1.837720923339138,0.23141024150996026
1822,0.3542,46,253,46,407470,198140,48269,59687,1.835377375967987,0.23150019198920208
1823,0.3543,80,422,80,407892,197718,48349,59607,1.8314683760050392,0.23164092101428155
1824,0.3544,97,401,97,408293,197317,48446,59510,1.8277538997369298,0.231712397839791
1825,0.3545,103,480,103,408773,196837,48549,59407,1.8233076438549038,0.2318376235150872
1826,0.3546,86,441,86,409214,196396,48635,59321,1.8192226462632926,0.23197910189780108
1827,0.3547,56,317,56,409531,196079,48691,59265,1.8162862647745377,0.23209865906385113
1828,0.3548,75,378,75,409909,195701,48766,59190,1.8127848382674423,0.23221690840398446
1829,0.3549,90,467,90,410376,195234,48856,59100,1.8084590018155544,0.23237160584113803
1830,0.355,60,315,60,410691,194919,48916,59040,1.805541146392975,0.23247847093428467
1831,0.3551,74,340,74,411031,194579,48990,58966,1.8023917151432065,0.23256621112623005
1832,0.3552,47,270,47,411301,194309,49037,58919,1.7998906962095669,0.23267174246133918
1833,0.3553,83,304,83,411605,194005,49120,58836,1.7970747341509503,0.2326996017259859
1834,0.3554,87,441,87,412046,193564,49207,58749,1.792989736559339,0.2328417481461518
1835,0.3555,69,363,69,412409,193201,49276,58680,1.7896272555485568,0.2329671551248407
1836,0.3556,92,387,92,412796,192814,49368,58588,1.7860424617436734,0.23304508317356265
1837,0.3557,77,411,77,413207,192403,49445,58511,1.7822353551446886,0.23319145205130046
1838,0.3558,76,381,76,413588,192022,49521,58435,1.7787061395383303,0.23331350291666833
1839,0.3559,56,356,56,413944,191666,49577,58379,1.775408499759161,0.23347397468455677
1840,0.356,85,488,85,414432,191178,49662,58294,1.7708881396124347,0.23366951000513084
1841,0.3561,111,383,111,414815,190795,49773,58183,1.7673403979399014,0.23368731373856325
1842,0.3562,80,377,80,415192,190418,49853,58103,1.7638482344658934,0.23379513200091742
1843,0.3563,62,414,62,415606,190004,49915,58041,1.760013338767646,0.2339938317643976
1844,0.3564,88,439,88,416045,189565,50003,57953,1.7559468672422098,0.2341365072439176
1845,0.3565,80,461,80,416506,189104,50083,57873,1.7516766089888474,0.23432546350469882
1846,0.3566,89,437,89,416943,188667,50172,57784,1.7476286635295861,0.23446445743778682
1847,0.3567,79,318,79,417261,188349,50251,57705,1.7446830190077438,0.23452169036065254
1848,0.3568,94,450,94,417711,187899,50345,57611,1.7405146541183445,0.23465846605026272
1849,0.3569,70,382,70,418093,187517,50415,57541,1.7369761754788988,0.23480563784899902
1850,0.357,78,318,78,418411,187199,50493,57463,1.7340305309570565,0.2348668775698719
1851,0.3571,66,355,66,418766,186844,50559,57397,1.7307421542109749,0.23500149442558785
1852,0.3572,123,472,123,419238,186372,50682,57274,1.7263700025936493,0.23507055317961303
1853,0.3573,64,434,64,419672,185938,50746,57210,1.7223498462336508,0.235288795301627
1854,0.3574,123,546,123,420218,185392,50869,57087,1.7172922301678462,0.2354306970912945
1855,0.3575,77,374,77,420592,185018,50946,57010,1.7138278557931008,0.23555125853207068
1856,0.3576,87,403,87,420995,184615,51033,56923,1.7100948534588165,0.23566892166035985
1857,0.3577,93,474,93,421469,184141,51126,56830,1.705704175775316,0.23583750741790505
1858,0.3578,64,347,64,421816,183794,51190,56766,1.7024899032939345,0.2359743930828068
1859,0.3579,76,332,76,422148,183462,51266,56690,1.6994145763088666,0.23605882940804157
1860,0.358,77,390,77,422538,183072,51343,56613,1.6958019934047204,0.23619750923086552
1861,0.3581,96,454,96,422992,182618,51439,56517,1.6915965763829708,0.23633930624960797
1862,0.3582,77,335,77,423327,182283,51516,56440,1.6884934602986401,0.23642464278682826
1863,0.3583,62,282,62,423609,182001,51578,56378,1.6858812849679499,0.23650573246804457
1864,0.3584,101,484,101,424093,181517,51679,56277,1.6813979769535736,0.2366628258072113
1865,0.3585,82,397,82,424490,181120,51761,56195,1.6777205528178147,0.23679497714008807
1866,0.3586,63,361,63,424851,180759,51824,56132,1.6743765978732077,0.23695286017619918
1867,0.3587,96,362,96,425213,180397,51920,56036,1.671023379895513,0.2370058325191492
1868,0.3588,87,319,87,425532,180078,52007,55949,1.6680684723405832,0.23704491435301894
1869,0.3589,68,255,68,425787,179823,52075,55881,1.6657063989032568,0.23708125445473985
1870,0.359,73,370,73,426157,179453,52148,55808,1.662279076660862,0.2372173883474099
1871,0.3591,86,373,86,426530,179080,52234,55722,1.658823965319204,0.23731484399621808
1872,0.3592,75,336,75,426866,178744,52309,55647,1.655711586201786,0.23741099274289543
1873,0.3593,86,354,86,427220,178390,52395,55561,1.6524324724887918,0.23748990173155918
1874,0.3594,79,402,79,427622,177988,52474,55482,1.648708733187595,0.23764081038249027
1875,0.3595,97,457,97,428079,177531,52571,55385,1.6444755270665827,0.23778958937986228
1876,0.3596,73,323,73,428402,177208,52644,55312,1.6414835673793027,0.23788061242043695
1877,0.3597,86,343,86,428745,176865,52730,55226,1.6383063470302717,0.23794976970240123
1878,0.3598,75,398,75,429143,176467,52805,55151,1.634619659861425,0.23811189113108652
1879,0.3599,68,321,68,429464,176146,52873,55083,1.6316462262403202,0.23821838956186292
1880,0.36,100,426,100,429890,175720,52973,54983,1.627700174145022,0.23832806682184454
1881,0.3601,43,272,43,430162,175448,53016,54940,1.6251806291452073,0.23846728128201122
1882,0.3602,79,386,79,430548,175062,53095,54861,1.6216050983734114,0.23860596808496756
1883,0.3603,106,453,106,431001,174609,53201,54755,1.6174089443847492,0.2387253448666748
1884,0.3604,125,506,125,431507,174103,53326,54630,1.612721849642447,0.23883742179746692
1885,0.3605,77,391,77,431898,173712,53403,54553,1.6091000037052132,0.2389897706612928
1886,0.3606,83,360,83,432258,173352,53486,54470,1.6057653117936936,0.23909016688467313
1887,0.3607,85,404,85,432662,172948,53571,54385,1.6020230464263219,0.23923055605653382
1888,0.3608,62,313,62,432975,172635,53633,54323,1.5991237170699173,0.23935265555741592
1889,0.3609,74,319,74,433294,172316,53707,54249,1.5961688095149875,0.23944121995895218
1890,0.361,90,409,90,433703,171907,53797,54159,1.592380228982178,0.23957162952412128
1891,0.3611,104,441,104,434144,171466,53901,54055,1.5882952313905665,0.23968943025261505
1892,0.3612,92,436,92,434580,171030,53993,53963,1.584256548964393,0.2398430173383172
1893,0.3613,66,263,66,434843,170767,54059,53897,1.5818203712623662,0.23990047359612576
1894,0.3614,66,331,66,435174,170436,54125,53831,1.5787543073103858,0.24003085607780011
1895,0.3615,75,440,75,435614,169996,54200,53756,1.574678572751862,0.24024813186027388
1896,0.3616,79,432,79,436046,169564,54279,53677,1.5706769424580385,0.24044418364010195
1897,0.3617,85,432,85,436478,169132,54364,53592,1.566675312164215,0.2406206785079291
1898,0.3618,83,371,83,436849,168761,54447,53509,1.5632387268887324,0.2407387411706483
1899,0.3619,101,428,101,437277,168333,54548,53408,1.5592741487272592,0.24085757708317362
1900,0.362,41,304,41,437581,168029,54589,53367,1.5564581866686429,0.24104771540587905
1901,0.3621,137,620,137,438201,167409,54726,53230,1.5507151061543591,0.2412538127892168
1902,0.3622,100,431,100,438632,166978,54826,53130,1.5467227388936233,0.24138150362549293
1903,0.3623,55,326,55,438958,166652,54881,53075,1.5437029901070807,0.2415497412698485
1904,0.3624,86,408,86,439366,166244,54967,52989,1.5399236726073586,0.24170175110498876
1905,0.3625,66,258,66,439624,165986,55033,52923,1.5375338100707696,0.2417579907632852
1906,0.3626,83,369,83,439993,165617,55116,52840,1.534115750861462,0.24187826437239365
1907,0.3627,43,255,43,440248,165362,55159,52797,1.5317536774241358,0.2420115603756893
1908,0.3628,68,256,68,440504,165106,55227,52729,1.529382340953722,0.24205935685266372
1909,0.3629,73,380,73,440884,164726,55300,52656,1.5258623883804512,0.2422279673570029
1910,0.363,87,358,87,441242,164368,55387,52569,1.522546222535107,0.242323808294574
1911,0.3631,91,477,91,441719,163891,55478,52478,1.5181277557523436,0.24253936562076822
1912,0.3632,95,405,95,442124,163486,55573,52383,1.5143762273518842,0.24266105832704093
1913,0.3633,100,321,100,442445,163165,55673,52283,1.5114027937307792,0.2426710853663065
1914,0.3634,59,283,59,442728,162882,55732,52224,1.5087813553670013,0.2427826280996346
1915,0.3635,75,345,75,443073,162537,55807,52149,1.5055856089517952,0.24290824739386827
1916,0.3636,56,290,56,443363,162247,55863,52093,1.5028993293564044,0.2430390967621536
1917,0.3637,66,404,66,443767,161843,55929,52027,1.4991570639890326,0.24326459999064853
1918,0.3638,74,291,74,444058,161552,56003,51953,1.4964615213605543,0.2433338797686237
1919,0.3639,87,390,87,444448,161162,56090,51866,1.492848938456408,0.24347034192688286
1920,0.364,54,227,54,444675,160935,56144,51812,1.4907462299455334,0.2435380992446427
1921,0.3641,103,433,103,445108,160502,56247,51709,1.4867353366186224,0.24366785887630707
1922,0.3642,99,486,99,445594,160016,56346,51610,1.482233502538071,0.24387362611399355
1923,0.3643,89,436,89,446030,159580,56435,51521,1.4781948201118975,0.24405853122439022
1924,0.3644,78,382,78,446412,159198,56513,51443,1.4746563414724518,0.24422121049558254
1925,0.3645,101,418,101,446830,158780,56614,51342,1.470784393641854,0.24434376219529608
1926,0.3646,114,401,114,447231,158379,56728,51228,1.467069917373745,0.24440023472498534
1927,0.3647,69,307,69,447538,158072,56797,51159,1.4642261662158658,0.2445096567908197
1928,0.3648,61,320,61,447858,157752,56858,51098,1.4612619956278483,0.2446636341872157
1929,0.3649,61,255,61,448113,157497,56919,51037,1.4588999221905221,0.24474186463598263
1930,0.365,62,234,62,448347,157263,56981,50975,1.4567323724480343,0.2447920168269
1931,0.3651,71,348,71,448695,156915,57052,50904,1.4535088369335656,0.2449439175436317
1932,0.3652,85,326,85,449021,156589,57137,50819,1.450489088147023,0.24501947851577566
1933,0.3653,53,270,53,449291,156319,57190,50766,1.4479880692133833,0.24514571311297292
1934,0.3654,73,290,73,449581,156029,57263,50693,1.4453017896179925,0.245223053182535
1935,0.3655,73,342,73,449923,155687,57336,50620,1.442133832302049,0.24536249375930047
1936,0.3656,53,248,53,450171,155439,57389,50567,1.4398366000963356,0.245463724357543
1937,0.3657,84,269,84,450440,155170,57473,50483,1.4373448441957835,0.24547660379376912
1938,0.3658,107,437,107,450877,154733,57580,50376,1.4332968987365222,0.24560599486126888
1939,0.3659,86,404,86,451281,154329,57666,50290,1.4295546333691505,0.24577385286801323
1940,0.366,82,337,82,451618,153992,57748,50208,1.4264329912186446,0.2458765915768854
1941,0.3661,86,392,86,452010,153600,57834,50122,1.4228018822483235,0.24603135645634738
1942,0.3662,89,364,89,452374,153236,57923,50033,1.4194301382044536,0.24614181208152744
1943,0.3663,63,300,63,452674,152936,57986,49970,1.4166512282781873,0.2462716725971632
1944,0.3664,69,305,69,452979,152631,58055,49901,1.4138260031864833,0.24638575632492643
1945,0.3665,53,312,53,453291,152319,58108,49848,1.4109359368631664,0.24656843104957782
1946,0.3666,102,423,102,453714,151896,58210,49746,1.407017673867131,0.24670455559853602
1947,0.3667,71,281,71,453995,151615,58281,49675,1.4044147615695284,0.246783248050077
1948,0.3668,76,344,76,454339,151271,58357,49599,1.4012282781874097,0.24692089411061882
1949,0.3669,63,279,63,454618,150992,58420,49536,1.398643891955982,0.24702784648527887
1950,0.367,84,354,84,454972,150638,58504,49452,1.3953647782429879,0.24714878304762858
1951,0.3671,58,278,58,455250,150360,58562,49394,1.392789655044648,0.2472741472010573
1952,0.3672,79,373,79,455623,149987,58641,49315,1.38933454370299,0.24743856057641167
1953,0.3673,76,316,76,455939,149671,58717,49239,1.386407425247323,0.24754411542908852
1954,0.3674,63,292,63,456231,149379,58780,49176,1.3837026195857571,0.2476694114980736
1955,0.3675,52,363,52,456594,149016,58832,49124,1.380340138574975,0.2479257090945796
1956,0.3676,85,355,85,456949,148661,58917,49039,1.3770517618288933,0.24804754678806273
1957,0.3677,63,267,63,457216,148394,58980,48976,1.3745785319945163,0.2481430815220145
1958,0.3678,86,371,86,457587,148023,59066,48890,1.3711419467190338,0.24828223631756155
1959,0.3679,61,266,61,457853,147757,59127,48829,1.3686779799177442,0.2483849307682134
1960,0.368,63,244,63,458097,147513,59190,48766,1.366417799844381,0.2484524579807315
1961,0.3681,78,418,78,458515,147095,59268,48688,1.3625458520137834,0.24868349141651727
1962,0.3682,44,259,44,458774,146836,59312,48644,1.360146726444107,0.2488438714958052
1963,0.3683,67,253,67,459027,146583,59379,48577,1.3578031790729557,0.24890858782537406
1964,0.3684,121,473,121,459500,146110,59500,48456,1.3534217644225426,0.249046596013692
1965,0.3685,87,294,87,459794,145816,59587,48369,1.3506984326948015,0.24908721064963824
1966,0.3686,45,190,45,459984,145626,59632,48324,1.3489384564081663,0.2491569992266048
1967,0.3687,98,373,98,460357,145253,59730,48226,1.3454833450665087,0.24925702531024038
1968,0.3688,82,374,82,460731,144879,59812,48144,1.3420189706917633,0.2494210534495889
1969,0.3689,82,414,82,461145,144465,59894,48062,1.3381840749935159,0.24963771315192154
1970,0.369,74,250,74,461395,144215,59968,47988,1.3358683167216274,0.24967352226552134
1971,0.3691,74,321,74,461716,143894,60042,47914,1.3328948831005225,0.24980188521855187
1972,0.3692,55,201,55,461917,143693,60097,47859,1.331033013449924,0.24984860507851653
1973,0.3693,81,324,81,462241,143369,60178,47778,1.3280317907295565,0.24995422371264
1974,0.3694,71,266,71,462507,143103,60249,47707,1.325567823928267,0.25002358366961897
1975,0.3695,55,311,55,462818,142792,60304,47652,1.3226870206380377,0.2502152863833988
1976,0.3696,75,311,75,463129,142481,60379,47577,1.3198062173478085,0.2503288469835524
1977,0.3697,78,317,78,463446,142164,60457,47499,1.3168698358590536,0.250438936429351
1978,0.3698,103,350,103,463796,141814,60560,47396,1.3136277742784097,0.2504941599281222
1979,0.3699,59,311,59,464107,141503,60619,47337,1.3107469709881803,0.25067252700699005
1980,0.37,66,336,66,464443,141167,60685,47271,1.3076345918707621,0.2508570458187839
1981,0.3701,82,318,82,464761,140849,60767,47189,1.3046889473489198,0.2509545942841341
1982,0.3702,57,322,57,465083,140527,60824,47132,1.3017062506947275,0.2511576849498292
1983,0.3703,58,224,58,465307,140303,60882,47074,1.2996313312831154,0.2512261376796512
1984,0.3704,84,392,84,465699,139911,60966,46990,1.296000222312794,0.25141652532624226
1985,0.3705,77,300,77,465999,139611,61043,46913,1.293221312386528,0.2515118697861937
1986,0.3706,95,346,95,466345,139265,61138,46818,1.290016302938234,0.2515974054588544
1987,0.3707,79,260,79,466605,139005,61217,46739,1.28760791433547,0.2516312774571453
1988,0.3708,85,346,85,466951,138659,61302,46654,1.2844029048871763,0.2517578367410813
1989,0.3709,44,263,44,467214,138396,61346,46610,1.2819667271851496,0.2519377749910814
1990,0.371,80,309,80,467523,138087,61426,46530,1.2791044499610953,0.2520352946911715
1991,0.3711,68,303,68,467826,137784,61494,46462,1.2762977509355664,0.2521737242599568
1992,0.3712,66,304,66,468130,137480,61560,46396,1.2734817888769498,0.25232221714633774
1993,0.3713,81,337,81,468467,137143,61641,46315,1.270360146726444,0.25245560291728897
1994,0.3714,56,197,56,468664,136946,61697,46259,1.268535329208196,0.2524985671788434
1995,0.3715,70,255,70,468919,136691,61767,46189,1.2661732557708696,0.25256452318460193
1996,0.3716,88,425,88,469344,136266,61855,46101,1.2622364667086592,0.2527924460017437
1997,0.3717,72,323,72,469667,135943,61927,46029,1.2592445070213791,0.25294550810014726
1998,0.3718,87,331,87,469998,135612,62014,45942,1.2561784430693987,0.2530486797316501
1999,0.3719,81,377,81,470375,135235,62095,45861,1.2526862795953908,0.25324137474046915
2000,0.372,65,280,65,470655,134955,62160,45796,1.2500926303308755,0.25336512661064114
2001,0.3721,77,312,77,470967,134643,62237,45719,1.2472025640075586,0.25348465863097547
2002,0.3722,66,267,66,471234,134376,62303,45653,1.2447293341731818,0.25358692210699385
2003,0.3723,104,404,104,471638,133972,62407,45549,1.2409870688058098,0.2537251909247386
2004,0.3724,85,357,85,471995,133615,62492,45464,1.237680165993553,0.2538767806387125
2005,0.3725,83,282,83,472277,133333,62575,45381,1.2350679906628625,0.2539308616000985
2006,0.3726,85,329,85,472606,133004,62660,45296,1.2320204527770573,0.2540437464946719
2007,0.3727,88,414,88,473020,132590,62748,45208,1.2281855570788098,0.25426607723371464
2008,0.3728,74,327,74,473347,132263,62822,45134,1.2251565452591797,0.2544236937490487
2009,0.3729,80,383,80,473730,131880,62902,45054,1.2216088035866464,0.2546373223914002
2010,0.373,82,375,82,474105,131505,62984,44972,1.2181351661788136,0.25483207443462885
2011,0.3731,54,229,54,474334,131276,63038,44918,1.2160139316017637,0.25493490130197394
2012,0.3732,72,350,72,474684,130926,63110,44846,1.2127718700211196,0.25513733700475616
2013,0.3733,79,369,79,475053,130557,63189,44767,1.2093538108118123,0.25533868723049896
2014,0.3734,72,275,72,475328,130282,63261,44695,1.2068064767127349,0.25543357126936683
2015,0.3735,55,208,55,475536,130074,63316,44640,1.2048797658305235,0.2555032796455922
2016,0.3736,80,295,80,475831,129779,63396,44560,1.2021471710696952,0.25559398642873943
2017,0.3737,83,391,83,476222,129388,63479,44477,1.1985253251324615,0.2558134184568487
2018,0.3738,106,466,106,476688,128922,63585,44371,1.194208751713661,0.2560461184237101
2019,0.3739,89,350,89,477038,128572,63674,44282,1.1909666901330171,0.25618151734990224
2020,0.374,51,263,51,477301,128309,63725,44231,1.1885305124309904,0.2563521502260345
2021,0.3741,104,339,104,477640,127970,63829,44127,1.1853903442143094,0.2564077235512531
2022,0.3742,58,276,58,477916,127694,63887,44069,1.1828337470821446,0.2565686440036562
2023,0.3743,104,370,104,478286,127324,63991,43965,1.1794064248397496,0.2566714733578922
2024,0.3744,76,375,76,478661,126949,64067,43889,1.1759327874319168,0.256904201641321
2025,0.3745,58,238,58,478899,126711,64125,43831,1.173728185557079,0.2570100034009218
2026,0.3746,66,376,66,479275,126335,64191,43765,1.1702452851161584,0.25728982951205176
2027,0.3747,51,251,51,479526,126084,64242,43714,1.1679202638111823,0.25744708418238144
2028,0.3748,65,209,65,479735,125875,64307,43649,1.1659842898958834,0.2574797668766664
2029,0.3749,95,367,95,480102,125508,64402,43554,1.1625847567527512,0.2576214643148667
2030,0.375,64,222,64,480324,125286,64466,43490,1.160528363407314,0.25767881689339717
2031,0.3751,76,314,76,480638,124972,64542,43414,1.157619771017822,0.2578242846792489
2032,0.3752,96,255,96,480893,124717,64638,43318,1.1552576975804958,0.2577915315261701
2033,0.3753,81,283,81,481176,124434,64719,43237,1.1526362592167179,0.25786808690829066
2034,0.3754,70,279,70,481455,124155,64789,43167,1.1500518729852902,0.2579875927851687
2035,0.3755,62,240,62,481695,123915,64851,43105,1.1478287450442772,0.25808286432762545
2036,0.3756,62,264,62,481959,123651,64913,43043,1.145383304309163,0.2582156526329682
2037,0.3757,66,263,66,482222,123388,64979,42977,1.1429471266071363,0.2583295765335257
2038,0.3758,88,368,88,482590,123020,65067,42889,1.1395383304309163,0.25850918274475765
2039,0.3759,85,383,85,482973,122637,65152,42804,1.135990588758383,0.25872667597512106
2040,0.376,71,316,71,483289,122321,65223,42733,1.1330634703027158,0.25890314684891
2041,0.3761,44,222,44,483511,122099,65267,42689,1.1310070769572789,0.2590540573342719
2042,0.3762,66,277,66,483788,121822,65333,42623,1.1284412167920264,0.2591930432667457
2043,0.3763,65,230,65,484018,121592,65398,42558,1.1263107191818889,0.25926286932683523
2044,0.3764,60,331,60,484349,121261,65458,42498,1.1232446552299085,0.2595155075446235
2045,0.3765,86,381,86,484730,120880,65544,42412,1.1197154396235502,0.25973103397594494
2046,0.3766,116,481,116,485211,120399,65660,42296,1.1152599207084368,0.2599711115891699
2047,0.3767,64,310,64,485521,120089,65724,42232,1.112388380451295,0.2601758244466212
2048,0.3768,96,338,96,485859,119751,65820,42136,1.1092574752677016,0.260280318987936
2049,0.3769,50,235,50,486094,119516,65870,42086,1.1070806624921263,0.26042994517394585
2050,0.377,77,305,77,486399,119211,65947,42009,1.1042554374004223,0.26056940826200226
2051,0.3771,76,269,76,486668,118942,66023,41933,1.1017636814998704,0.26065578865578864
2052,0.3772,75,358,75,487026,118584,66098,41858,1.098447515654526,0.26089178643995964
2053,0.3773,85,293,85,487319,118291,66183,41773,1.0957334469598725,0.2609768592562975
2054,0.3774,90,330,90,487649,117961,66273,41683,1.0926766460409796,0.2610996968254366
2055,0.3775,76,317,76,487966,117644,66349,41607,1.089740264552225,0.26126680523199225
2056,0.3776,61,235,61,488201,117409,66410,41546,1.0875634517766497,0.2613695700040892
2057,0.3777,80,369,80,488570,117040,66490,41466,1.0841453925673423,0.26160523891840054
2058,0.3778,78,329,78,488899,116711,66568,41388,1.0810978546815369,0.2617853370356549
2059,0.3779,91,292,91,489191,116419,66659,41297,1.0783930490199711,0.2618440741586142
2060,0.378,62,248,62,489439,116171,66721,41235,1.0760958168142576,0.2619658716948528
2061,0.3781,81,291,81,489730,115880,66802,41154,1.0734002741857793,0.2620706343849103
2062,0.3782,75,310,75,490040,115570,66877,41079,1.0705287339286376,0.2622359542671833
2063,0.3783,91,284,91,490324,115286,66968,40988,1.0678980325317722,0.26228291334451026
2064,0.3784,111,364,111,490688,114922,67079,40877,1.0645262884879025,0.2623701050712777
2065,0.3785,97,343,97,491031,114579,67176,40780,1.0613490681388713,0.2624888162256451
2066,0.3786,85,378,85,491409,114201,67261,40695,1.057847641631776,0.2627246668732569
2067,0.3787,59,248,59,491657,113953,67320,40636,1.0555504094260624,0.2628647575183228
2068,0.3788,105,376,105,492033,113577,67425,40531,1.0520675089851421,0.26300386741765513
2069,0.3789,88,369,88,492402,113208,67513,40443,1.0486494497758345,0.2632133861803698
2070,0.379,43,237,43,492639,112971,67556,40400,1.0464541109340844,0.2634135527576921
2071,0.3791,62,233,62,492872,112738,67618,40338,1.044295824224684,0.26351616190650395
2072,0.3792,78,326,78,493198,112412,67696,40260,1.0412760754381414,0.2637025780758751
2073,0.3793,97,385,97,493583,112027,67793,40163,1.037709807699433,0.2639003876733031
2074,0.3794,84,318,84,493901,111709,67877,40079,1.0347641631775908,0.26404590613223705
2075,0.3795,52,213,52,494114,111496,67929,40027,1.0327911371299419,0.2641645162780568
2076,0.3796,68,278,68,494392,111218,67997,39959,1.0302160139316017,0.2643193078312177
2077,0.3797,75,240,75,494632,110978,68072,39884,1.0279928859905887,0.2643740637138577
2078,0.3798,43,203,43,494835,110775,68115,39841,1.0261124902738152,0.2645203696818399
2079,0.3799,54,256,54,495091,110519,68169,39787,1.0237411538034014,0.264706665069924
2080,0.38,81,254,81,495345,110265,68250,39706,1.0213883433991626,0.2647578531849491
2081,0.3801,121,348,121,495693,109917,68371,39585,1.0181648078846937,0.2647790665007826
2082,0.3802,67,241,67,495934,109676,68438,39518,1.0159324169105932,0.2648766036167674
2083,0.3803,73,240,73,496174,109436,68511,39445,1.0137092889695802,0.2649431425097897
2084,0.3804,99,339,99,496513,109097,68610,39346,1.0105691207528993,0.2650579683784348
2085,0.3805,88,319,88,496832,108778,68698,39258,1.0076142131979695,0.265192250533654
2086,0.3806,55,229,55,497061,108549,68753,39203,1.0054929786209197,0.2653297417293844
2087,0.3807,88,287,88,497348,108262,68841,39115,1.0028344881247915,0.26540776376232383
2088,0.3808,68,305,68,497653,107957,68909,39047,1.0000092630330875,0.2656186226225137
2089,0.3809,60,234,60,497887,107723,68969,38987,0.9978417132905999,0.26574193988139866
2090,0.381,70,257,70,498144,107466,69039,38917,0.9954611137870985,0.26585737414863747
2091,0.3811,68,262,68,498406,107204,69107,38849,0.9930341991181593,0.26599248218112603
2092,0.3812,50,203,50,498609,107001,69157,38799,0.9911538034013857,0.26611111111111113
2093,0.3813,89,254,89,498863,106747,69246,38710,0.988800992997147,0.26612675911094
2094,0.3814,44,209,44,499072,106538,69290,38666,0.9868650190818482,0.2662874300983444
2095,0.3815,82,264,82,499336,106274,69372,38584,0.9844195783467339,0.2663573982796946
2096,0.3816,74,263,74,499599,106011,69446,38510,0.9819834006447071,0.26646646508119926
2097,0.3817,66,260,66,499859,105751,69512,38444,0.979575012041943,0.2666111862408544
2098,0.3818,90,304,90,500163,105447,69602,38354,0.9767590499833265,0.2667158086522347
2099,0.3819,51,281,51,500444,105166,69653,38303,0.9741561376857238,0.266977535216667
2100,0.382,96,346,96,500790,104820,69749,38207,0.97095112823743,0.2671313807882428
2101,0.3821,62,233,62,501023,104587,69811,38145,0.9687928415280299,0.2672491102205532
2102,0.3822,59,227,59,501250,104360,69870,38086,0.9666901330171551,0.26737149516307934
2103,0.3823,64,238,64,501488,104122,69934,38022,0.9644855311423173,0.26748930661864023
2104,0.3824,77,307,77,501795,103815,70011,37945,0.9616417799844381,0.2676707110609481
2105,0.3825,52,203,52,501998,103612,70063,37893,0.9597613842676646,0.2677855906151726
2106,0.3826,107,393,107,502391,103219,70170,37786,0.9561210122642558,0.2679763128967058
2107,0.3827,69,250,69,502641,102969,70239,37717,0.9538052539923673,0.26809348478171247
2108,0.3828,85,261,85,502902,102708,70324,37632,0.9513876023565156,0.2681487815305686
2109,0.3829,71,272,71,503174,102436,70395,37561,0.9488680573567009,0.26829860639870856
2110,0.383,68,224,68,503398,102212,70463,37493,0.9467931379450888,0.26837264235353064
2111,0.3831,38,165,38,503563,102047,70501,37455,0.9452647374856423,0.26849077432581614
2112,0.3832,69,274,69,503837,101773,70570,37386,0.9427266664196524,0.26865671641791045
2113,0.3833,70,245,70,504082,101528,70640,37316,0.9404572233132017,0.26876206389905216
2114,0.3834,69,283,69,504365,101245,70709,37247,0.9378357849494239,0.2689469427836987
2115,0.3835,54,256,54,504621,100989,70763,37193,0.93546444847901,0.26915951426379703
2116,0.3836,72,314,72,504935,100675,70835,37121,0.932555856089518,0.2693909837731139
2117,0.3837,105,378,105,505313,100297,70940,37016,0.9290544295824225,0.2695738932220547
2118,0.3838,75,285,75,505598,100012,71015,36941,0.9264144651524695,0.2697348725475163
2119,0.3839,48,217,48,505815,99795,71063,36893,0.9244043869724703,0.2699066487182489
2120,0.384,79,322,79,506137,99473,71142,36814,0.9214216903182778,0.2701211414148085
2121,0.3841,48,181,48,506318,99292,71190,36766,0.9197450813294306,0.27022299313528053
2122,0.3842,71,248,71,506566,99044,71261,36695,0.917447849123717,0.2703349811034412
2123,0.3843,90,270,90,506836,98774,71351,36605,0.9149468301900774,0.27038905590970536
2124,0.3844,122,356,122,507192,98418,71473,36483,0.9116491904109082,0.2704427691418151
2125,0.3845,80,325,80,507517,98093,71553,36403,0.908638704657453,0.27066232453009753
2126,0.3846,87,317,87,507834,97776,71640,36316,0.9057023231686984,0.2708289830862393
2127,0.3847,83,347,83,508181,97429,71723,36233,0.9024880506873171,0.27107928955125615
2128,0.3848,85,249,85,508430,97180,71808,36148,0.9001815554485161,0.27112084483379334
2129,0.3849,64,259,64,508689,96921,71872,36084,0.8977824298788395,0.2712980715010714
2130,0.385,92,320,92,509009,96601,71964,35992,0.8948182592908221,0.2714472106370623
2131,0.3851,69,322,69,509331,96279,72033,35923,0.8918355626366298,0.2717281130391371
2132,0.3852,68,280,68,509611,95999,72101,35855,0.8892419133721146,0.271929558451014
2133,0.3853,67,264,67,509875,95735,72168,35788,0.8867964726370002,0.2721044988329038
2134,0.3854,60,247,60,510122,95488,72228,35728,0.8845085034643744,0.27228386782099745
2135,0.3855,54,228,54,510350,95260,72282,35674,0.882396531920412,0.27245787954236483
2136,0.3856,95,294,95,510644,94966,72377,35579,0.879673200192671,0.2725420353134934
2137,0.3857,77,257,77,510901,94709,72454,35502,0.8772926006891697,0.2726497761325848
2138,0.3858,67,306,67,511207,94403,72521,35435,0.8744581125643781,0.2729170196706665
2139,0.3859,64,263,64,511470,94140,72585,35371,0.8720219348623514,0.27311193643783155
2140,0.386,49,196,49,511666,93944,72634,35322,0.8702063803771907,0.2732505067071001
2141,0.3861,79,250,79,511916,93694,72713,35243,0.8678906221053022,0.2733350395929795
2142,0.3862,75,251,75,512167,93443,72788,35168,0.8655656008003261,0.27344472867795133
2143,0.3863,48,214,48,512381,93229,72836,35120,0.8635833117195895,0.27362893361070206
2144,0.3864,77,251,77,512632,92978,72913,35043,0.8612582904146133,0.2737285289132252
2145,0.3865,65,232,65,512864,92746,72978,34978,0.8591092667383008,0.2738561272744355
2146,0.3866,97,276,97,513140,92470,73075,34881,0.8565526696061359,0.273896553619524
2147,0.3867,90,325,90,513465,92145,73165,34791,0.8535421838526808,0.27408300245793155
2148,0.3868,69,249,69,513714,91896,73234,34722,0.8512356886138798,0.274226413306165
2149,0.3869,60,217,60,513931,91679,73294,34662,0.8492256104338805,0.2743527437648903
2150,0.387,56,271,56,514202,91408,73350,34606,0.8467153284671532,0.2746202802863174
2151,0.3871,74,228,74,514430,91180,73424,34532,0.8446033569231909,0.27469135802469136
2152,0.3872,59,221,59,514651,90959,73483,34473,0.8425562266108415,0.2748341730977741
2153,0.3873,54,173,54,514824,90786,73537,34419,0.8409537218866946,0.27490116209416554
2154,0.3874,93,373,93,515197,90413,73630,34326,0.8374986105450368,0.2751825812296074
2155,0.3875,46,146,46,515343,90267,73676,34280,0.836146207714254,0.2752374605570588
2156,0.3876,60,215,60,515558,90052,73736,34220,0.8341546556004298,0.2753637182953521
2157,0.3877,82,254,82,515812,89798,73818,34138,0.831801845196191,0.2754486186418797
2158,0.3878,92,286,92,516098,89512,73910,34046,0.8291526177331505,0.27554670680975735
2159,0.3879,81,208,81,516306,89304,73991,33965,0.8272259068509392,0.2755356172273645
2160,0.388,72,194,72,516500,89110,74063,33893,0.8254288784319538,0.2755461248912628
2161,0.3881,66,235,66,516735,88875,74129,33827,0.8232520656563785,0.27568417792701017
2162,0.3882,84,286,84,517021,88589,74213,33743,0.820602838193338,0.2758313442108361
2163,0.3883,62,229,62,517250,88360,74275,33681,0.8184816036162881,0.275981022771036
2164,0.3884,80,253,80,517503,88107,74355,33601,0.8161380562451369,0.2760788115818188
2165,0.3885,72,249,72,517752,87858,74427,33529,0.8138315610063359,0.27621573974148794
2166,0.3886,65,209,65,517961,87649,74492,33464,0.811895587091037,0.27630394755311155
2167,0.3887,98,307,98,518268,87342,74590,33366,0.809051835933158,0.2764191271498161
2168,0.3888,66,275,66,518543,87067,74656,33300,0.8065045018340805,0.2766539001553582
2169,0.3889,48,205,48,518748,86862,74704,33252,0.8046055800511319,0.27683700484539686
2170,0.389,101,331,101,519079,86531,74805,33151,0.8015395160991515,0.2769923630955365
2171,0.3891,98,262,98,519341,86269,74903,33053,0.7991126014302123,0.2770067548314644
2172,0.3892,73,222,73,519563,86047,74976,32980,0.7970562080847753,0.27707999025431207
2173,0.3893,54,256,54,519819,85791,75030,32926,0.7946848716143614,0.27734865267821796
2174,0.3894,72,256,72,520075,85535,75102,32854,0.7923135351439475,0.2775088901840543
2175,0.3895,130,387,130,520462,85148,75232,32724,0.788728741339064,0.2776231844712909
2176,0.3896,67,209,67,520671,84939,75299,32657,0.7867927674237652,0.2777050239804075
2177,0.3897,99,322,99,520993,84617,75398,32558,0.7838100707695728,0.2778579048431833
2178,0.3898,93,266,93,521259,84351,75491,32465,0.7813461039682834,0.27791569647993425
2179,0.3899,57,236,57,521495,84115,75548,32408,0.7791600281596206,0.27812534864361543
2180,0.39,62,183,62,521678,83932,75610,32346,0.7774648931045982,0.278178159239065
2181,0.3901,60,218,60,521896,83714,75670,32286,0.7754455518915113,0.27832758620689657
2182,0.3902,109,307,109,522203,83407,75779,32177,0.7726018007336323,0.2783862818383167
2183,0.3903,63,236,63,522439,83171,75842,32114,0.7704157249249695,0.2785618250422865
2184,0.3904,65,185,65,522624,82986,75907,32049,0.7687020638037719,0.2786021645586126
2185,0.3905,54,181,54,522805,82805,75961,31995,0.7670254548149246,0.2787020905923345
2186,0.3906,72,198,72,523003,82607,76033,31923,0.7651913742635889,0.27873046363398235
2187,0.3907,98,318,98,523321,82289,76131,31825,0.7622457297417466,0.2788877788877789
2188,0.3908,51,199,51,523520,82090,76182,31774,0.7604023861573234,0.2790522026276962
2189,0.3909,82,251,82,523771,81839,76264,31692,0.7580773648523472,0.27914842642097754
2190,0.391,85,258,85,524029,81581,76349,31607,0.7556875023157583,0.2792433826907446
2191,0.3911,70,159,70,524188,81422,76419,31537,0.7542146800548372,0.2791897945272178
2192,0.3912,107,354,107,524542,81068,76526,31430,0.750935566341843,0.2793827445821259
2193,0.3913,76,330,76,524872,80738,76602,31354,0.7478787654229501,0.2797166613139207
2194,0.3914,49,169,49,525041,80569,76651,31305,0.7463133128311534,0.2798237302679801
2195,0.3915,97,359,97,525400,80210,76748,31208,0.7429878839527215,0.2800983683067368
2196,0.3916,52,215,52,525615,79995,76800,31156,0.7409963318388973,0.28030337108977876
2197,0.3917,83,283,83,525898,79712,76883,31073,0.7383748934751195,0.2804802094146319
2198,0.3918,81,226,81,526124,79486,76964,30992,0.7362814479973322,0.2805264396531436
2199,0.3919,63,170,63,526294,79316,77027,30929,0.734706732372448,0.28054787065173026
2200,0.392,77,248,77,526542,79068,77104,30852,0.7324095001667346,0.28067685589519653
2201,0.3921,81,285,81,526827,78783,77185,30771,0.7297695357367816,0.2808751848403527
2202,0.3922,112,308,112,527135,78475,77297,30659,0.726916521545815,0.28092986603624903
2203,0.3923,74,257,74,527392,78218,77371,30585,0.7245359220423135,0.28110438131301524
2204,0.3924,50,232,50,527624,77986,77421,30535,0.722386898366001,0.28137411192303796
2205,0.3925,97,343,97,527967,77643,77518,30438,0.7192096780169699,0.281622116745774
2206,0.3926,69,181,69,528148,77462,77587,30369,0.7175330690281225,0.28163515130157374
2207,0.3927,84,235,84,528383,77227,77671,30285,0.7153562562525473,0.28168948582483816
2208,0.3928,63,270,63,528653,76957,77734,30222,0.7128552373189077,0.2819768797992144
2209,0.3929,53,175,53,528828,76782,77787,30169,0.7112342065285857,0.2820824489719591
2210,0.393,81,227,81,529055,76555,77868,30088,0.7091314980177109,0.2821375992798402
2211,0.3931,82,221,82,529276,76334,77950,30006,0.7070843677053614,0.28217039684032347
2212,0.3932,32,147,32,529423,76187,77982,29974,0.705722701841491,0.2823447405356016
2213,0.3933,62,205,62,529628,75982,78044,29912,0.7038237800585424,0.2824711503956787
2214,0.3934,108,308,108,529936,75674,78152,29804,0.7009707658675757,0.2825612924022071
2215,0.3935,85,230,85,530166,75444,78237,29719,0.6988402682574382,0.2825993933227466
2216,0.3936,76,285,76,530451,75159,78313,29643,0.6962003038274853,0.282847655579092
2217,0.3937,81,253,81,530704,74906,78394,29562,0.693856756456334,0.28297660527625684
2218,0.3938,39,172,39,530876,74734,78433,29523,0.6922635147652747,0.2831752304401623
2219,0.3939,100,262,100,531138,74472,78533,29423,0.6898366000963355,0.28319938399345496
2220,0.394,94,366,94,531504,74106,78627,29329,0.6864463299862907,0.2835500555904674
2221,0.3941,80,224,80,531728,73882,78707,29249,0.6843714105746785,0.2836101657115707
2222,0.3942,53,208,53,531936,73674,78760,29196,0.6824446996924673,0.28381452318460193
2223,0.3943,87,289,87,532225,73385,78847,29109,0.6797676831301641,0.2840068686947529
2224,0.3944,64,200,64,532425,73185,78911,29045,0.6779150765126533,0.28411425217646485
2225,0.3945,54,154,54,532579,73031,78965,28991,0.67648856941717,0.2841641998784576
2226,0.3946,63,189,63,532768,72842,79028,28928,0.6747378561636223,0.2842487963053945
2227,0.3947,59,270,59,533038,72572,79087,28869,0.6722368372299826,0.2845890714799736
2228,0.3948,79,234,79,533272,72338,79166,28790,0.670069287487495,0.2846887113361285
2229,0.3949,76,225,76,533497,72113,79242,28714,0.6679851050427952,0.2847848294603628
2230,0.395,71,221,71,533718,71892,79313,28643,0.6659379747304457,0.28490575421495
2231,0.3951,64,206,64,533924,71686,79377,28579,0.6640297899144095,0.2850346581558869
2232,0.3952,55,193,55,534117,71493,79432,28524,0.6622420245285117,0.28519151744203486
2233,0.3953,101,302,101,534419,71191,79533,28423,0.6594445885360702,0.2853313791234164
2234,0.3954,80,251,80,534670,70940,79613,28343,0.6571195672310941,0.2854768691518185
2235,0.3955,59,191,59,534861,70749,79672,28284,0.6553503279113713,0.28560176910726726
2236,0.3956,98,251,98,535112,70498,79770,28186,0.6530253066063952,0.28561874265331766
2237,0.3957,115,353,115,535465,70145,79885,28071,0.6497554559264885,0.28580882951861203
2238,0.3958,68,264,68,535729,69881,79953,28003,0.6473100151913742,0.286083527440644
2239,0.3959,72,238,72,535967,69643,80025,27931,0.6451054133165364,0.2862545350195749
2240,0.396,70,222,70,536189,69421,80095,27861,0.6430490199710993,0.2863941941983101
2241,0.3961,69,212,69,536401,69209,80164,27792,0.6410852569565378,0.28651251018030743
2242,0.3962,104,273,104,536674,68936,80268,27688,0.6385564489236355,0.2865540652425898
2243,0.3963,70,209,70,536883,68727,80338,27618,0.6366204750083367,0.286657325237428
2244,0.3964,93,270,93,537153,68457,80431,27525,0.6341194560746971,0.2867725198474714
2245,0.3965,73,218,73,537371,68239,80504,27452,0.6321001148616103,0.2868817339143702
2246,0.3966,55,181,55,537552,68058,80559,27397,0.630423505872763,0.28701482373893455
2247,0.3967,64,178,64,537730,67880,80623,27333,0.6287746859831783,0.28707214350981486
2248,0.3968,76,182,76,537912,67698,80699,27257,0.6270888139612435,0.28705176136064453
2249,0.3969,47,161,47,538073,67537,80746,27210,0.6255974656341472,0.28718587395906997
2250,0.397,62,215,62,538288,67322,80808,27148,0.6236059135203231,0.2873716523764158
2251,0.3971,102,252,102,538540,67070,80910,27046,0.6212716291822594,0.28736877895363167
2252,0.3972,78,242,78,538782,66828,80988,26968,0.6190299751750713,0.28751759136850186
2253,0.3973,62,183,62,538965,66645,81050,26906,0.6173348401200489,0.2876078288847794
2254,0.3974,68,217,68,539182,66428,81118,26838,0.6153247619400497,0.28775759655179806
2255,0.3975,77,215,77,539397,66213,81195,26761,0.6133332098262255,0.28783315765697937
2256,0.3976,89,270,89,539667,65943,81284,26672,0.6108321908925859,0.28798790692652376
2257,0.3977,42,138,42,539805,65805,81326,26630,0.6095538923265034,0.2880943365608265
2258,0.3978,101,338,101,540143,65467,81427,26529,0.6064229871429101,0.2883712335318927
2259,0.3979,81,259,81,540402,65208,81508,26448,0.6040238615732335,0.2885572139303483
2260,0.398,89,307,89,540709,64901,81597,26359,0.6011801104153544,0.2888341003725619
2261,0.3981,84,291,84,541000,64610,81681,26275,0.5984845677868761,0.2891016119271607
2262,0.3982,80,241,80,541241,64369,81761,26195,0.5962521768127755,0.28924296630007507
2263,0.3983,69,237,69,541478,64132,81830,26126,0.5940568379710253,0.28945910611801723
2264,0.3984,53,168,53,541646,63964,81883,26073,0.5925006484123161,0.28958095005386675
2265,0.3985,52,183,52,541829,63781,81935,26021,0.5908055133572937,0.2897596935480279
2266,0.3986,92,276,92,542105,63505,82027,25929,0.5882489162251288,0.2899232953910146
2267,0.3987,74,240,74,542345,63265,82101,25855,0.5860257882841158,0.2901144524236984
2268,0.3988,76,214,76,542559,63051,82177,25779,0.5840434992033792,0.2902060114826072
2269,0.3989,80,255,80,542814,62796,82257,25699,0.5816814257660529,0.2904005876038194
2270,0.399,94,247,94,543061,62549,82351,25605,0.579393456593427,0.29045760827642536
2271,0.3991,56,190,56,543251,62359,82407,25549,0.5776334803067916,0.2906333894526095
2272,0.3992,56,177,56,543428,62182,82463,25493,0.5759939234502945,0.2907670373538637
2273,0.3993,89,260,89,543688,61922,82552,25404,0.5735855348475305,0.290909923734054
2274,0.3994,82,220,82,543908,61702,82634,25322,0.5715476675682686,0.2909772016914874
2275,0.3995,77,244,77,544152,61458,82711,25245,0.5692874874949053,0.2911663956264489
2276,0.3996,81,261,81,544413,61197,82792,25164,0.5668698358590537,0.29138152638343695
2277,0.3997,78,278,78,544691,60919,82870,25086,0.5642947126607136,0.2916807162374281
2278,0.3998,81,218,81,544909,60701,82951,25005,0.5622753714476268,0.29175320280960493
2279,0.3999,61,202,61,545111,60499,83012,24944,0.5604042387639409,0.29193731493510294
2280,0.4,98,276,98,545387,60223,83110,24846,0.5578476416317759,0.2920687912165419
2281,0.4001,92,233,92,545620,59990,83202,24754,0.5556893549223758,0.29210327574813555
2282,0.4002,81,269,81,545889,59721,83283,24673,0.5531975990218237,0.29235490674692516
2283,0.4003,40,144,40,546033,59577,83323,24633,0.5518637222572159,0.2925187032418953
2284,0.4004,61,156,61,546189,59421,83384,24572,0.5504186890955575,0.29254818853952114
2285,0.4005,41,132,41,546321,59289,83425,24531,0.5491959687280003,0.2926628489620616
2286,0.4006,50,163,50,546484,59126,83475,24481,0.5476860943347289,0.29281041061155166
2287,0.4007,75,226,75,546710,58900,83550,24406,0.5455926488569417,0.2929680935346794
2288,0.4008,52,123,52,546833,58777,83602,24354,0.5444532957871725,0.2929593051930086
2289,0.4009,88,273,88,547106,58504,83690,24266,0.5419244877542703,0.2931738552615682
2290,0.401,78,248,78,547354,58256,83768,24188,0.5396272555485568,0.2933870263451555
2291,0.4011,90,254,90,547608,58002,83858,24098,0.5372744451443181,0.29352009744214375
2292,0.4012,66,189,66,547797,57813,83924,24032,0.5355237318907703,0.2936281996456717
2293,0.4013,50,189,50,547986,57624,83974,23982,0.5337730186372226,0.2938754503345342
2294,0.4014,67,207,67,548193,57417,84041,23915,0.5318555707880989,0.29404170560173115
2295,0.4015,102,267,102,548460,57150,84143,23813,0.5293823409537219,0.294122006348579
2296,0.4016,91,284,91,548744,56866,84234,23722,0.5267516395568564,0.2943614433910756
2297,0.4017,88,194,88,548938,56672,84322,23634,0.524954611137871,0.29429930515777153
2298,0.4018,90,223,90,549161,56449,84412,23544,0.5228889547593464,0.29432575350343154
2299,0.4019,73,207,73,549368,56242,84485,23471,0.5209715069102226,0.2944438171941841
2300,0.402,67,178,67,549546,56064,84552,23404,0.519322687020638,0.29450848140131874
2301,0.4021,70,199,70,549745,55865,84622,23334,0.5174793434362147,0.29462493213298147
2302,0.4022,34,105,34,549850,55760,84656,23300,0.5165067249620215,0.2947128762964837
2303,0.4023,57,186,57,550036,55574,84713,23243,0.5147838008077364,0.29489830874050016
2304,0.4024,60,207,60,550243,55367,84773,23183,0.5128663529586127,0.2951368555060471
2305,0.4025,54,203,54,550446,55164,84827,23129,0.5109859572418393,0.29541593756785406
2306,0.4026,52,229,52,550675,54935,84879,23077,0.5088647226647893,0.2958134645951905
2307,0.4027,77,265,77,550940,54670,84956,23000,0.5064100188965875,0.2961246298442127
2308,0.4028,61,264,61,551204,54406,85017,22939,0.5039645781614732,0.2965802572887711
2309,0.4029,123,323,123,551527,54083,85140,22816,0.5009726184741932,0.29670086737148726
2310,0.403,66,168,66,551695,53915,85206,22750,0.4994164289154841,0.2967455814256832
2311,0.4031,92,206,92,551901,53709,85298,22658,0.49750824409944794,0.2966988358846098
2312,0.4032,68,247,68,552148,53462,85366,22590,0.495220274926822,0.2970336085836007
2313,0.4033,73,225,73,552373,53237,85439,22517,0.49313609248212237,0.29723842965387964
2314,0.4034,84,189,84,552562,53048,85523,22433,0.4913853792285746,0.2972006200235821
2315,0.4035,77,223,77,552785,52825,85600,22356,0.48931972285005004,0.29736236549128103
2316,0.4036,68,195,68,552980,52630,85668,22288,0.4875134313979769,0.29749859846765797
2317,0.4037,56,182,56,553162,52448,85724,22232,0.4858275593760421,0.29769683985002676
2318,0.4038,74,214,74,553376,52234,85798,22158,0.4838452702953055,0.297854608022368
2319,0.4039,81,188,81,553564,52046,85879,22077,0.4821038200748453,0.29784277484721344
2320,0.404,65,206,65,553770,51840,85944,22012,0.48019563525880915,0.2980555706006608
2321,0.4041,70,169,70,553939,51671,86014,21942,0.47863018266701246,0.2980723513509842
2322,0.4042,50,187,50,554126,51484,86064,21892,0.47689799547963985,0.2983536851286524
2323,0.4043,64,205,64,554331,51279,86128,21828,0.47499907369669125,0.2985760597480405
2324,0.4044,81,231,81,554562,51048,86209,21747,0.47285931305346623,0.29874304553884196
2325,0.4045,64,183,64,554745,50865,86273,21683,0.4711641779984438,0.2988779842311297
2326,0.4046,66,163,66,554908,50702,86339,21617,0.46965430360517246,0.2989117659259669
2327,0.4047,96,228,96,555136,50474,86435,21521,0.4675423320612101,0.29892353635669144
2328,0.4048,69,192,69,555328,50282,86504,21452,0.46576382970839975,0.2990492653414002
2329,0.4049,79,207,79,555535,50075,86583,21373,0.463846381859276,0.2991406337476206
2330,0.405,74,213,74,555748,49862,86657,21299,0.461873355811627,0.29930720478914014
2331,0.4051,70,220,70,555968,49642,86727,21229,0.45983548853236506,0.2995442423558296
2332,0.4052,60,174,60,556142,49468,86787,21169,0.4582237207751306,0.2996871328057534
2333,0.4053,76,159,76,556301,49309,86863,21093,0.45675089851420947,0.2996079656827931
2334,0.4054,52,210,52,556511,49099,86915,21041,0.45480566156582314,0.29998574280011403
2335,0.4055,73,189,73,556700,48910,86988,20968,0.4530549483122754,0.30006582901628553
2336,0.4056,80,231,80,556931,48679,87068,20888,0.45091518766905037,0.30025730590653615
2337,0.4057,50,144,50,557075,48535,87118,20838,0.44958131090444253,0.3003762270624018
2338,0.4058,81,206,81,557281,48329,87199,20757,0.44767312608840637,0.3004516110355209
2339,0.4059,30,128,30,557409,48201,87229,20727,0.44648745785319943,0.3007050835654596
2340,0.406,66,173,66,557582,48028,87295,20661,0.4448849531290526,0.30079051958828923
2341,0.4061,59,205,59,557787,47823,87354,20602,0.442986031346104,0.30108878333942274
2342,0.4062,74,196,74,557983,47627,87428,20528,0.44117047686094335,0.30119580368278187
2343,0.4063,51,135,51,558118,47492,87479,20477,0.43991996739412353,0.3012696964792773
2344,0.4064,62,202,62,558320,47290,87541,20415,0.4380488347104376,0.3015286906432317
2345,0.4065,75,201,75,558521,47089,87616,20340,0.43618696505983917,0.3016506251019591
2346,0.4066,52,154,52,558675,46935,87668,20288,0.43476045796435586,0.3018014667598887
2347,0.4067,85,158,85,558833,46777,87753,20203,0.4332968987365223,0.30162735144819347
2348,0.4068,55,129,55,558962,46648,87808,20148,0.4321019674682278,0.3016348284328403
2349,0.4069,53,178,53,559140,46470,87861,20095,0.43045314757864317,0.3018853751971757
2350,0.407,70,203,70,559343,46267,87931,20025,0.42857275186186966,0.30207264828335245
2351,0.4071,68,202,68,559545,46065,87999,19957,0.4267016191781837,0.30227802853594254
2352,0.4072,50,164,50,559709,45901,88049,19907,0.4251824817518248,0.3025012156576708
2353,0.4073,81,178,81,559887,45723,88130,19826,0.4235336618622402,0.3024607545500313
2354,0.4074,77,179,77,560066,45544,88207,19749,0.42187557893956795,0.302467339531037
2355,0.4075,56,132,56,560198,45412,88263,19693,0.42065285857201085,0.30248060824821443
2356,0.4076,76,205,76,560403,45207,88339,19617,0.4187539367890622,0.30261940022213996
2357,0.4077,45,147,45,560550,45060,88384,19572,0.41739227092519177,0.3028221314519124
2358,0.4078,71,205,71,560755,44855,88455,19501,0.4154933491422431,0.30301758965753
2359,0.4079,46,171,46,560926,44684,88501,19455,0.41390937048427134,0.30332558973479473
2360,0.408,55,119,55,561045,44565,88556,19400,0.4128070695468524,0.3032908621902603
2361,0.4081,48,146,48,561191,44419,88604,19352,0.4114546667160695,0.3034608207492434
2362,0.4082,45,153,45,561344,44266,88649,19307,0.4100374226536737,0.30369811083321535
2363,0.4083,55,164,55,561508,44102,88704,19252,0.4085182852273148,0.3038797865959529
2364,0.4084,68,210,68,561718,43892,88772,19184,0.40657304827892843,0.304141036210286
2365,0.4085,57,148,57,561866,43744,88829,19127,0.4052021193819704,0.30422611378855113
2366,0.4086,63,146,63,562012,43598,88892,19064,0.4038497165511875,0.3042354217867288
2367,0.4087,45,187,45,562199,43411,88937,19019,0.4021175293638149,0.30464520262694217
2368,0.4088,77,199,77,562398,43212,89014,18942,0.4002741857793916,0.30475914663577564
2369,0.4089,44,151,44,562549,43061,89058,18898,0.3988754677831709,0.3050081505511709
2370,0.409,94,197,94,562746,42864,89152,18804,0.39705065026492276,0.30492313679704225
2371,0.4091,53,176,53,562922,42688,89205,18751,0.3954203564415132,0.30519702469115706
2372,0.4092,80,219,80,563141,42469,89285,18671,0.39339175219533884,0.30538109257441937
2373,0.4093,54,151,54,563292,42318,89339,18617,0.3919930341991182,0.30552227783703945
2374,0.4094,39,102,39,563394,42216,89378,18578,0.3910482048241876,0.3055893673717801
2375,0.4095,67,233,67,563627,41983,89445,18511,0.3888899181147875,0.3059972889873376
2376,0.4096,86,213,86,563840,41770,89531,18425,0.3869168920671385,0.3060885455602625
2377,0.4097,52,164,52,564004,41606,89583,18373,0.3853977546407796,0.3063238800246753
2378,0.4098,77,199,77,564203,41407,89660,18296,0.3835544110563563,0.30645026213088117
2379,0.4099,66,155,66,564358,41252,89726,18230,0.3821186409277854,0.30647927103997846
2380,0.41,68,184,68,564542,41068,89794,18162,0.3804142428396754,0.30663515110585854
2381,0.4101,44,129,44,564671,40939,89838,18118,0.37921931157138095,0.30678835701102325
2382,0.4102,86,222,86,564893,40717,89924,18032,0.3771629182259439,0.3069328839639824
2383,0.4103,89,237,89,565130,40480,90013,17943,0.37496757938419356,0.3071221950259316
2384,0.4104,59,156,59,565286,40324,90072,17884,0.3735225462225351,0.3072429906542056
2385,0.4105,97,220,97,565506,40104,90169,17787,0.3714846789432732,0.3072498315800383
2386,0.4106,72,174,72,565680,39930,90241,17715,0.36987291118603877,0.307311995836586
2387,0.4107,65,167,65,565847,39763,90306,17650,0.3683259846604172,0.3074216640830474
2388,0.4108,60,209,60,566056,39554,90366,17590,0.3663900107451184,0.30781884362312756
2389,0.4109,39,172,39,566228,39382,90405,17551,0.36479676905405906,0.3082746386102963
2390,0.411,73,156,73,566384,39226,90478,17478,0.3633517358924006,0.308232223476298
2391,0.4111,55,150,55,566534,39076,90533,17423,0.36196228092926747,0.3083771394183968
2392,0.4112,51,139,51,566673,38937,90584,17372,0.3606747193300974,0.3085119607877959
2393,0.4113,48,146,48,566819,38791,90632,17324,0.3593223164993145,0.3087231578009445
2394,0.4114,80,228,80,567047,38563,90712,17244,0.3572103449553522,0.30899349543964016
2395,0.4115,55,122,55,567169,38441,90767,17189,0.35608025491867057,0.30898795613877406
2396,0.4116,73,190,73,567359,38251,90840,17116,0.35432027863203525,0.30913721169649794
2397,0.4117,62,190,62,567549,38061,90902,17054,0.3525603023454,0.30942574616710516
2398,0.4118,59,148,59,567697,37913,90961,16995,0.351189373448442,0.3095177387630218
2399,0.4119,86,251,86,567948,37662,91047,16909,0.34886435214346584,0.30985321874255556
2400,0.412,81,199,81,568147,37463,91128,16828,0.34702100855904255,0.30995929343721795
2401,0.4121,58,169,58,568316,37294,91186,16770,0.3454555559672459,0.3101879254217224
2402,0.4122,64,178,64,568494,37116,91250,16706,0.34380673607766127,0.31039351937869275
2403,0.4123,64,152,64,568646,36964,91314,16642,0.34239875504835304,0.31045032272506806
2404,0.4124,50,142,50,568788,36822,91364,16592,0.34108340434992035,0.3106301718650541
2405,0.4125,71,203,71,568991,36619,91435,16521,0.33920300863314684,0.3108957470831765
2406,0.4126,62,164,62,569155,36455,91497,16459,0.33768387120678794,0.3110518955285936
2407,0.4127,38,115,38,569270,36340,91535,16421,0.3366186224017192,0.3112336763897576
2408,0.4128,75,226,75,569496,36114,91610,16346,0.33452517692393197,0.31158978269157456
2409,0.4129,51,129,51,569625,35985,91661,16295,0.33333024565563746,0.3116870696250956
2410,0.413,54,133,54,569758,35852,91715,16241,0.3320982622549928,0.31176933561131054
2411,0.4131,54,147,54,569905,35705,91769,16187,0.3307365963911223,0.311936329299314
2412,0.4132,69,186,69,570091,35519,91838,16118,0.32901367223683725,0.3121405193950075
2413,0.4133,96,186,96,570277,35333,91934,16022,0.32729074808255215,0.31198520105150424
2414,0.4134,62,168,62,570445,35165,91996,15960,0.32573455852384303,0.3121760391198044
2415,0.4135,52,171,52,570616,34994,92048,15908,0.32415057986587126,0.31252210129268004
2416,0.4136,98,205,98,570821,34789,92146,15810,0.32225165808292267,0.3124567679203146
2417,0.4137,40,121,40,570942,34668,92186,15770,0.3211308310793286,0.3126610888615726
2418,0.4138,52,170,52,571112,34498,92238,15718,0.3195561154544444,0.31300780627688385
2419,0.4139,60,149,60,571261,34349,92298,15658,0.31817592352439883,0.3131161637370768
2420,0.414,93,179,93,571440,34170,92391,15565,0.3165178406017266,0.31295868100934954
2421,0.4141,64,174,64,571614,33996,92455,15501,0.3149060728444922,0.3131704951815262
2422,0.4142,53,123,53,571737,33873,92508,15448,0.31376671977472304,0.3132134384947588
2423,0.4143,40,136,40,571873,33737,92548,15408,0.31250694727481565,0.3135212127378167
2424,0.4144,43,123,43,571996,33614,92591,15365,0.3113675942050465,0.3137058739459768
2425,0.4145,47,151,47,572147,33463,92638,15318,0.3099688762088258,0.31401570283512026
2426,0.4146,50,115,50,572262,33348,92688,15268,0.3089036274037571,0.3140529866710548
2427,0.4147,68,154,68,572416,33194,92756,15200,0.30747712030827373,0.3140885233706658
2428,0.4148,45,129,45,572545,33065,92801,15155,0.3062821890399792,0.3142886768975529
2429,0.4149,50,145,50,572690,32920,92851,15105,0.3049390492422839,0.31452368558042687
2430,0.415,84,214,84,572904,32706,92935,15021,0.3029567601615473,0.3147275127286442
2431,0.4151,44,93,44,572997,32613,92979,14977,0.3020952980844048,0.31470897247320867
2432,0.4152,31,131,31,573128,32482,93010,14946,0.3008818407499352,0.31513030277473225
2433,0.4153,81,250,81,573378,32232,93091,14865,0.2985660824780466,0.31562519905726477
2434,0.4154,60,137,60,573515,32095,93151,14805,0.2972970469450517,0.3156716417910448
2435,0.4155,46,140,46,573655,31955,93197,14759,0.2960002223127941,0.3159438284026202
2436,0.4156,57,155,57,573810,31800,93254,14702,0.2945644521842232,0.3161584447980732
2437,0.4157,51,127,51,573937,31673,93305,14651,0.2933880469821038,0.3162723426301701
2438,0.4158,47,131,47,574068,31542,93352,14604,0.2921745896476342,0.3164738005460928
2439,0.4159,45,109,45,574177,31433,93397,14559,0.2911649190410908,0.3165550530527048
2440,0.416,64,161,64,574338,31272,93461,14495,0.2896735707139946,0.316712915419407
2441,0.4161,51,111,51,574449,31161,93512,14444,0.28864537404127605,0.31671965793224427
2442,0.4162,70,209,70,574658,30952,93582,14374,0.28670940012597723,0.31712482901645855
2443,0.4163,49,136,49,574794,30816,93631,14325,0.2854496276260699,0.31733900445271485
2444,0.4164,60,128,60,574922,30688,93691,14265,0.28426395939086296,0.31733143505439015
2445,0.4165,57,104,57,575026,30584,93748,14208,0.2833006039497573,0.31719949991069835
2446,0.4166,45,115,45,575141,30469,93793,14163,0.28223535514468856,0.31732837426062016
2447,0.4167,37,108,37,575249,30361,93830,14126,0.28123494757123274,0.3175309641018725
2448,0.4168,56,142,56,575391,30219,93886,14070,0.27991959687280005,0.3176861071597914
2449,0.4169,59,136,59,575527,30083,93945,14011,0.27865982437289266,0.3177529822651608
2450,0.417,84,198,84,575725,29885,94029,13927,0.27682574382155695,0.3178809458595819
2451,0.4171,78,154,78,575879,29731,94107,13849,0.2753992367260736,0.3177833868747132
2452,0.4172,43,112,43,575991,29619,94150,13806,0.27436177702026754,0.3179274611398964
2453,0.4173,57,119,57,576110,29500,94207,13749,0.27325947608284856,0.3179033041226387
2454,0.4174,53,109,53,576219,29391,94260,13696,0.2722498054763052,0.317868498619073
2455,0.4175,48,156,48,576375,29235,94308,13648,0.2708047723146467,0.31826131567287735
2456,0.4176,30,109,30,576484,29126,94338,13618,0.2697951017081033,0.31859442260902116
2457,0.4177,46,158,46,576642,28968,94384,13572,0.26833154248026975,0.31904090267983076
2458,0.4178,29,114,29,576756,28854,94413,13543,0.26727555670828856,0.31943297874849635
2459,0.4179,53,98,53,576854,28756,94466,13490,0.2663677794657083,0.319320172324007
2460,0.418,36,91,36,576945,28665,94502,13454,0.2655248434547408,0.31942828652152233
2461,0.4181,51,124,51,577069,28541,94553,13403,0.2643762273518841,0.31954510776273126
2462,0.4182,48,115,48,577184,28426,94601,13355,0.26331097854681534,0.3196428998827218
2463,0.4183,44,155,44,577339,28271,94645,13311,0.26187520841824447,0.32011447260834014
2464,0.4184,55,106,55,577445,28165,94700,13256,0.26089332691096373,0.3200309021993675
2465,0.4185,48,124,48,577569,28041,94748,13208,0.259744710808107,0.320201701859439
2466,0.4186,55,176,55,577745,27865,94803,13153,0.25811441698469745,0.3206640986883807
2467,0.4187,43,109,43,577854,27756,94846,13110,0.25710474637815406,0.3208045808251358
2468,0.4188,38,117,38,577971,27639,94884,13072,0.2560209715069102,0.32109257940114466
2469,0.4189,33,121,33,578092,27518,94917,13039,0.25490014450331616,0.32149813842246716
2470,0.419,71,152,71,578244,27366,94988,12968,0.25349216347400794,0.32151534685377103
2471,0.4191,49,133,49,578377,27233,95037,12919,0.2522601800733632,0.3217523411038055
2472,0.4192,70,182,70,578559,27051,95107,12849,0.2505743080514284,0.32203007518796994
2473,0.4193,25,95,25,578654,26956,95132,12824,0.24969431990811072,0.3223730517848165
2474,0.4194,26,72,26,578726,26884,95158,12798,0.2490273815258068,0.3225139861902122
2475,0.4195,46,144,46,578870,26740,95204,12752,0.247693504761199,0.32290084067659275
2476,0.4196,66,134,66,579004,26606,95270,12686,0.24645225832746676,0.3228647052835183
2477,0.4197,65,131,65,579135,26475,95335,12621,0.24523880099299714,0.3228207489257213
2478,0.4198,46,116,46,579251,26359,95381,12575,0.24416428915484087,0.32298248317665795
2479,0.4199,66,157,66,579408,26202,95447,12509,0.24270999296009485,0.3231381261140244
2480,0.42,50,125,50,579533,26077,95497,12459,0.24155211382415057,0.3233080755657048
2481,0.4201,57,159,57,579692,25918,95554,12402,0.24007929156322946,0.32364300626304804
2482,0.4202,64,175,64,579867,25743,95618,12338,0.2384582607729075,0.3239935926052362
2483,0.4203,49,117,49,579984,25626,95667,12289,0.23737448590166363,0.3241197415271001
2484,0.4204,28,73,28,580057,25553,95695,12261,0.2366982844862722,0.3242449886285503
2485,0.4205,44,122,44,580179,25431,95739,12217,0.23556819444959057,0.3245059498512537
2486,0.4206,72,136,72,580315,25295,95811,12145,0.2343084219496832,0.3243856837606838
2487,0.4207,56,115,56,580430,25180,95867,12089,0.23324317314461449,0.32437146153639757
2488,0.4208,61,124,61,580554,25056,95928,12028,0.23209455704175774,0.3243447308812426
2489,0.4209,47,138,47,580692,24918,95975,11981,0.23081625847567527,0.3246971462641264
2490,0.421,53,150,53,580842,24768,96028,11928,0.22942680351254216,0.3250490516677567
2491,0.4211,48,125,48,580967,24643,96076,11880,0.22826892437659788,0.325274484571366
2492,0.4212,52,139,52,581106,24504,96128,11828,0.22698136277742784,0.32555323131124075
2493,0.4213,68,196,68,581302,24308,96196,11760,0.22516580829226723,0.32605079294665634
2494,0.4214,53,110,53,581412,24198,96249,11707,0.22414687465263625,0.3260548670101657
2495,0.4215,57,120,57,581532,24078,96306,11650,0.22303531068212976,0.3260747872816838
2496,0.4216,41,94,41,581626,23984,96347,11609,0.22216458557189966,0.32615963813109317
2497,0.4217,57,129,57,581755,23855,96404,11552,0.22096965430360518,0.32626316830005364
2498,0.4218,44,87,44,581842,23768,96448,11508,0.22016377042498797,0.32622746343122805
2499,0.4219,30,82,30,581924,23686,96478,11478,0.21940420171180852,0.3264133773177113
2500,0.422,79,176,79,582100,23510,96557,11399,0.21777390788839898,0.3265347045174597
2501,0.4221,59,142,59,582242,23368,96616,11340,0.2164585571899663,0.3267258268986977
2502,0.4222,44,120,44,582362,23248,96660,11296,0.21534699321945977,0.3270032422417786
2503,0.4223,60,157,60,582519,23091,96720,11236,0.21389269702471378,0.32732251580388616
2504,0.4224,39,66,39,582585,23025,96759,11197,0.2132813368409352,0.3271871895272047
2505,0.4225,37,99,37,582684,22926,96796,11160,0.21236429656526734,0.3274071466291146
2506,0.4226,62,154,62,582838,22772,96858,11098,0.21093778946978398,0.3276645999409507
2507,0.4227,47,100,47,582938,22672,96905,11051,0.21001148616102858,0.32769919639415235
2508,0.4228,36,58,36,582996,22614,96941,11015,0.20947423024195042,0.3275446786999316
2509,0.4229,31,93,31,583089,22521,96972,10984,0.2086127681648079,0.3278316669153858
2510,0.423,40,106,40,583195,22415,97012,10944,0.20763088665752713,0.32806738811115443
2511,0.4231,39,95,39,583290,22320,97051,10905,0.2067508985142095,0.32821670428893907
2512,0.4232,23,84,23,583374,22236,97074,10882,0.20597280373485494,0.32858264387946134
2513,0.4233,35,105,35,583479,22131,97109,10847,0.20500018526066174,0.32891624719509976
2514,0.4234,41,118,41,583597,22013,97150,10806,0.20390714735633036,0.32926048935068103
2515,0.4235,27,78,27,583675,21935,97177,10779,0.20318463077550114,0.32949196062847713
2516,0.4236,69,117,69,583792,21818,97246,10710,0.2021008559042573,0.32925479586817513
2517,0.4237,28,86,28,583878,21732,97274,10682,0.20130423505872763,0.3295489603257852
2518,0.4238,62,175,62,584053,21557,97336,10620,0.19968320426840563,0.3300494141778289
2519,0.4239,40,102,40,584155,21455,97376,10580,0.19873837489347512,0.3302637739971906
2520,0.424,66,132,66,584287,21323,97442,10514,0.19751565452591796,0.3302446838584037
2521,0.4241,36,108,36,584395,21215,97478,10478,0.1965152469524621,0.330609282806929
2522,0.4242,53,117,53,584512,21098,97531,10425,0.19543147208121828,0.3307109094946547
2523,0.4243,56,129,56,584641,20969,97587,10369,0.1942365408129238,0.3308762524730359
2524,0.4244,40,80,40,584721,20889,97627,10329,0.19349549816591946,0.3308668076109937
2525,0.4245,53,119,53,584840,20770,97680,10276,0.1923931972285005,0.3309927204792888
2526,0.4246,36,101,36,584941,20669,97716,10240,0.19145763088665751,0.33129509204438834
2527,0.4247,51,148,51,585089,20521,97767,10189,0.1900867019896995,0.3317811787691306
2528,0.4248,32,104,32,585193,20417,97799,10157,0.18912334654859386,0.33221037482828547
2529,0.4249,52,129,52,585322,20288,97851,10105,0.18792841528029938,0.3324778731944856
2530,0.425,19,70,19,585392,20218,97870,10086,0.18728000296417058,0.3328273495248152
2531,0.4251,47,109,47,585501,20109,97917,10039,0.1862703323576272,0.332990579806289
2532,0.4252,30,62,30,585563,20047,97947,10009,0.18569602430619883,0.3330117114719191
2533,0.4253,35,69,35,585632,19978,97982,9974,0.1850568750231576,0.3329994658119658
2534,0.4254,54,146,54,585778,19832,98036,9920,0.18370447219237468,0.3334229631621404
2535,0.4255,74,185,74,585963,19647,98110,9846,0.18199081107117715,0.33384192859322553
2536,0.4256,51,95,51,586058,19552,98161,9795,0.1811108229278595,0.33376495042082666
2537,0.4257,41,74,41,586132,19478,98202,9754,0.1804253584793805,0.33367542419266555
2538,0.4258,38,81,38,586213,19397,98240,9716,0.1796750527992886,0.3337340706900697
2539,0.4259,51,119,51,586332,19278,98291,9665,0.17857275186186966,0.3339322115882942
2540,0.426,58,94,58,586426,19184,98349,9607,0.17770202675163957,0.333680664096419
2541,0.4261,20,55,20,586481,19129,98369,9587,0.1771925599318241,0.3338556902075498
2542,0.4262,33,92,33,586573,19037,98402,9554,0.17634036088776908,0.33416109964674195
2543,0.4263,32,97,32,586670,18940,98434,9522,0.17544184667827634,0.3345513316000281
2544,0.4264,35,122,35,586792,18818,98469,9487,0.17431175664159473,0.33517046458222927
2545,0.4265,60,105,60,586897,18713,98529,9427,0.17333913816740154,0.33500355366027007
2546,0.4266,41,93,41,586990,18620,98570,9386,0.172477676090259,0.33514246947082765
2547,0.4267,56,133,56,587123,18487,98626,9330,0.1712456926896143,0.33540640615450984
2548,0.4268,63,125,63,587248,18362,98689,9267,0.17008781355367,0.3354084476455898
2549,0.4269,44,71,44,587319,18291,98733,9223,0.16943013820445366,0.33521116522497635
2550,0.427,34,104,34,587423,18187,98767,9189,0.16846678276334803,0.33565897136177675
2551,0.4271,53,121,53,587544,18066,98820,9136,0.16734595575975397,0.335857657525182
2552,0.4272,54,153,54,587697,17913,98874,9082,0.16592871169735818,0.33643267271716987
2553,0.4273,48,101,48,587798,17812,98922,9034,0.1649931453555152,0.3365119570885793
2554,0.4274,46,125,46,587923,17687,98968,8988,0.16383526621957092,0.3369447047797563
2555,0.4275,54,92,54,588015,17595,99022,8934,0.16298306717551594,0.3367635417844623
2556,0.4276,57,113,57,588128,17482,99079,8877,0.16193634443662233,0.3367730187032892
2557,0.4277,46,100,46,588228,17382,99125,8831,0.1610100411278669,0.3368939076030977
2558,0.4278,65,134,65,588362,17248,99190,8766,0.15976879469413466,0.3369723994772046
2559,0.4279,44,107,44,588469,17141,99234,8722,0.15877765015376635,0.3372385260797278
2560,0.428,44,105,44,588574,17036,99278,8678,0.15780503167957316,0.3374815275725286
2561,0.4281,40,79,40,588653,16957,99318,8638,0.15707325206565637,0.33748779058409845
2562,0.4282,44,98,44,588751,16859,99362,8594,0.15616547482307608,0.33764192825993006
2563,0.4283,30,81,30,588832,16778,99392,8564,0.15541516914298417,0.33793702154526084
2564,0.4284,49,105,49,588937,16673,99441,8515,0.15444255066879098,0.33805780530411306
2565,0.4285,48,123,48,589060,16550,99489,8467,0.15330319759902183,0.3384498540992125
2566,0.4286,27,77,27,589137,16473,99516,8440,0.15258994405128015,0.33877895074860515
2567,0.4287,42,95,42,589232,16378,99558,8398,0.1517099559079625,0.3389570552147239
2568,0.4288,33,76,33,589308,16302,99591,8365,0.15100596539330838,0.33911703895893297
2569,0.4289,33,104,33,589412,16198,99624,8332,0.15004260995220275,0.3396657154504688
2570,0.429,28,74,28,589486,16124,99652,8304,0.14935714550372373,0.33993777632225314
2571,0.4291,26,70,26,589556,16054,99678,8278,0.14870873318759495,0.3402104224889035
2572,0.4292,20,57,20,589613,15997,99698,8258,0.14818074030160436,0.3404658833230262
2573,0.4293,47,97,47,589710,15900,99745,8211,0.1472822260921116,0.34054995645141223
2574,0.4294,32,55,32,589765,15845,99777,8179,0.14677275927229613,0.3404512154512154
2575,0.4295,40,92,40,589857,15753,99817,8139,0.14592056022824113,0.3406579608237067
2576,0.4296,38,87,38,589944,15666,99855,8101,0.1451146763496239,0.3408507594563891
2577,0.4297,39,102,39,590046,15564,99894,8062,0.1441698469746934,0.3412342334715991
2578,0.4298,34,64,34,590110,15500,99928,8028,0.14357701285708993,0.3412104726283577
2579,0.4299,31,71,31,590181,15429,99959,7997,0.14291933750787358,0.3413728336036882
2580,0.43,35,77,35,590258,15352,99994,7962,0.1422060839601319,0.34151153813159474
2581,0.4301,35,98,35,590356,15254,100029,7927,0.14129830671755159,0.3419610888227428
2582,0.4302,35,71,35,590427,15183,100064,7892,0.14064063136833524,0.3420151679306609
2583,0.4303,34,64,34,590491,15119,100098,7858,0.14004779725073177,0.3419941680811246
2584,0.4304,49,76,49,590567,15043,100147,7809,0.13934380673607766,0.34172063714335726
2585,0.4305,35,77,35,590644,14966,100182,7774,0.13863055318833598,0.3418645558487247
2586,0.4306,44,95,44,590739,14871,100226,7730,0.13775056504501834,0.3420202645900624
2587,0.4307,41,81,41,590820,14790,100267,7689,0.13700025936492646,0.34205258241024955
2588,0.4308,37,112,37,590932,14678,100304,7652,0.1359627996591204,0.3426780116435289
2589,0.4309,26,79,26,591011,14599,100330,7626,0.1352310200452036,0.3431271091113611
2590,0.431,21,50,21,591061,14549,100351,7605,0.13476786839082588,0.3432788661189853
2591,0.4311,35,70,35,591131,14479,100386,7570,0.1341194560746971,0.34332622794684564
2592,0.4312,45,64,45,591195,14415,100431,7525,0.13352662195709364,0.34298085688240654
2593,0.4313,30,89,30,591284,14326,100461,7495,0.1327022120123013,0.34347646762293205
2594,0.4314,34,102,34,591386,14224,100495,7461,0.13175738263737077,0.34406271616324646
2595,0.4315,36,50,36,591436,14174,100531,7425,0.13129423098299306,0.3437659150886615
2596,0.4316,27,61,27,591497,14113,100558,7398,0.13072918596465227,0.3439170656873228
2597,0.4317,48,73,48,591570,14040,100606,7350,0.1300529845492608,0.3436185133239832
2598,0.4318,32,56,32,591626,13984,100638,7318,0.12953425469635776,0.34353581823302975
2599,0.4319,27,75,27,591701,13909,100665,7291,0.12883952721479122,0.34391509433962264
2600,0.432,37,78,37,591779,13831,100702,7254,0.128117010633962,0.34403604458145604
2601,0.4321,36,80,36,591859,13751,100738,7218,0.12737596798695766,0.34422242357766225
2602,0.4322,26,91,26,591950,13660,100764,7192,0.12653303197599022,0.3449069633608287
2603,0.4323,25,61,25,592011,13599,100789,7167,0.1259679869576494,0.34513146489453916
2604,0.4324,37,82,37,592093,13517,100826,7130,0.12520841824446996,0.3453286191698552
2605,0.4325,26,80,26,592173,13437,100852,7104,0.12446737559746564,0.34584489557470427
2606,0.4326,40,80,40,592253,13357,100892,7064,0.1237263329504613,0.34591841731550854
2607,0.4327,17,35,17,592288,13322,100909,7047,0.1234021267923969,0.3459669105012519
2608,0.4328,32,103,32,592391,13219,100941,7015,0.12244803438437882,0.34669368389838884
2609,0.4329,56,94,56,592485,13125,100997,6959,0.12157730927414873,0.346494722166899
2610,0.433,27,53,27,592538,13072,101024,6932,0.12108636852050836,0.34653069386122776
2611,0.4331,33,91,33,592629,12981,101057,6899,0.12024343250954092,0.34703219315895373
2612,0.4332,37,54,37,592683,12927,101094,6862,0.119743228722813,0.3467583000656931
2613,0.4333,48,94,48,592777,12833,101142,6814,0.1188725036125829,0.3468213976688553
2614,0.4334,21,40,21,592817,12793,101163,6793,0.11850198228908074,0.3468293679158583
2615,0.4335,26,45,26,592862,12748,101189,6767,0.1180851458001408,0.34675890340763516
2616,0.4336,44,96,44,592958,12652,101233,6723,0.1171958946237356,0.3469935483870968
2617,0.4337,32,76,32,593034,12576,101265,6691,0.11649190410908147,0.347277728759018
2618,0.4338,34,122,34,593156,12454,101299,6657,0.11536181407239987,0.3483334205431427
2619,0.4339,42,96,42,593252,12358,101341,6615,0.11447256289599467,0.34865334949665316
2620,0.434,23,49,23,593301,12309,101364,6592,0.11401867427470451,0.34876461562880273
2621,0.4341,43,82,43,593383,12227,101407,6549,0.11325910556152506,0.3487963357477631
2622,0.4342,21,34,21,593417,12193,101428,6528,0.11294416243654823,0.34869932161743494
2623,0.4343,36,67,36,593484,12126,101464,6492,0.11232353921968209,0.34869481147276826
2624,0.4344,15,42,15,593526,12084,101479,6477,0.11193449183000481,0.3489574915144658
2625,0.4345,36,85,36,593611,11999,101515,6441,0.11114713401756271,0.34929501084598696
2626,0.4346,16,68,16,593679,11931,101531,6425,0.11051724776760903,0.35002179123992155
2627,0.4347,25,68,25,593747,11863,101556,6400,0.10988736151765534,0.3504353063571155
2628,0.4348,37,77,37,593824,11786,101593,6363,0.10917410796991367,0.3505978290814921
2629,0.4349,31,50,31,593874,11736,101624,6332,0.10871095631553596,0.3504538410449413
2630,0.435,46,96,46,593970,11640,101670,6286,0.10782170513913075,0.35066384023206515
2631,0.4351,22,40,22,594010,11600,101692,6264,0.10745118381562858,0.35064935064935066
2632,0.4352,33,70,33,594080,11530,101725,6231,0.1068027714994998,0.3508248409436406
2633,0.4353,30,59,30,594139,11471,101755,6201,0.1062562525473341,0.3508940697148031
2634,0.4354,21,46,21,594185,11425,101776,6180,0.1058301530253066,0.35103663731894347
2635,0.4355,41,77,41,594262,11348,101817,6139,0.10511689947756493,0.35106078801395324
2636,0.4356,33,63,33,594325,11285,101850,6106,0.10453332839304902,0.3511011442700247
2637,0.4357,12,39,12,594364,11246,101862,6094,0.1041720701026344,0.351441753171857
2638,0.4358,22,69,22,594433,11177,101884,6072,0.10353292081959317,0.3520204069801148
2639,0.4359,50,101,50,594534,11076,101934,6022,0.10259735447775019,0.3522049362498538
2640,0.436,32,77,32,594611,10999,101966,5990,0.10188410093000852,0.35258108187650833
2641,0.4361,24,67,24,594678,10932,101990,5966,0.1012634777131424,0.353059533672624
2642,0.4362,62,104,62,594782,10828,102052,5904,0.10030012227203676,0.3528568013387521
2643,0.4363,38,86,38,594868,10742,102090,5866,0.0995035014265071,0.35320327552986513
2644,0.4364,33,47,33,594915,10695,102123,5833,0.09906813887139204,0.3529162633107454
2645,0.4365,23,35,23,594950,10660,102146,5810,0.09874393271332765,0.35276259866423804
2646,0.4366,38,60,38,595010,10600,102184,5772,0.0981881507280744,0.3525531395064745
2647,0.4367,35,55,35,595065,10545,102219,5737,0.09767868390825891,0.35235229087335707
2648,0.4368,17,50,17,595115,10495,102236,5720,0.09721553225388121,0.3527597903176072
2649,0.4369,21,42,21,595157,10453,102257,5699,0.09682648486420393,0.3528355621594849
2650,0.437,21,70,21,595227,10383,102278,5678,0.09617807254807514,0.35352717763526553
2651,0.4371,37,83,37,595310,10300,102315,5641,0.09540924080180814,0.35386738598582274
2652,0.4372,28,70,28,595380,10230,102343,5613,0.09476082848567935,0.3542889604241621
2653,0.4373,49,92,49,595472,10138,102392,5564,0.09390862944162437,0.3543497643612279
2654,0.4374,15,46,15,595518,10092,102407,5549,0.09348252991959688,0.35477271274215205
2655,0.4375,22,49,22,595567,10043,102429,5527,0.09302864129830672,0.3549775208734746
2656,0.4376,26,62,26,595629,9981,102455,5501,0.09245433324687836,0.3553158506652887
2657,0.4377,23,35,23,595664,9946,102478,5478,0.09213012708881396,0.35516078838174275
2658,0.4378,36,61,36,595725,9885,102514,5442,0.09156508207047316,0.35505969857114894
2659,0.4379,21,29,21,595754,9856,102535,5421,0.09129645411093408,0.35484715585520715
2660,0.438,23,70,23,595824,9786,102558,5398,0.09064804179480529,0.35550579557428874
2661,0.4381,40,83,40,595907,9703,102598,5358,0.0898792100485383,0.35575327003519025
2662,0.4382,15,24,15,595931,9679,102613,5343,0.089656897254437,0.3556783384369591
2663,0.4383,21,40,21,595971,9639,102634,5322,0.08928637593093483,0.35572488470022057
2664,0.4384,31,58,31,596029,9581,102665,5291,0.08874912001185668,0.3557692307692308
2665,0.4385,21,40,21,596069,9541,102686,5270,0.08837859868835451,0.35581662278036597
2666,0.4386,36,47,36,596116,9494,102722,5234,0.08794323613323947,0.3553775122216187
2667,0.4387,21,53,21,596169,9441,102743,5213,0.0874522953795991,0.35573904735908285
2668,0.4388,44,93,44,596262,9348,102787,5169,0.08659083330245655,0.35606530274850173
2669,0.4389,24,35,24,596297,9313,102811,5145,0.08626662714439216,0.3558583483192696
2670,0.439,16,46,16,596343,9267,102827,5129,0.08584052762236467,0.3562795220894693
2671,0.4391,31,73,31,596416,9194,102858,5098,0.08516432620697321,0.35670305065771063
2672,0.4392,24,45,24,596461,9149,102882,5074,0.08474748971803327,0.3567461154468115
2673,0.4393,42,66,42,596527,9083,102924,5032,0.0841361295342547,0.3565001771165427
2674,0.4394,24,60,24,596587,9023,102948,5008,0.08358034754900144,0.3569239541016321
2675,0.4395,20,29,20,596616,8994,102968,4988,0.08331171958946237,0.3567443856386783
2676,0.4396,22,72,22,596688,8922,102990,4966,0.08264478120715847,0.3575748847926267
2677,0.4397,31,42,31,596730,8880,103021,4935,0.08225573381748119,0.3572204125950054
2678,0.4398,17,20,17,596750,8860,103038,4918,0.08207047315573011,0.35694585571200466
2679,0.4399,28,74,28,596824,8786,103066,4890,0.0813850087072511,0.35756069026031
2680,0.44,10,26,10,596850,8760,103076,4880,0.08114416984697469,0.35777126099706746
2681,0.4401,15,34,15,596884,8726,103091,4865,0.08082922672199785,0.35795747185637555
2682,0.4402,29,23,29,596907,8703,103120,4836,0.08061617696098411,0.35719033902060715
2683,0.4403,15,35,15,596942,8668,103135,4821,0.08029197080291971,0.35740232782267034
2684,0.4404,29,34,29,596976,8634,103164,4792,0.07997702767794286,0.3569194100998063
2685,0.4405,24,47,24,597023,8587,103188,4768,0.07954166512282781,0.3570198427555223
2686,0.4406,18,24,18,597047,8563,103206,4750,0.07931935232872651,0.3567941110193044
2687,0.4407,24,32,24,597079,8531,103230,4726,0.07902293526992478,0.3564909104623972
2688,0.4408,36,76,36,597155,8455,103266,4690,0.07831894475527067,0.3567896538607836
2689,0.4409,23,35,23,597190,8420,103289,4667,0.07799473859720626,0.35661343317796285
2690,0.441,30,65,30,597255,8355,103319,4637,0.07739264144651525,0.3569119458128079
2691,0.4411,13,45,13,597300,8310,103332,4624,0.0769758049575753,0.3575073449822174
2692,0.4412,21,50,21,597350,8260,103353,4603,0.0765126533031976,0.3578480914250175
2693,0.4413,28,57,28,597407,8203,103381,4575,0.07598466041720701,0.3580372515260604
2694,0.4414,17,26,17,597433,8177,103398,4558,0.0757438215569306,0.35791126815861796
2695,0.4415,7,24,7,597457,8153,103405,4551,0.0755215087628293,0.35823362720403024
2696,0.4416,23,23,23,597480,8130,103428,4528,0.07530845900181556,0.35771843893190075
2697,0.4417,12,42,12,597522,8088,103440,4516,0.07491941161213828,0.3582989527134243
2698,0.4418,23,32,23,597554,8056,103463,4493,0.07462299455333654,0.35803649693202644
2699,0.4419,20,76,20,597630,7980,103483,4473,0.07391900403868243,0.3591905564924115
2700,0.442,17,33,17,597663,7947,103500,4456,0.07361332394679314,0.3592679190518423
2701,0.4421,28,45,28,597708,7902,103528,4428,0.0731964874578532,0.35912408759124087
2702,0.4422,17,41,17,597749,7861,103545,4411,0.07281670310126348,0.3594361147327249
2703,0.4423,20,48,20,597797,7813,103565,4391,0.07237207751306088,0.35980006555227795
2704,0.4424,39,95,39,597892,7718,103604,4352,0.07149208936974323,0.36056338028169016
2705,0.4425,15,39,15,597931,7679,103619,4337,0.07113083107932862,0.3609354194407457
2706,0.4426,14,25,14,597956,7654,103633,4323,0.07089925525213976,0.36094180512649243
2707,0.4427,30,61,30,598017,7593,103663,4293,0.07033421023379896,0.36118122160524985
2708,0.4428,9,44,9,598061,7549,103672,4284,0.06992663677794657,0.36203836727795147
2709,0.4429,12,32,12,598093,7517,103684,4272,0.06963021971914483,0.3623717024344728
2710,0.443,16,19,16,598112,7498,103700,4256,0.06945422209048131,0.36208950144631613
2711,0.4431,17,36,17,598148,7462,103717,4239,0.06912075289932935,0.3622767284847449
2712,0.4432,22,40,22,598188,7422,103739,4217,0.06875023157582719,0.3623163502019074
2713,0.4433,13,31,13,598219,7391,103752,4204,0.06846307755011301,0.3625700733074601
2714,0.4434,9,17,9,598236,7374,103761,4195,0.06830560598762458,0.36260696689428645
2715,0.4435,21,29,21,598265,7345,103782,4174,0.06803697802808552,0.36235784356280926
2716,0.4436,19,32,19,598297,7313,103801,4155,0.06774056096928378,0.36231252179979073
2717,0.4437,23,41,23,598338,7272,103824,4132,0.06736077661269406,0.36232900736583656
2718,0.4438,15,31,15,598369,7241,103839,4117,0.06707362258697988,0.36247578799084346
2719,0.4439,33,32,33,598401,7209,103872,4084,0.06677720552817815,0.3616399539537767
2720,0.444,29,59,29,598460,7150,103901,4055,0.06623068657601244,0.36189201249442216
2721,0.4441,22,49,22,598509,7101,103923,4033,0.0657767979547223,0.36222381893299804
2722,0.4442,25,40,25,598549,7061,103948,4008,0.06540627663122013,0.36209232993043633
2723,0.4443,17,26,17,598575,7035,103965,3991,0.06516543777094372,0.3619626337747143
2724,0.4444,32,38,32,598613,6997,103997,3959,0.06481344251361666,0.36135450894487037
2725,0.4445,20,36,20,598649,6961,104017,3939,0.0644799733224647,0.3613761467889908
2726,0.4446,20,42,20,598691,6919,104037,3919,0.06409092593278744,0.3615980808267208
2727,0.4447,19,63,19,598754,6856,104056,3900,0.06350735484827152,0.36258832279657865
2728,0.4448,7,54,7,598808,6802,104063,3893,0.06300715106154359,0.36400187003272555
2729,0.4449,25,42,25,598850,6760,104088,3868,0.06261810367186632,0.36394429808054196
2730,0.445,8,21,8,598871,6739,104096,3860,0.06242357997702768,0.36418530050004716
2731,0.4451,25,55,25,598926,6684,104121,3835,0.061914113157212194,0.36457838197547293
2732,0.4452,24,45,24,598971,6639,104145,3811,0.06149727666827226,0.364688995215311
2733,0.4453,13,19,13,598990,6620,104158,3798,0.06132127903960873,0.36456133614897296
2734,0.4454,20,38,20,599028,6582,104178,3778,0.06096928378228167,0.3646718146718147
2735,0.4455,12,34,12,599062,6548,104190,3766,0.06065434065730483,0.3651347682761295
2736,0.4456,7,19,7,599081,6529,104197,3759,0.0604783430286413,0.36537713841368585
2737,0.4457,27,43,27,599124,6486,104224,3732,0.060080032605876466,0.36523781561949503
2738,0.4458,23,46,23,599170,6440,104247,3709,0.059653933083848976,0.3654547246034092
2739,0.4459,25,56,25,599226,6384,104272,3684,0.05913520323094594,0.36591179976162097
2740,0.446,39,72,39,599298,6312,104311,3645,0.05846826484864204,0.366074118710455
2741,0.4461,27,45,27,599343,6267,104338,3618,0.058051428359702104,0.36600910470409714
2742,0.4462,11,22,11,599365,6245,104349,3607,0.05784764163177591,0.36611855460820136
2743,0.4463,14,30,14,599395,6215,104363,3593,0.057569750639149285,0.3663336052202284
2744,0.4464,14,24,14,599419,6191,104377,3579,0.057347437845047984,0.36632548618219035
2745,0.4465,20,27,20,599446,6164,104397,3559,0.05709733595168402,0.3660392882855086
2746,0.4466,9,36,9,599482,6128,104406,3550,0.05676386676053207,0.3668113246538541
2747,0.4467,19,43,19,599525,6085,104425,3531,0.05636555633776724,0.36720049916805325
2748,0.4468,25,38,25,599563,6047,104450,3506,0.05601356108044018,0.3670051292787606
2749,0.4469,36,76,36,599639,5971,104486,3470,0.05530957056578606,0.36754581082512444
2750,0.447,22,38,22,599677,5933,104508,3448,0.054957575308459,0.3675514337490673
2751,0.4471,14,36,14,599713,5897,104522,3434,0.05462410611730705,0.3680205765727146
2752,0.4472,21,33,21,599746,5864,104543,3413,0.05431842602541776,0.36789910531421793
2753,0.4473,12,29,12,599775,5835,104555,3401,0.054049798065878694,0.36823300129926373
2754,0.4474,24,39,24,599814,5796,104579,3377,0.053688539775464075,0.3681456448272103
2755,0.4475,15,20,15,599834,5776,104594,3362,0.05350327911371299,0.36791420442109873
2756,0.4476,22,38,22,599872,5738,104616,3340,0.053151283856385935,0.36792244987882794
2757,0.4477,21,29,21,599901,5709,104637,3319,0.05288265589684686,0.36763402747009305
2758,0.4478,19,33,19,599934,5676,104656,3300,0.05257697580495758,0.36764705882352944
2759,0.4479,29,43,29,599977,5633,104685,3271,0.05217866538219274,0.36736298292902064
2760,0.448,14,19,14,599996,5614,104699,3257,0.052002667753529214,0.36715139217675574
2761,0.4481,15,18,15,600014,5596,104714,3242,0.05183593315795324,0.36682507354605115
2762,0.4482,15,31,15,600045,5565,104729,3227,0.05154877913223906,0.36703821656050956
2763,0.4483,15,20,15,600065,5545,104744,3212,0.05136351847048798,0.3667922804613452
2764,0.4484,15,40,15,600105,5505,104759,3197,0.05099299714698581,0.3673868076304298
2765,0.4485,24,25,24,600130,5480,104783,3173,0.050761421319796954,0.36669363226626606
2766,0.4486,16,27,16,600157,5453,104799,3157,0.05051131942643299,0.36666666666666664
2767,0.4487,13,25,13,600182,5428,104812,3144,0.050279743599244135,0.3667755482967802
2768,0.4488,26,38,26,600220,5390,104838,3118,0.04992774834191708,0.36647860836859425
2769,0.4489,16,43,16,600263,5347,104854,3102,0.04952943791915225,0.3671440407148775
2770,0.449,19,32,19,600295,5315,104873,3083,0.049233020860350515,0.3671112169564182
2771,0.4491,13,16,13,600311,5299,104886,3070,0.04908481233094965,0.366829967738081
2772,0.4492,32,42,32,600353,5257,104918,3038,0.04869576494127237,0.3662447257383966
2773,0.4493,24,34,24,600387,5223,104942,3014,0.04838082181629553,0.3659099186597062
2774,0.4494,24,31,24,600418,5192,104966,2990,0.04809366779058135,0.3654363236372525
2775,0.4495,13,27,13,600445,5165,104979,2977,0.04784356589721739,0.36563497912060916
2776,0.4496,19,27,19,600472,5138,104998,2958,0.04759346400385342,0.3653656126482213
2777,0.4497,21,36,21,600508,5102,105019,2937,0.04725999481270147,0.3653439482522702
2778,0.4498,19,18,19,600526,5084,105038,2918,0.047093260217125496,0.3646588352911772
2779,0.4499,10,26,10,600552,5058,105048,2908,0.04685242135684908,0.36505146874215416
2780,0.45,11,19,11,600571,5039,105059,2897,0.046676423728185555,0.3650453629032258
2781,0.4501,16,17,16,600588,5022,105075,2881,0.04651895216569714,0.3645451094521068
2782,0.4502,14,25,14,600613,4997,105089,2867,0.04628737633850828,0.36457273652085453
2783,0.4503,15,23,15,600636,4974,105104,2852,0.04607432657749454,0.3644262714030156
2784,0.4504,20,53,20,600689,4921,105124,2832,0.04558338582385416,0.36527795691990195
2785,0.4505,20,42,20,600731,4879,105144,2812,0.04519433843417689,0.36562215576648033
2786,0.4506,18,22,18,600753,4857,105162,2794,0.044990551706250693,0.36518102208861586
2787,0.4507,15,33,15,600786,4824,105177,2779,0.0446848716143614,0.36551361304748126
2788,0.4508,9,21,9,600807,4803,105186,2770,0.04449034791952277,0.36577314142347817
2789,0.4509,19,30,19,600837,4773,105205,2751,0.04421245692689614,0.3656299840510367
2790,0.451,10,33,10,600870,4740,105215,2741,0.04390677683500686,0.36639486699639084
2791,0.4511,10,22,10,600892,4718,105225,2731,0.04370299010708066,0.3666263928044033
2792,0.4512,14,23,14,600915,4695,105239,2717,0.043489940346066916,0.36656772800863463
2793,0.4513,15,23,15,600938,4672,105254,2702,0.04327689058505317,0.36642256577163007
2794,0.4514,24,57,24,600995,4615,105278,2678,0.04274889769906258,0.3672014260249554
2795,0.4515,10,29,10,601024,4586,105288,2668,0.04248026973952351,0.3677970774744968
2796,0.4516,11,18,11,601042,4568,105299,2657,0.042313535143947534,0.36775086505190313
2797,0.4517,20,34,20,601076,4534,105319,2637,0.041998592018970694,0.36773113931111423
2798,0.4518,5,15,5,601091,4519,105324,2632,0.041859646522657376,0.3680604111313103
2799,0.4519,12,30,12,601121,4489,105336,2620,0.04158175553003075,0.36854691236460824
2800,0.452,13,20,13,601141,4469,105349,2607,0.04139649486827967,0.36842849067269645
2801,0.4521,18,32,18,601173,4437,105367,2589,0.041100077809477935,0.36848847139197266
2802,0.4522,11,19,11,601192,4418,105378,2578,0.04092408018081441,0.3684962835906232
2803,0.4523,30,34,30,601226,4384,105408,2548,0.04060913705583756,0.36757068667051357
2804,0.4524,16,21,16,601247,4363,105424,2532,0.04041461336099893,0.3672226250906454
2805,0.4525,6,18,6,601265,4345,105430,2526,0.04024787876542295,0.36763207684470967
2806,0.4526,13,29,13,601294,4316,105443,2513,0.03997925080588388,0.3679894567286572
2807,0.4527,8,15,8,601309,4301,105451,2505,0.03984030530957056,0.368057596238613
2808,0.4528,19,35,19,601344,4266,105470,2486,0.03951609915150617,0.3681872037914692
2809,0.4529,18,28,18,601372,4238,105488,2468,0.03925673422505465,0.3680286310766478
2810,0.453,30,55,30,601427,4183,105518,2438,0.03874726740523917,0.36822232291194684
2811,0.4531,13,37,13,601464,4146,105531,2425,0.03840453518099966,0.369045807335261
2812,0.4532,19,57,19,601521,4089,105550,2406,0.03787654229500908,0.37043879907621247
2813,0.4533,5,16,5,601537,4073,105555,2401,0.03772833376560821,0.3708680877355576
2814,0.4534,8,22,8,601559,4051,105563,2393,0.037524547037682016,0.3713531967721912
2815,0.4535,15,29,15,601588,4022,105578,2378,0.03725591907814295,0.3715625
2816,0.4536,7,25,7,601613,3997,105585,2371,0.03702434325095409,0.37233040201005024
2817,0.4537,17,41,17,601654,3956,105602,2354,0.03664455889436437,0.37305863708399367
2818,0.4538,11,32,11,601686,3924,105613,2343,0.03634814183556263,0.37386309238870274
2819,0.4539,6,12,6,601698,3912,105619,2337,0.03623698543851198,0.3739798367738838
2820,0.454,11,15,11,601713,3897,105630,2326,0.03609803994219867,0.37377470673308694
2821,0.4541,20,30,20,601743,3867,105650,2306,0.03582014894957205,0.3735622873805281
2822,0.4542,12,22,12,601765,3845,105662,2294,0.03561636222164585,0.3736764945430852
2823,0.4543,18,22,18,601787,3823,105680,2276,0.035412575493719664,0.37317593048040665
2824,0.4544,12,20,12,601807,3803,105692,2264,0.03522731483196858,0.37316630954343166
2825,0.4545,18,39,18,601846,3764,105710,2246,0.03486605654155397,0.37371048252911815
2826,0.4546,11,22,11,601868,3742,105721,2235,0.03466226981362777,0.37393341141040654
2827,0.4547,14,29,14,601897,3713,105735,2221,0.034393641854088705,0.37428378833838893
2828,0.4548,16,14,16,601911,3699,105751,2205,0.03426395939086294,0.37347560975609756
2829,0.4549,6,16,6,601927,3683,105757,2199,0.034115750861462076,0.37385243114586875
2830,0.455,16,22,16,601949,3661,105773,2183,0.033911964133535887,0.37354551676933606
2831,0.4551,10,22,10,601971,3639,105783,2173,0.03370817740560969,0.37388162422573984
2832,0.4552,9,10,9,601981,3629,105792,2164,0.03361554707473415,0.3735542896599344
2833,0.4553,12,22,12,602003,3607,105804,2152,0.033411760346807956,0.3736759854141344
2834,0.4554,4,13,4,602016,3594,105808,2148,0.03329134091666976,0.37408568443051204
2835,0.4555,28,42,28,602058,3552,105836,2120,0.03290229352699248,0.37376586741889983
2836,0.4556,11,27,11,602085,3525,105847,2109,0.032652191633628515,0.37433439829605963
2837,0.4557,10,11,10,602096,3514,105857,2099,0.03255029826966542,0.37395332264386244
2838,0.4558,1,8,1,602104,3506,105858,2098,0.03247619400496499,0.37437544610992146
2839,0.4559,16,25,16,602129,3481,105874,2082,0.03224461817777613,0.3742584936185511
2840,0.456,14,19,14,602148,3462,105888,2068,0.0320686205491126,0.3739602169981917
2841,0.4561,19,21,19,602169,3441,105907,2049,0.03187409685427396,0.373224043715847
2842,0.4562,12,16,12,602185,3425,105919,2037,0.031725888324873094,0.3729403149029659
2843,0.4563,4,14,4,602199,3411,105923,2033,0.03159620586164734,0.3734386480529023
2844,0.4564,8,25,8,602224,3386,105931,2025,0.03136463003445848,0.3742376640177416
2845,0.4565,7,22,7,602246,3364,105938,2018,0.03116084330653229,0.3749535488665923
2846,0.4566,6,14,6,602260,3350,105944,2012,0.03103116084330653,0.3752331219694144
2847,0.4567,6,11,6,602271,3339,105950,2006,0.030929267479343436,0.3753040224508887
2848,0.4568,11,22,11,602293,3317,105961,1995,0.030725480751417244,0.37556475903614456
2849,0.4569,22,37,22,602330,3280,105983,1973,0.03038274852717774,0.3755948981534361
2850,0.457,8,17,8,602347,3263,105991,1965,0.030225276964689317,0.37586074980872225
2851,0.4571,14,21,14,602368,3242,106005,1951,0.03003075326985068,0.3756980550741383
2852,0.4572,16,15,16,602383,3227,106021,1935,0.029891807773537366,0.3748547074777218
2853,0.4573,12,37,12,602420,3190,106033,1923,0.02954907554929786,0.3761001369059261
2854,0.4574,7,14,7,602434,3176,106040,1916,0.029419393086072103,0.3762765121759623
2855,0.4575,12,18,12,602452,3158,106052,1904,0.029252658490496127,0.37613591465823787
2856,0.4576,7,24,7,602476,3134,106059,1897,0.029030345696394826,0.3770622142715166
2857,0.4577,14,26,14,602502,3108,106073,1883,0.028789506836118417,0.37727910238429174
2858,0.4578,16,20,16,602522,3088,106089,1867,0.028604246174367336,0.3767911200807265
2859,0.4579,4,25,4,602547,3063,106093,1863,0.02837267034717848,0.3781973203410475
2860,0.458,7,11,7,602558,3052,106100,1856,0.028270776983215385,0.378158109209454
2861,0.4581,17,20,17,602578,3032,106117,1839,0.0280855163214643,0.37754054608909876
2862,0.4582,6,18,6,602596,3014,106123,1833,0.027918781725888325,0.37817206519496593
2863,0.4583,6,11,6,602607,3003,106129,1827,0.027816888361925227,0.3782608695652174
2864,0.4584,10,20,10,602627,2983,106139,1817,0.027631627700174147,0.37854166666666667
2865,0.4585,12,28,12,602655,2955,106151,1805,0.02737226277372263,0.3792016806722689
2866,0.4586,19,33,19,602688,2922,106170,1786,0.02706658268183334,0.37935429056924386
2867,0.4587,9,10,9,602698,2912,106179,1777,0.026973952350957797,0.37897206227340585
2868,0.4588,4,13,4,602711,2899,106183,1773,0.026853532920819594,0.3794948630136986
2869,0.4589,7,14,7,602725,2885,106190,1766,0.026723850457593835,0.37970328961513655
2870,0.459,19,29,19,602754,2856,106209,1747,0.026455222498054765,0.37953508581359985
2871,0.4591,16,13,16,602767,2843,106225,1731,0.026334803067916558,0.3784433756012243
2872,0.4592,5,11,5,602778,2832,106230,1726,0.026232909703953464,0.3786748573935937
2873,0.4593,12,14,12,602792,2818,106242,1714,0.026103227240727705,0.37819947043248014
2874,0.4594,3,6,3,602798,2812,106245,1711,0.02604764904220238,0.3782887464072518
2875,0.4595,12,15,12,602813,2797,106257,1699,0.025908703545889065,0.3778914590747331
2876,0.4596,12,15,12,602828,2782,106269,1687,0.025769758049575753,0.37748937122398746
2877,0.4597,4,8,4,602836,2774,106273,1683,0.02569565378487532,0.37760825667489345
2878,0.4598,15,23,15,602859,2751,106288,1668,0.025482604023861575,0.3774609640190088
2879,0.4599,5,4,5,602863,2747,106293,1663,0.025445551891511358,0.37709750566893424
2880,0.46,4,29,4,602892,2718,106297,1659,0.025176923931972284,0.37902673063742287
2881,0.4601,14,29,14,602921,2689,106311,1645,0.024908295972433214,0.3795569912321181
2882,0.4602,2,5,2,602926,2684,106313,1643,0.02486198080699544,0.37970880517679684
2883,0.4603,10,9,10,602935,2675,106323,1633,0.024778613509207455,0.3790622098421541
2884,0.4604,2,4,2,602939,2671,106325,1631,0.02474156137685724,0.37912598791259877
2885,0.4605,11,17,11,602956,2654,106336,1620,0.024584089814368815,0.37903603182030887
2886,0.4606,4,11,4,602967,2643,106340,1616,0.02448219645040572,0.3794317915003522
2887,0.4607,3,13,3,602980,2630,106343,1613,0.024361777020267518,0.3801555503181711
2888,0.4608,9,16,9,602996,2614,106352,1604,0.02421356849086665,0.38027501185395923
2889,0.4609,6,13,6,603009,2601,106358,1598,0.024093149060728444,0.3805668016194332
2890,0.461,11,25,11,603034,2576,106369,1587,0.02386157323353959,0.3812154696132597
2891,0.4611,13,25,13,603059,2551,106382,1574,0.023629997406350734,0.38157575757575757
2892,0.4612,13,28,13,603087,2523,106395,1561,0.02337063247989922,0.38222331047992164
2893,0.4613,6,16,6,603103,2507,106401,1555,0.023222423950498353,0.3828163466272772
2894,0.4614,11,15,11,603118,2492,106412,1544,0.023083478454185038,0.38255698711595637
2895,0.4615,6,17,6,603135,2475,106418,1538,0.022926006891696618,0.38325442312484426
2896,0.4616,5,13,5,603148,2462,106423,1533,0.02280558746155841,0.383729662077597
2897,0.4617,5,11,5,603159,2451,106428,1528,0.022703694097595317,0.38401608444332747
2898,0.4618,13,22,13,603181,2429,106441,1515,0.022499907369669125,0.3841277890466531
2899,0.4619,12,23,12,603204,2406,106453,1503,0.02228685760865538,0.3844973138910207
2900,0.462,9,12,9,603216,2394,106462,1494,0.02217570121160473,0.38425925925925924
2901,0.4621,4,10,4,603226,2384,106466,1490,0.022083070880729187,0.38461538461538464
2902,0.4622,7,11,7,603237,2373,106473,1483,0.02198117751676609,0.3845954356846473
2903,0.4623,7,10,7,603247,2363,106480,1476,0.021888547185890547,0.38447512373013804
2904,0.4624,2,10,2,603257,2353,106482,1474,0.021795916855015005,0.38515808727462764
2905,0.4625,9,8,9,603265,2345,106491,1465,0.02172181259031457,0.38451443569553806
2906,0.4626,9,14,9,603279,2331,106500,1456,0.021592130127088813,0.3844731977818854
2907,0.4627,5,7,5,603286,2324,106505,1451,0.021527288895475935,0.38437086092715234
2908,0.4628,13,12,13,603298,2312,106518,1438,0.021416132498425285,0.3834666666666667
2909,0.4629,14,29,14,603327,2283,106532,1424,0.021147504538886214,0.38413811707580253
2910,0.463,6,18,6,603345,2265,106538,1418,0.02098076994331024,0.3850122183002987
2911,0.4631,7,19,7,603364,2246,106545,1411,0.020804772314646707,0.3858353841946951
2912,0.4632,10,18,10,603382,2228,106555,1401,0.02063803771907073,0.38605676494902175
2913,0.4633,4,6,4,603388,2222,106559,1397,0.020582459520545406,0.3860182370820669
2914,0.4634,8,9,8,603397,2213,106567,1389,0.02049909222275742,0.38561910049972237
2915,0.4635,15,20,15,603417,2193,106582,1374,0.020313831561006336,0.38519764507989906
2916,0.4636,6,11,6,603428,2182,106588,1368,0.02021193819704324,0.38535211267605635
2917,0.4637,5,10,5,603438,2172,106593,1363,0.0201193078661677,0.3855728429985856
2918,0.4638,7,12,7,603450,2160,106600,1356,0.02000815146911705,0.3856655290102389
2919,0.4639,4,13,4,603463,2147,106604,1352,0.019887732038978843,0.3863961131751929
2920,0.464,18,16,18,603479,2131,106622,1334,0.019739523509577975,0.384992784992785
2921,0.4641,9,16,9,603495,2115,106631,1325,0.019591314980177108,0.3851744186046512
2922,0.4642,4,6,4,603501,2109,106635,1321,0.019535736781651783,0.38513119533527695
2923,0.4643,6,9,6,603510,2100,106641,1315,0.019452369483863797,0.3850658857979502
2924,0.4644,9,18,9,603528,2082,106650,1306,0.01928563488828782,0.3854781582054309
2925,0.4645,5,13,5,603541,2069,106655,1301,0.019165215458149615,0.38605341246290803
2926,0.4646,8,11,8,603552,2058,106663,1293,0.01906332209418652,0.38585496866606983
2927,0.4647,7,13,7,603565,2045,106670,1286,0.018942902664048317,0.3860702491744221
2928,0.4648,18,23,18,603588,2022,106688,1268,0.01872985290303457,0.38541033434650457
2929,0.4649,7,19,7,603607,2003,106695,1261,0.01855385527437104,0.3863357843137255
2930,0.465,9,18,9,603625,1985,106704,1252,0.018387120678795065,0.3867778807537844
2931,0.4651,2,5,2,603630,1980,106706,1250,0.018340805513357292,0.38699690402476783
2932,0.4652,6,7,6,603637,1973,106712,1244,0.018275964281744415,0.38669567920422754
2933,0.4653,2,12,2,603649,1961,106714,1242,0.018164807884693764,0.3877614736184827
2934,0.4654,7,10,7,603659,1951,106721,1235,0.018072177553818222,0.38763339610797237
2935,0.4655,16,22,16,603681,1929,106737,1219,0.01786839082589203,0.3872299872935197
2936,0.4656,4,22,4,603703,1907,106741,1215,0.017664604097965837,0.3891736066623959
2937,0.4657,5,5,5,603708,1902,106746,1210,0.017618288932528068,0.38881748071979433
2938,0.4658,8,17,8,603725,1885,106754,1202,0.017460817370039645,0.38937479753806287
2939,0.4659,3,8,3,603733,1877,106757,1199,0.01738671310533921,0.3897919375812744
2940,0.466,11,9,11,603742,1868,106768,1188,0.017303345807551225,0.3887434554973822
2941,0.4661,11,16,11,603758,1852,106779,1177,0.017155137278150358,0.3885770881479036
2942,0.4662,15,6,15,603764,1846,106794,1162,0.017099559079625033,0.3863031914893617
2943,0.4663,2,4,2,603768,1842,106796,1160,0.017062506947274816,0.3864090606262492
2944,0.4664,2,2,2,603770,1840,106798,1158,0.017043980881099707,0.38625750500333556
2945,0.4665,1,7,1,603777,1833,106799,1157,0.01697913964948683,0.3869565217391304
2946,0.4666,3,2,3,603779,1831,106802,1154,0.01696061358331172,0.3865996649916248
2947,0.4667,17,20,17,603799,1811,106819,1137,0.016775352921560637,0.385685210312076
2948,0.4668,8,16,8,603815,1795,106827,1129,0.01662714439215977,0.38611491108071133
2949,0.4669,4,15,4,603830,1780,106831,1125,0.016488198895846455,0.387263339070568
2950,0.467,1,5,1,603835,1775,106832,1124,0.016441883730408686,0.3877199034149707
2951,0.4671,6,16,6,603851,1759,106838,1118,0.01629367520100782,0.3885992353145638
2952,0.4672,5,3,5,603854,1756,106843,1113,0.016265886101745154,0.3879400487974904
2953,0.4673,5,11,5,603865,1745,106848,1108,0.01616399273778206,0.38836312653347355
2954,0.4674,7,13,7,603878,1732,106855,1101,0.016043573307643853,0.38863395693611014
2955,0.4675,1,12,1,603890,1720,106856,1100,0.015932416910593206,0.3900709219858156
2956,0.4676,7,8,7,603898,1712,106863,1093,0.015858312645892773,0.38966131907308377
2957,0.4677,5,11,5,603909,1701,106868,1088,0.015756419281929675,0.39010397992111867
2958,0.4678,12,19,12,603928,1682,106880,1076,0.015580421653266145,0.39013778100072516
2959,0.4679,5,10,5,603938,1672,106885,1071,0.015487791322390603,0.3904484141450966
2960,0.468,2,7,2,603945,1665,106887,1069,0.015422950090777725,0.39100219458668617
2961,0.4681,8,16,8,603961,1649,106895,1061,0.015274741561376858,0.3915129151291513
2962,0.4682,5,28,5,603989,1621,106900,1056,0.01501537663492534,0.39447142323496454
2963,0.4683,2,4,2,603993,1617,106902,1054,0.014978324502575123,0.3946087607637589
2964,0.4684,10,14,10,604007,1603,106912,1044,0.014848642039349364,0.3944087646392142
2965,0.4685,0,8,0,604015,1595,106912,1044,0.01477453777464893,0.3956043956043956
2966,0.4686,5,20,5,604035,1575,106917,1039,0.014589277112897847,0.3974751338944147
2967,0.4687,6,10,6,604045,1565,106923,1033,0.014496646782022305,0.3976135488837567
2968,0.4688,5,13,5,604058,1552,106928,1028,0.0143762273518841,0.3984496124031008
2969,0.4689,15,18,15,604076,1534,106943,1013,0.014209492756308126,0.397722811150373
2970,0.469,7,10,7,604086,1524,106950,1006,0.014116862425432584,0.3976284584980237
2971,0.4691,1,4,1,604090,1520,106951,1005,0.014079810293082367,0.39801980198019804
2972,0.4692,5,2,5,604092,1518,106956,1000,0.014061284226907259,0.3971405877680699
2973,0.4693,2,7,2,604099,1511,106958,998,0.01399644299529438,0.39776803507373454
2974,0.4694,2,3,2,604102,1508,106960,996,0.013968653896031717,0.3977635782747604
2975,0.4695,2,5,2,604107,1503,106962,994,0.013922338730593946,0.39807769323187825
2976,0.4696,5,14,5,604121,1489,106967,989,0.013792656267368187,0.39911218724778047
2977,0.4697,3,3,3,604124,1486,106970,986,0.013764867168105524,0.3988673139158576
2978,0.4698,4,8,4,604132,1478,106974,982,0.01369076290340509,0.3991869918699187
2979,0.4699,8,8,8,604140,1470,106982,974,0.013616658638704657,0.3985270049099836
2980,0.47,10,18,10,604158,1452,106992,964,0.013449924043128681,0.3990066225165563
2981,0.4701,16,18,16,604176,1434,107008,948,0.013283189447552708,0.3979848866498741
2982,0.4702,9,9,9,604185,1425,107017,939,0.01319982214976472,0.39720812182741116
2983,0.4703,4,11,4,604196,1414,107021,935,0.013097928785801623,0.39804171988080034
2984,0.4704,5,14,5,604210,1400,107026,930,0.012968246322575865,0.39914163090128757
2985,0.4705,8,16,8,604226,1384,107034,922,0.012820037793174997,0.3998265394622723
2986,0.4706,4,9,4,604235,1375,107038,918,0.01273667049538701,0.40034888791975576
2987,0.4707,1,9,1,604244,1366,107039,917,0.012653303197599022,0.401664476565922
2988,0.4708,4,12,4,604256,1354,107043,913,0.012542146800548371,0.4027348919276577
2989,0.4709,6,11,6,604267,1343,107049,907,0.012440253436585275,0.4031111111111111
2990,0.471,9,6,9,604273,1337,107058,898,0.01238467523805995,0.40178970917225953
2991,0.4711,3,7,3,604280,1330,107061,895,0.01231983400644707,0.40224719101123596
2992,0.4712,1,1,1,604281,1329,107062,894,0.012310570973359516,0.40215924426450744
2993,0.4713,5,6,5,604287,1323,107067,889,0.012254992774834191,0.40189873417721517
2994,0.4714,15,28,15,604315,1295,107082,874,0.011995627848382675,0.4029506685108345
2995,0.4715,0,2,0,604317,1293,107082,874,0.011977101782207566,0.40332256575911396
2996,0.4716,4,6,4,604323,1287,107086,870,0.011921523583682241,0.40333796940194716
2997,0.4717,8,12,8,604335,1275,107094,862,0.01181036718663159,0.4033692091717361
2998,0.4718,2,4,2,604339,1271,107096,860,0.011773315054281374,0.40356640075082123
2999,0.4719,4,4,4,604343,1267,107100,856,0.011736262921931157,0.4032030146019783
3000,0.472,2,8,2,604351,1259,107102,854,0.011662158657230724,0.4041646947468055
3001,0.4721,4,13,4,604364,1246,107106,850,0.011541739227092519,0.40553435114503816
3002,0.4722,4,3,4,604367,1243,107110,846,0.011513950127829856,0.40497845859262804
3003,0.4723,1,5,1,604372,1238,107111,845,0.011467634962392085,0.4056649063850216
3004,0.4725,8,12,8,604384,1226,107119,837,0.011356478565341435,0.40571982549684926
3005,0.4726,10,17,10,604401,1209,107129,827,0.011199007002853013,0.406188605108055
3006,0.4727,5,6,5,604407,1203,107134,822,0.01114342880432769,0.4059259259259259
3007,0.4728,4,6,4,604413,1197,107138,818,0.011087850605802365,0.40595533498759306
3008,0.4729,2,2,2,604415,1195,107140,816,0.011069324539627256,0.40576827449030334
3009,0.473,8,4,8,604419,1191,107148,808,0.01103227240727704,0.4042021010505253
3010,0.4731,8,9,8,604428,1182,107156,800,0.010948905109489052,0.4036326942482341
3011,0.4732,2,0,2,604428,1182,107158,798,0.010948905109489052,0.403030303030303
3012,0.4733,20,25,20,604453,1157,107178,778,0.010717329282300197,0.4020671834625323
3013,0.4734,1,2,1,604455,1155,107179,777,0.010698803216125088,0.40217391304347827
3014,0.4735,3,5,3,604460,1150,107182,774,0.010652488050687317,0.4022869022869023
3015,0.4736,3,1,3,604461,1149,107185,771,0.010643225017599763,0.4015625
3016,0.4737,4,1,4,604462,1148,107189,767,0.010633961984512209,0.40052219321148824
3017,0.4738,7,15,7,604477,1133,107196,760,0.010495016488198896,0.40147913365029053
3018,0.4739,4,14,4,604491,1119,107200,756,0.010365334024973137,0.4032
3019,0.474,1,2,1,604493,1117,107201,755,0.010346807958798028,0.4033119658119658
3020,0.4741,6,6,6,604499,1111,107207,749,0.010291229760272703,0.4026881720430108
3021,0.4742,5,8,5,604507,1103,107212,744,0.01021712549557227,0.402815376285869
3022,0.4743,7,5,7,604512,1098,107219,737,0.010170810330134498,0.4016348773841962
3023,0.4744,15,21,15,604533,1077,107234,722,0.009976286635295862,0.4013340744858255
3024,0.4745,7,16,7,604549,1061,107241,715,0.009828078105894995,0.4025900900900901
3025,0.4746,5,12,5,604561,1049,107246,710,0.009716921708844344,0.40363843092666285
3026,0.4747,8,14,8,604575,1035,107254,702,0.009587239245618585,0.40414507772020725
3027,0.4748,5,3,5,604578,1032,107259,697,0.009559450146355923,0.4031231925968768
3028,0.4749,6,11,6,604589,1021,107265,691,0.009457556782392827,0.4036214953271028
3029,0.475,1,6,1,604595,1015,107266,690,0.009401978583867501,0.4046920821114369
3030,0.4751,6,6,6,604601,1009,107272,684,0.009346400385342176,0.40401653868871823
3031,0.4752,1,5,1,604606,1004,107273,683,0.009300085219904405,0.4048606994665086
3032,0.4753,11,31,11,604637,973,107284,672,0.009012931194190226,0.4085106382978723
3033,0.4754,4,4,4,604641,969,107288,668,0.00897587906184001,0.40806353084911423
3034,0.4755,12,6,12,604647,963,107300,656,0.008920300863314684,0.4051883878937616
3035,0.4756,7,8,7,604655,955,107307,649,0.00884619659861425,0.40461346633416456
3036,0.4757,5,12,5,604667,943,107312,644,0.0087350402015636,0.4057971014492754
3037,0.4758,1,0,1,604667,943,107313,643,0.0087350402015636,0.40542244640605296
3038,0.4759,0,3,0,604670,940,107313,643,0.008707251102300938,0.4061907770056854
3039,0.476,4,7,4,604677,933,107317,639,0.008642409870688058,0.4064885496183206
3040,0.4761,2,1,2,604678,932,107319,637,0.008633146837600504,0.4059910771191842
3041,0.4762,1,4,1,604682,928,107320,636,0.008596094705250287,0.40664961636828645
3042,0.4763,4,18,4,604700,910,107324,632,0.008429360109674312,0.4098573281452659
3043,0.4764,4,12,4,604712,898,107328,628,0.008318203712623661,0.41153342070773263
3044,0.4765,1,7,1,604719,891,107329,627,0.008253362481010782,0.41304347826086957
3045,0.4766,1,2,1,604721,889,107330,626,0.008234836414835673,0.4132013201320132
3046,0.4767,8,8,8,604729,881,107338,618,0.00816073215013524,0.4122748498999333
3047,0.4768,8,7,8,604736,874,107346,610,0.00809589091852236,0.4110512129380054
3048,0.4769,5,3,5,604739,871,107351,605,0.008068101819259698,0.40989159891598914
3049,0.477,4,4,4,604743,867,107355,601,0.00803104968690948,0.4094005449591281
3050,0.4771,7,5,7,604748,862,107362,594,0.00798473452147171,0.40796703296703296
3051,0.4772,1,4,1,604752,858,107363,593,0.007947682389121495,0.40868366643694004
3052,0.4773,13,13,13,604765,845,107376,580,0.00782726295898329,0.4070175438596491
3053,0.4774,2,5,2,604770,840,107378,578,0.007780947793545518,0.4076163610719323
3054,0.4775,5,13,5,604783,827,107383,573,0.0076605283634073144,0.4092857142857143
3055,0.4776,2,5,2,604788,822,107385,571,0.007614213197969543,0.40990667623833454
3056,0.4777,7,6,7,604794,816,107392,564,0.007558634999444218,0.40869565217391307
3057,0.4778,3,5,3,604799,811,107395,561,0.007512319834006447,0.40889212827988336
3058,0.4779,1,2,1,604801,809,107396,560,0.007493793767831339,0.40905770635500366
3059,0.478,2,1,2,604802,808,107398,558,0.0074845307347437846,0.4084919472913616
3060,0.4781,9,7,9,604809,801,107407,549,0.007419689503130905,0.4066666666666667
3061,0.4782,2,13,2,604822,788,107409,547,0.0072992700729927005,0.40973782771535583
3062,0.4783,3,1,3,604823,787,107412,544,0.007290007039905146,0.4087152516904583
3063,0.4784,3,4,3,604827,783,107415,541,0.0072529549075549295,0.4086102719033233
3064,0.4785,3,4,3,604831,779,107418,538,0.007215902775204713,0.4085041761579347
3065,0.4786,3,9,3,604840,770,107421,535,0.007132535477416726,0.4099616858237548
3066,0.4787,0,5,0,604845,765,107421,535,0.007086220311978955,0.4115384615384615
3067,0.4788,2,2,2,604847,763,107423,533,0.007067694245803846,0.4112654320987654
3068,0.4789,6,5,6,604852,758,107429,527,0.007021379080366075,0.4101167315175097
3069,0.479,5,8,5,604860,750,107434,522,0.006947274815665642,0.41037735849056606
3070,0.4791,6,9,6,604869,741,107440,516,0.006863907517877654,0.4105011933174224
3071,0.4792,3,12,3,604881,729,107443,513,0.006752751120827003,0.41304347826086957
3072,0.4793,5,8,5,604889,721,107448,508,0.00667864685612657,0.41334418226200165
3073,0.4794,2,1,2,604890,720,107450,506,0.0066693838230390155,0.41272430668841764
3074,0.4795,4,1,4,604891,719,107454,502,0.006660120789951461,0.41113841113841115
3075,0.4796,1,2,1,604893,717,107455,501,0.006641594723776354,0.41133004926108374
3076,0.4798,4,7,4,604900,710,107459,497,0.006576753492163474,0.4117647058823529
3077,0.4799,8,28,8,604928,682,107467,489,0.006317388565711957,0.4175918018787361
3078,0.48,1,4,1,604932,678,107468,488,0.00628033643336174,0.41852487135506006
3079,0.4801,0,4,0,604936,674,107468,488,0.006243284301011523,0.4199655765920826
3080,0.4802,7,4,7,604940,670,107475,481,0.006206232168661306,0.41789748045178104
3081,0.4803,7,14,7,604954,656,107482,474,0.006076549705435548,0.4194690265486726
3082,0.4804,1,1,1,604955,655,107483,473,0.006067286672347994,0.41932624113475175
3083,0.4805,1,2,1,604957,653,107484,472,0.006048760606172886,0.41955555555555557
3084,0.4806,2,3,2,604960,650,107486,470,0.006020971506910223,0.41964285714285715
3085,0.4807,3,0,3,604960,650,107489,467,0.006020971506910223,0.41808415398388543
3086,0.4808,4,3,4,604963,647,107493,463,0.00599318240764756,0.41711711711711713
3087,0.4809,2,5,2,604968,642,107495,461,0.005946867242209789,0.41795104261106075
3088,0.481,10,16,10,604984,626,107505,451,0.005798658712808922,0.41875580315691735
3089,0.4811,1,6,1,604990,620,107506,450,0.005743080514283597,0.4205607476635514
3090,0.4813,2,5,2,604995,615,107508,448,0.005696765348845826,0.42144873000940736
3091,0.4814,3,2,3,604997,613,107511,445,0.005678239282670717,0.42060491493383745
3092,0.4815,8,10,8,605007,603,107519,437,0.005585608951795175,0.4201923076923077
3093,0.4816,1,5,1,605012,598,107520,436,0.005539293786357405,0.42166344294003866
3094,0.4817,10,15,10,605027,583,107530,426,0.005400348290044092,0.4222001982160555
3095,0.4818,1,2,1,605029,581,107531,425,0.005381822223868984,0.4224652087475149
3096,0.4819,1,0,1,605029,581,107532,424,0.005381822223868984,0.4218905472636816
3097,0.482,3,4,3,605033,577,107535,421,0.005344770091518767,0.4218436873747495
3098,0.4821,0,3,0,605036,574,107535,421,0.005316980992256104,0.42311557788944726
3099,0.4822,2,1,2,605037,573,107537,419,0.00530771795916855,0.4223790322580645
3100,0.4823,1,1,1,605038,572,107538,418,0.005298454926080996,0.4222222222222222
3101,0.4824,2,5,2,605043,567,107540,416,0.005252139760643225,0.4231943031536114
3102,0.4825,2,4,2,605047,563,107542,414,0.005215087628293008,0.42374616171954965
3103,0.4826,14,24,14,605071,539,107556,400,0.004992774834191708,0.42598509052183176
3104,0.4827,1,0,1,605071,539,107557,399,0.004992774834191708,0.4253731343283582
3105,0.4828,5,13,5,605084,526,107562,394,0.004872355404053503,0.4282608695652174
3106,0.4829,3,4,3,605088,522,107565,391,0.004835303271703287,0.42825848849945236
3107,0.483,1,2,1,605090,520,107566,390,0.004816777205528178,0.42857142857142855
3108,0.4831,3,3,3,605093,517,107569,387,0.004788988106265516,0.4280973451327434
3109,0.4832,2,8,2,605101,509,107571,385,0.004714883841565082,0.4306487695749441
3110,0.4833,2,3,2,605104,506,107573,383,0.004687094742302419,0.43082114735658045
3111,0.4834,0,6,0,605110,500,107573,383,0.004631516543777094,0.4337485843714609
3112,0.4835,2,2,2,605112,498,107575,381,0.004612990477601986,0.4334470989761092
3113,0.4836,2,4,2,605116,494,107577,379,0.004575938345251769,0.434135166093929
3114,0.4837,1,2,1,605118,492,107578,378,0.0045574122790766605,0.43448275862068964
3115,0.4838,3,13,3,605131,479,107581,375,0.004436992848938457,0.43911007025761123
3116,0.4839,2,1,2,605132,478,107583,373,0.0044277298158509025,0.4383078730904818
3117,0.484,2,1,2,605133,477,107585,371,0.004418466782763348,0.4375
3118,0.4841,5,5,5,605138,472,107590,366,0.004372151617325577,0.43675417661097854
3119,0.4842,2,2,2,605140,470,107592,364,0.004353625551150469,0.4364508393285372
3120,0.4843,3,1,3,605141,469,107595,361,0.004344362518062915,0.43493975903614457
3121,0.4844,1,0,1,605141,469,107596,360,0.004344362518062915,0.43425814234016885
3122,0.4845,4,4,4,605145,465,107600,356,0.004307310385712698,0.4336175395858709
3123,0.4847,6,7,6,605152,458,107606,350,0.004242469154099818,0.43316831683168316
3124,0.4848,1,6,1,605158,452,107607,349,0.004186890955574493,0.43570536828963796
3125,0.4849,2,6,2,605164,446,107609,347,0.004131312757049168,0.43757881462799497
3126,0.485,3,4,3,605168,442,107612,344,0.004094260624698951,0.43765903307888043
3127,0.4851,2,2,2,605170,440,107614,342,0.004075734558523843,0.4373401534526854
3128,0.4852,2,4,2,605174,436,107616,340,0.004038682426173626,0.4381443298969072
3129,0.4853,1,2,1,605176,434,107617,339,0.0040201563599985175,0.4385510996119017
3130,0.4854,6,4,6,605180,430,107623,333,0.003983104227648302,0.436435124508519
3131,0.4856,2,0,2,605180,430,107625,331,0.003983104227648302,0.43495400788436267
3132,0.4857,1,3,1,605183,427,107626,330,0.003955315128385639,0.43593130779392336
3133,0.4858,1,3,1,605186,424,107627,329,0.003927526029122976,0.43691899070385126
3134,0.4859,2,3,2,605189,421,107629,327,0.0038997369298603133,0.43716577540106955
3135,0.486,5,11,5,605200,410,107634,322,0.0037978435658972175,0.43989071038251365
3136,0.4861,1,4,1,605204,406,107635,321,0.0037607914335470007,0.44154057771664373
3137,0.4862,2,1,2,605205,405,107637,319,0.0037515284004594465,0.44060773480662985
3138,0.4863,8,11,8,605216,394,107645,311,0.0036496350364963502,0.44113475177304967
3139,0.4864,2,3,2,605219,391,107647,309,0.0036218459372336876,0.44142857142857145
3140,0.4865,0,4,0,605223,387,107647,309,0.0035847938048834713,0.44396551724137934
3141,0.4866,3,2,3,605225,385,107650,306,0.003566267738708363,0.44283646888567296
3142,0.4867,1,5,1,605230,380,107651,305,0.003519952573270592,0.44525547445255476
3143,0.4868,2,1,2,605231,379,107653,303,0.0035106895401830376,0.4442815249266862
3144,0.487,5,4,5,605235,375,107658,298,0.003473637407832821,0.4427934621099554
3145,0.4871,2,8,2,605243,367,107660,296,0.003399533143132387,0.4464555052790347
3146,0.4872,5,3,5,605246,364,107665,291,0.0033717440438697246,0.4442748091603053
3147,0.4873,1,4,1,605250,360,107666,290,0.0033346919115195077,0.4461538461538462
3148,0.4874,1,3,1,605253,357,107667,289,0.0033069028122568456,0.4473684210526316
3149,0.4875,1,0,1,605253,357,107668,288,0.0033069028122568456,0.44651162790697674
3150,0.4876,2,3,2,605256,354,107670,286,0.003279113712994183,0.446875
3151,0.4877,4,4,4,605260,350,107674,282,0.003242061580643966,0.4462025316455696
3152,0.4878,1,0,1,605260,350,107675,281,0.003242061580643966,0.44532488114104596
3153,0.488,2,6,2,605266,344,107677,279,0.003186483382118641,0.4478330658105939
3154,0.4881,3,7,3,605273,337,107680,276,0.0031216421505057615,0.45024469820554647
3155,0.4882,2,1,2,605274,336,107682,274,0.0031123791174182073,0.4491803278688525
3156,0.4883,0,1,0,605275,335,107682,274,0.003103116084330653,0.44991789819376027
3157,0.4884,1,2,1,605277,333,107683,273,0.0030845900181555447,0.4504950495049505
3158,0.4885,5,4,5,605281,329,107688,268,0.0030475378858053283,0.4489112227805695
3159,0.4886,1,0,1,605281,329,107689,267,0.0030475378858053283,0.44798657718120805
3160,0.4887,3,3,3,605284,326,107692,264,0.0030197487865426657,0.44745762711864406
3161,0.4888,3,1,3,605285,325,107695,261,0.0030104857534551115,0.4453924914675768
3162,0.4889,3,2,3,605287,323,107698,258,0.002991959687280003,0.4440619621342513
3163,0.489,2,3,2,605290,320,107700,256,0.0029641705880173405,0.4444444444444444
3164,0.4891,0,3,0,605293,317,107700,256,0.002936381488754678,0.4467713787085515
3165,0.4892,2,1,2,605294,316,107702,254,0.0029271184556671236,0.4456140350877193
3166,0.4893,2,3,2,605297,313,107704,252,0.002899329356404461,0.44601769911504424
3167,0.4894,1,0,1,605297,313,107705,251,0.002899329356404461,0.4450354609929078
3168,0.4896,0,3,0,605300,310,107705,251,0.0028715402571417984,0.4474153297682709
3169,0.4897,3,0,3,605300,310,107708,248,0.0028715402571417984,0.4444444444444444
3170,0.4898,1,1,1,605301,309,107709,247,0.0028622772240542442,0.4442446043165468
3171,0.4899,3,0,3,605301,309,107712,244,0.0028622772240542442,0.4412296564195298
3172,0.49,2,3,2,605304,306,107714,242,0.0028344881247915816,0.4416058394160584
3173,0.4901,2,4,2,605308,302,107716,240,0.002797435992441365,0.44280442804428044
3174,0.4903,2,0,2,605308,302,107718,238,0.002797435992441365,0.44074074074074077
3175,0.4904,0,2,0,605310,300,107718,238,0.002778909926266257,0.4423791821561338
3176,0.4906,5,7,5,605317,293,107723,233,0.0027140686946533774,0.4429657794676806
3177,0.4908,1,1,1,605318,292,107724,232,0.002704805661565823,0.44274809160305345
3178,0.4909,0,2,0,605320,290,107724,232,0.0026862795953907148,0.4444444444444444
3179,0.491,0,1,0,605321,289,107724,232,0.0026770165623031606,0.44529750479846447
3180,0.4911,2,3,2,605324,286,107726,230,0.002649227463040498,0.44573643410852715
3181,0.4914,2,2,2,605326,284,107728,228,0.0026307013968653896,0.4453125
3182,0.4915,2,2,2,605328,282,107730,226,0.002612175330690281,0.4448818897637795
3183,0.4916,2,1,2,605329,281,107732,224,0.002602912297602727,0.44356435643564357
3184,0.4917,1,0,1,605329,281,107733,223,0.002602912297602727,0.44246031746031744
3185,0.4918,3,1,3,605330,280,107736,220,0.0025936492645151727,0.44
3186,0.4919,6,7,6,605337,273,107742,214,0.0025288080329022933,0.4394250513347023
3187,0.492,1,1,1,605338,272,107743,213,0.0025195449998147395,0.43917525773195876
3188,0.4922,0,1,0,605339,271,107743,213,0.0025102819667271853,0.44008264462809915
3189,0.4923,0,1,0,605340,270,107743,213,0.002501018933639631,0.4409937888198758
3190,0.4924,0,1,0,605341,269,107743,213,0.002491755900552077,0.44190871369294604
3191,0.4925,3,3,3,605344,266,107746,210,0.0024639668012894143,0.4411764705882353
3192,0.4926,1,0,1,605344,266,107747,209,0.0024639668012894143,0.44
3193,0.4927,4,6,4,605350,260,107751,205,0.002408388602764089,0.44086021505376344
3194,0.4928,0,2,0,605352,258,107751,205,0.0023898625365889807,0.4427645788336933
3195,0.4929,0,3,0,605355,255,107751,205,0.002362073437326318,0.44565217391304346
3196,0.493,0,2,0,605357,253,107751,205,0.0023435473711512097,0.44759825327510916
3197,0.4931,1,2,1,605359,251,107752,204,0.0023250213049761013,0.44835164835164837
3198,0.4932,0,1,0,605360,250,107752,204,0.002315758271888547,0.44933920704845814
3199,0.4935,1,2,1,605362,248,107753,203,0.0022972322057134387,0.4501108647450111
3200,0.4936,1,1,1,605363,247,107754,202,0.0022879691726258844,0.44988864142538976
3201,0.4937,6,5,6,605368,242,107760,196,0.002241654007188114,0.4474885844748858
3202,0.4938,1,0,1,605368,242,107761,195,0.002241654007188114,0.4462242562929062
3203,0.4939,2,2,2,605370,240,107763,193,0.0022231279410130055,0.4457274826789838
3204,0.494,3,2,3,605372,238,107766,190,0.002204601874837897,0.4439252336448598
3205,0.4941,2,1,2,605373,237,107768,188,0.002195338841750343,0.4423529411764706
3206,0.4942,3,1,3,605374,236,107771,185,0.0021860758086627886,0.43942992874109266
3207,0.4944,3,4,3,605378,232,107774,182,0.002149023676312572,0.4396135265700483
3208,0.4945,0,1,0,605379,231,107774,182,0.0021397606432250176,0.4406779661016949
3209,0.4946,0,2,0,605381,229,107774,182,0.002121234577049909,0.44282238442822386
3210,0.4947,0,2,0,605383,227,107774,182,0.002102708510874801,0.4449877750611247
3211,0.4949,2,7,2,605390,220,107776,180,0.0020378672792619214,0.45
3212,0.495,1,1,1,605391,219,107777,179,0.002028604246174367,0.44974874371859297
3213,0.4951,1,5,1,605396,214,107778,178,0.0019822890807365966,0.45408163265306123
3214,0.4952,4,3,4,605399,211,107782,174,0.001954499981473934,0.45194805194805193
3215,0.4953,0,1,0,605400,210,107782,174,0.0019452369483863796,0.453125
3216,0.4954,3,1,3,605401,209,107785,171,0.0019359739152988254,0.45
3217,0.4955,1,1,1,605402,208,107786,170,0.0019267108822112714,0.4497354497354497
3218,0.4956,1,4,1,605406,204,107787,169,0.0018896587498610545,0.45308310991957107
3219,0.4958,0,1,0,605407,203,107787,169,0.0018803957167735003,0.4543010752688172
3220,0.4959,0,1,0,605408,202,107787,169,0.0018711326836859461,0.4555256064690027
3221,0.496,5,4,5,605412,198,107792,164,0.0018340805513357293,0.4530386740331492
3222,0.4961,2,2,2,605414,196,107794,162,0.001815554485160621,0.45251396648044695
3223,0.4964,3,2,3,605416,194,107797,159,0.0017970284189855125,0.45042492917847027
3224,0.4965,0,1,0,605417,193,107797,159,0.0017877653858979585,0.45170454545454547
3225,0.4966,1,4,1,605421,189,107798,158,0.0017507132535477417,0.4553314121037464
3226,0.4967,1,0,1,605421,189,107799,157,0.0017507132535477417,0.45375722543352603
3227,0.4968,2,2,2,605423,187,107801,155,0.0017321871873726333,0.45321637426900585
3228,0.4972,0,1,0,605424,186,107801,155,0.001722924154285079,0.45454545454545453
3229,0.4973,2,0,2,605424,186,107803,153,0.001722924154285079,0.45132743362831856
3230,0.4975,1,1,1,605425,185,107804,152,0.001713661121197525,0.45103857566765576
3231,0.4976,1,3,1,605428,182,107805,151,0.0016858720219348623,0.45345345345345345
3232,0.4977,4,1,4,605429,181,107809,147,0.001676608988847308,0.4481707317073171
3233,0.498,2,1,2,605430,180,107811,145,0.0016673459557597539,0.4461538461538462
3234,0.4981,1,2,1,605432,178,107812,144,0.0016488198895846457,0.4472049689440994
3235,0.4982,1,5,1,605437,173,107813,143,0.0016025047241468747,0.4525316455696203
3236,0.4984,1,1,1,605438,172,107814,142,0.0015932416910593205,0.45222929936305734
3237,0.4985,5,2,5,605440,170,107819,137,0.001574715624884212,0.44625407166123776
3238,0.4986,2,1,2,605441,169,107821,135,0.0015654525917966578,0.4440789473684211
3239,0.4988,0,1,0,605442,168,107821,135,0.0015561895587091036,0.44554455445544555
3240,0.4989,0,2,0,605444,166,107821,135,0.0015376634925339952,0.4485049833887043
3241,0.499,1,0,1,605444,166,107822,134,0.0015376634925339952,0.44666666666666666
3242,0.4992,1,0,1,605444,166,107823,133,0.0015376634925339952,0.44481605351170567
3243,0.4993,1,1,1,605445,165,107824,132,0.0015284004594464412,0.4444444444444444
3244,0.4994,0,2,0,605447,163,107824,132,0.0015098743932713328,0.44745762711864406
3245,0.4995,2,3,2,605450,160,107826,130,0.0014820852940086702,0.4482758620689655
3246,0.4997,0,1,0,605451,159,107826,130,0.001472822260921116,0.44982698961937717
3247,0.4998,0,1,0,605452,158,107826,130,0.0014635592278335618,0.4513888888888889
3248,0.5,1,0,1,605452,158,107827,129,0.0014635592278335618,0.44947735191637633
3249,0.5001,2,4,2,605456,154,107829,127,0.001426507095483345,0.45195729537366547
3250,0.5003,0,1,0,605457,153,107829,127,0.0014172440623957908,0.45357142857142857
3251,0.5004,2,0,2,605457,153,107831,125,0.0014172440623957908,0.44964028776978415
3252,0.5006,2,1,2,605458,152,107833,123,0.0014079810293082366,0.44727272727272727
3253,0.5007,0,1,0,605459,151,107833,123,0.0013987179962206824,0.4489051094890511
3254,0.5008,0,5,0,605464,146,107833,123,0.0013524028307829116,0.45724907063197023
3255,0.5009,1,2,1,605466,144,107834,122,0.0013338767646078032,0.45864661654135336
3256,0.501,0,1,0,605467,143,107834,122,0.001324613731520249,0.46037735849056605
3257,0.5011,2,2,2,605469,141,107836,120,0.0013060876653451406,0.45977011494252873
3258,0.5012,1,0,1,605469,141,107837,119,0.0013060876653451406,0.4576923076923077
3259,0.5013,1,0,1,605469,141,107838,118,0.0013060876653451406,0.4555984555984556
3260,0.5014,2,3,2,605472,138,107840,116,0.001278298566082478,0.4566929133858268
3261,0.5017,1,1,1,605473,137,107841,115,0.0012690355329949238,0.45634920634920634
3262,0.5018,0,1,0,605474,136,107841,115,0.0012597724999073698,0.4581673306772908
3263,0.5021,1,2,1,605476,134,107842,114,0.0012412464337322614,0.4596774193548387
3264,0.5024,1,5,1,605481,129,107843,113,0.0011949312682944903,0.4669421487603306
3265,0.5027,1,0,1,605481,129,107844,112,0.0011949312682944903,0.46473029045643155
3266,0.5028,0,1,0,605482,128,107844,112,0.0011856682352069361,0.4666666666666667
3267,0.503,0,1,0,605483,127,107844,112,0.001176405202119382,0.4686192468619247
3268,0.5035,7,4,7,605487,123,107851,105,0.0011393530697691651,0.4605263157894737
3269,0.5036,0,2,0,605489,121,107851,105,0.001120827003594057,0.4646017699115044
3270,0.5039,1,2,1,605491,119,107852,104,0.0011023009374189485,0.4663677130044843
3271,0.5041,1,2,1,605493,117,107853,103,0.0010837748712438401,0.4681818181818182
3272,0.5044,0,2,0,605495,115,107853,103,0.0010652488050687317,0.4724770642201835
3273,0.5045,1,1,1,605496,114,107854,102,0.0010559857719811775,0.4722222222222222
3274,0.5046,4,1,4,605497,113,107858,98,0.0010467227388936233,0.46445497630331756
3275,0.5047,2,2,2,605499,111,107860,96,0.001028196672718515,0.463768115942029
3276,0.505,1,3,1,605502,108,107861,95,0.0010004075734558523,0.46798029556650245
3277,0.5051,1,1,1,605503,107,107862,94,0.0009911445403682983,0.46766169154228854
3278,0.5052,0,1,0,605504,106,107862,94,0.000981881507280744,0.47
3279,0.5053,3,3,3,605507,103,107865,91,0.0009540924080180815,0.4690721649484536
3280,0.5054,1,1,1,605508,102,107866,90,0.0009448293749305273,0.46875
3281,0.5056,0,1,0,605509,101,107866,90,0.0009355663418429731,0.4712041884816754
3282,0.5057,0,2,0,605511,99,107866,90,0.0009170402756678647,0.47619047619047616
3283,0.5058,3,0,3,605511,99,107869,87,0.0009170402756678647,0.46774193548387094
3284,0.506,6,1,6,605512,98,107875,81,0.0009077772425803105,0.45251396648044695
3285,0.5061,3,4,3,605516,94,107878,78,0.0008707251102300938,0.45348837209302323
3286,0.5062,5,2,5,605518,92,107883,73,0.0008521990440549853,0.44242424242424244
3287,0.5063,1,0,1,605518,92,107884,72,0.0008521990440549853,0.43902439024390244
3288,0.5064,1,0,1,605518,92,107885,71,0.0008521990440549853,0.43558282208588955
3289,0.5065,0,1,0,605519,91,107885,71,0.0008429360109674311,0.4382716049382716
3290,0.5066,0,1,0,605520,90,107885,71,0.0008336729778798769,0.4409937888198758
3291,0.5067,0,1,0,605521,89,107885,71,0.0008244099447923228,0.44375
3292,0.5071,1,1,1,605522,88,107886,70,0.0008151469117047686,0.4430379746835443
3293,0.5073,1,0,1,605522,88,107887,69,0.0008151469117047686,0.4394904458598726
3294,0.5074,0,1,0,605523,87,107887,69,0.0008058838786172144,0.4423076923076923
3295,0.5075,3,1,3,605524,86,107890,66,0.0007966208455296602,0.4342105263157895
3296,0.5077,1,1,1,605525,85,107891,65,0.000787357812442106,0.43333333333333335
3297,0.5078,2,1,2,605526,84,107893,63,0.0007780947793545518,0.42857142857142855
3298,0.5079,0,1,0,605527,83,107893,63,0.0007688317462669976,0.4315068493150685
3299,0.5083,2,0,2,605527,83,107895,61,0.0007688317462669976,0.4236111111111111
3300,0.5084,1,0,1,605527,83,107896,60,0.0007688317462669976,0.4195804195804196
3301,0.5085,1,0,1,605527,83,107897,59,0.0007688317462669976,0.4154929577464789
3302,0.5086,0,2,0,605529,81,107897,59,0.0007503056800918893,0.42142857142857143
3303,0.509,1,2,1,605531,79,107898,58,0.0007317796139167809,0.4233576642335766
3304,0.5093,0,2,0,605533,77,107898,58,0.0007132535477416725,0.42962962962962964
3305,0.5095,1,1,1,605534,76,107899,57,0.0007039905146541183,0.42857142857142855
3306,0.5096,1,0,1,605534,76,107900,56,0.0007039905146541183,0.42424242424242425
3307,0.5097,0,2,0,605536,74,107900,56,0.00068546444847901,0.4307692307692308
3308,0.5098,0,8,0,605544,66,107900,56,0.0006113601837785765,0.45901639344262296
3309,0.5101,3,2,3,605546,64,107903,53,0.0005928341176034681,0.452991452991453
3310,0.5102,0,1,0,605547,63,107903,53,0.0005835710845159139,0.45689655172413796
3311,0.5103,2,0,2,605547,63,107905,51,0.0005835710845159139,0.4473684210526316
3312,0.5104,0,1,0,605548,62,107905,51,0.0005743080514283597,0.45132743362831856
3313,0.5106,1,1,1,605549,61,107906,50,0.0005650450183408056,0.45045045045045046
3314,0.5107,0,2,0,605551,59,107906,50,0.0005465189521656972,0.45871559633027525
3315,0.5111,2,0,2,605551,59,107908,48,0.0005465189521656972,0.4485981308411215
3316,0.5112,0,1,0,605552,58,107908,48,0.000537255919078143,0.4528301886792453
3317,0.5113,1,0,1,605552,58,107909,47,0.000537255919078143,0.44761904761904764
3318,0.5114,0,4,0,605556,54,107909,47,0.0005002037867279261,0.46534653465346537
3319,0.5117,1,0,1,605556,54,107910,46,0.0005002037867279261,0.46
3320,0.5121,0,1,0,605557,53,107910,46,0.000490940753640372,0.46464646464646464
3321,0.5122,0,1,0,605558,52,107910,46,0.00048167772055281784,0.46938775510204084
3322,0.5129,0,1,0,605559,51,107910,46,0.00047241468746526364,0.4742268041237113
3323,0.513,0,1,0,605560,50,107910,46,0.00046315165437770943,0.4791666666666667
3324,0.5132,1,1,1,605561,49,107911,45,0.00045388862129015523,0.4787234042553192
3325,0.5133,1,0,1,605561,49,107912,44,0.00045388862129015523,0.4731182795698925
3326,0.5134,1,1,1,605562,48,107913,43,0.0004446255882026011,0.4725274725274725
3327,0.5137,1,1,1,605563,47,107914,42,0.0004353625551150469,0.47191011235955055
3328,0.5138,0,2,0,605565,45,107914,42,0.00041683648893993847,0.4827586206896552
3329,0.5142,1,1,1,605566,44,107915,41,0.0004075734558523843,0.4823529411764706
3330,0.5143,0,1,0,605567,43,107915,41,0.0003983104227648301,0.4880952380952381
3331,0.5149,1,4,1,605571,39,107916,40,0.00036125829041461335,0.5063291139240507
3332,0.515,0,1,0,605572,38,107916,40,0.00035199525732705915,0.5128205128205128
3333,0.5154,0,2,0,605574,36,107916,40,0.0003334691911519508,0.5263157894736842
3334,0.5157,1,0,1,605574,36,107917,39,0.0003334691911519508,0.52
3335,0.5158,0,3,0,605577,33,107917,39,0.00030568009188928824,0.5416666666666666
3336,0.5159,1,1,1,605578,32,107918,38,0.00029641705880173404,0.5428571428571428
3337,0.516,0,1,0,605579,31,107918,38,0.00028715402571417983,0.5507246376811594
3338,0.5162,0,3,0,605582,28,107918,38,0.0002593649264515173,0.5757575757575758
3339,0.5166,2,0,2,605582,28,107920,36,0.0002593649264515173,0.5625
3340,0.5169,1,1,1,605583,27,107921,35,0.00025010189336396307,0.5645161290322581
3341,0.5174,1,0,1,605583,27,107922,34,0.00025010189336396307,0.5573770491803278
3342,0.5175,2,0,2,605583,27,107924,32,0.00025010189336396307,0.5423728813559322
3343,0.5176,2,1,2,605584,26,107926,30,0.00024083886027640892,0.5357142857142857
3344,0.518,1,0,1,605584,26,107927,29,0.00024083886027640892,0.5272727272727272
3345,0.5185,1,1,1,605585,25,107928,28,0.00023157582718885472,0.5283018867924528
3346,0.5189,1,0,1,605585,25,107929,27,0.00023157582718885472,0.5192307692307693
3347,0.5194,2,0,2,605585,25,107931,25,0.00023157582718885472,0.5
3348,0.5195,0,1,0,605586,24,107931,25,0.00022231279410130054,0.5102040816326531
3349,0.5198,0,1,0,605587,23,107931,25,0.00021304976101374634,0.5208333333333334
3350,0.5199,1,0,1,605587,23,107932,24,0.00021304976101374634,0.5106382978723404
3351,0.5203,0,1,0,605588,22,107932,24,0.00020378672792619216,0.5217391304347826
3352,0.5204,0,1,0,605589,21,107932,24,0.00019452369483863796,0.5333333333333333
3353,0.5205,1,0,1,605589,21,107933,23,0.00019452369483863796,0.5227272727272727
3354,0.521,0,1,0,605590,20,107933,23,0.00018526066175108378,0.5348837209302325
3355,0.5213,0,1,0,605591,19,107933,23,0.00017599762866352957,0.5476190476190477
3356,0.5216,1,0,1,605591,19,107934,22,0.00017599762866352957,0.5365853658536586
3357,0.5242,1,0,1,605591,19,107935,21,0.00017599762866352957,0.525
3358,0.5247,1,0,1,605591,19,107936,20,0.00017599762866352957,0.5128205128205128
3359,0.5249,1,0,1,605591,19,107937,19,0.00017599762866352957,0.5
3360,0.5264,0,1,0,605592,18,107937,19,0.0001667345955759754,0.5135135135135135
3361,0.5265,0,1,0,605593,17,107937,19,0.00015747156248842122,0.5277777777777778
3362,0.5278,2,1,2,605594,16,107939,17,0.00014820852940086702,0.5151515151515151
3363,0.5285,0,1,0,605595,15,107939,17,0.00013894549631331284,0.53125
3364,0.5286,0,1,0,605596,14,107939,17,0.00012968246322575864,0.5483870967741935
3365,0.5291,0,2,0,605598,12,107939,17,0.00011115639705065027,0.5862068965517241
3366,0.5293,0,1,0,605599,11,107939,17,0.00010189336396309608,0.6071428571428571
3367,0.5299,2,0,2,605599,11,107941,15,0.00010189336396309608,0.5769230769230769
3368,0.5301,1,0,1,605599,11,107942,14,0.00010189336396309608,0.56
3369,0.5322,1,0,1,605599,11,107943,13,0.00010189336396309608,0.5416666666666666
3370,0.5341,0,1,0,605600,10,107943,13,9.263033087554189e-05,0.5652173913043478
3371,0.5369,0,1,0,605601,9,107943,13,8.33672977879877e-05,0.5909090909090909
3372,0.5375,0,1,0,605602,8,107943,13,7.410426470043351e-05,0.6190476190476191
3373,0.5382,1,0,1,605602,8,107944,12,7.410426470043351e-05,0.6
3374,0.5397,2,0,2,605602,8,107946,10,7.410426470043351e-05,0.5555555555555556
3375,0.5403,1,0,1,605602,8,107947,9,7.410426470043351e-05,0.5294117647058824
3376,0.55,1,0,1,605602,8,107948,8,7.410426470043351e-05,0.5
3377,0.5509,1,0,1,605602,8,107949,7,7.410426470043351e-05,0.4666666666666667
3378,0.5529,1,1,1,605603,7,107950,6,6.484123161287932e-05,0.46153846153846156
3379,0.5548,1,0,1,605603,7,107951,5,6.484123161287932e-05,0.4166666666666667
3380,0.5592,1,1,1,605604,6,107952,4,5.5578198525325135e-05,0.4
3381,0.5639,1,0,1,605604,6,107953,3,5.5578198525325135e-05,0.3333333333333333
3382,0.5695,0,1,0,605605,5,107953,3,4.6315165437770945e-05,0.375
3383,0.5706,0,1,0,605606,4,107953,3,3.7052132350216754e-05,0.42857142857142855
3384,0.5755,0,1,0,605607,3,107953,3,2.7789099262662567e-05,0.5
3385,0.5856,0,2,0,605609,1,107953,3,9.263033087554189e-06,0.75
3386,0.5914,1,0,1,605609,1,107954,2,9.263033087554189e-06,0.6666666666666666
3387,0.6074,2,0,2,605609,1,107956,0,9.263033087554189e-06,0.0
3388,0.6734,0,1,0,605610,0,107956,0,0.0,
