,y_proba,y_test,Neg,Pos,TN,FP,FN,TP,FP/P,Prec
0,0.0,0,7,0,7,605603,0,107956,5.609720626922079,0.15129232481126298
1,0.0001,0,14,0,21,605589,0,107956,5.609590944458853,0.15129529321906818
2,0.0002,0,17,0,38,605572,0,107956,5.609433472896365,0.1512988978708614
3,0.0003,0,13,0,51,605559,0,107956,5.609313053466227,0.1513016544851895
4,0.0004,0,11,0,62,605548,0,107956,5.609211160102264,0.15130398708346415
5,0.0005,0,16,0,78,605532,0,107956,5.609062951572863,0.15130738008207567
6,0.0006,0,19,0,97,605513,0,107956,5.608886953944199,0.15131140946558294
7,0.0007,0,14,0,111,605499,0,107956,5.6087572714809735,0.1513143786223378
8,0.0008,0,17,0,128,605482,0,107956,5.608599799918485,0.15131798418362913
9,0.0009,0,13,0,141,605469,0,107956,5.6084793804883475,0.15132074149349967
10,0.001,0,13,0,154,605456,0,107956,5.608358961058209,0.1513234989038592
11,0.0011,0,19,0,173,605437,0,107956,5.608182963429545,0.1513275291459266
12,0.0012,0,20,0,193,605417,0,107956,5.607997702767794,0.15133177173792672
13,0.0013,0,15,0,208,605402,0,107956,5.607858757271481,0.15133495383804485
14,0.0014,0,8,0,216,605394,0,107956,5.607784653006781,0.1513366510128268
15,0.0015,0,18,0,234,605376,0,107956,5.607617918411204,0.15134046979527063
16,0.0016,0,12,0,246,605364,0,107956,5.607506762014154,0.15134301575730388
17,0.0017,0,12,0,258,605352,0,107956,5.6073956056171035,0.15134556180499867
18,0.0018,1,15,1,273,605337,1,107955,5.60725666012079,0.15134755471812386
19,0.0019,0,11,0,284,605326,1,107955,5.6071547667568264,0.1513498887535207
20,0.002,0,10,0,294,605316,1,107955,5.607062136425951,0.15135201066635262
21,0.0021,0,15,0,309,605301,1,107955,5.606923190929638,0.15135519364716174
22,0.0022,1,25,1,334,605276,2,107954,5.6066916151024495,0.1513593090587889
23,0.0023,0,14,0,348,605262,2,107954,5.606561932639224,0.15136228015075376
24,0.0024,0,17,0,365,605245,2,107954,5.606404461076735,0.15136588806209766
25,0.0025,0,15,0,380,605230,2,107954,5.6062655155804215,0.1513690716561224
26,0.0026,0,24,0,404,605206,2,107954,5.606043202786321,0.15137416568511974
27,0.0027,0,14,0,418,605192,2,107954,5.605913520323095,0.1513771373603722
28,0.0028,0,16,0,434,605176,2,107954,5.605765311793694,0.15138053370353233
29,0.0029,0,23,0,457,605153,2,107954,5.60555226203268,0.15138541621383608
30,0.003,0,16,0,473,605137,2,107954,5.605404053503279,0.15138881292850423
31,0.0031,0,8,0,481,605129,2,107954,5.605329949238579,0.15139051134299933
32,0.0032,0,21,0,502,605108,2,107954,5.6051354255437404,0.15139496986236822
33,0.0033,0,17,0,519,605091,2,107954,5.604977953981251,0.1513985793323002
34,0.0034,0,30,0,549,605061,2,107954,5.604700062988625,0.15140494940499147
35,0.0035,0,18,0,567,605043,2,107954,5.604533328393049,0.1514087717059118
36,0.0036,0,17,0,584,605026,2,107954,5.60437585683056,0.15141238183399253
37,0.0037,0,12,0,596,605014,2,107954,5.60426470043351,0.15141493026334982
38,0.0038,0,17,0,613,604997,2,107954,5.604107228871022,0.15141854068512423
39,0.0039,0,16,0,629,604981,2,107954,5.6039590203416205,0.15142193888643424
40,0.004,0,21,0,650,604960,2,107954,5.603764496646782,0.1514263992571334
41,0.0041,0,20,0,670,604940,2,107954,5.603579235985031,0.15143064747353743
42,0.0042,0,23,0,693,604917,2,107954,5.603366186224017,0.15143553321708977
43,0.0043,0,23,0,716,604894,2,107954,5.603153136463003,0.15144041927591856
44,0.0044,0,16,0,732,604878,2,107954,5.603004927933602,0.15144381845932842
45,0.0045,0,28,0,760,604850,2,107954,5.602745563007151,0.15144976739748936
46,0.0046,1,29,1,789,604821,3,107953,5.602476935047612,0.1514547388092158
47,0.0047,0,30,0,819,604791,3,107953,5.602199044054985,0.15146111366774045
48,0.0048,0,27,0,846,604764,3,107953,5.601948942161622,0.15146685149926267
49,0.0049,0,20,0,866,604744,3,107953,5.60176368149987,0.1514711020251243
50,0.005,0,16,0,882,604728,3,107953,5.60161547297047,0.15147450261758066
51,0.0051,0,14,0,896,604714,3,107953,5.601485790507244,0.15147747826123562
52,0.0052,0,21,0,917,604693,3,107953,5.601291266812405,0.1514819419459311
53,0.0053,0,21,0,938,604672,3,107953,5.601096743117567,0.15148640589370285
54,0.0054,1,20,1,958,604652,4,107952,5.600911482455816,0.1514894668006354
55,0.0055,0,26,0,984,604626,4,107952,5.600670643595539,0.15149499423221036
56,0.0056,0,26,0,1010,604600,4,107952,5.6004298047352625,0.15150052206716141
57,0.0057,0,27,0,1037,604573,4,107952,5.600179702841898,0.1515062629381425
58,0.0058,0,34,0,1071,604539,4,107952,5.5998647597169215,0.15151349280201434
59,0.0059,0,29,0,1100,604510,4,107952,5.599596131757383,0.15151965999590153
60,0.006,0,21,0,1121,604489,4,107952,5.599401608062544,0.15152412620834568
61,0.0061,0,19,0,1140,604470,4,107952,5.599225610433881,0.1515281672941038
62,0.0062,0,15,0,1155,604455,4,107952,5.599086664937567,0.15153135777722565
63,0.0063,0,26,0,1181,604429,4,107952,5.598845826077291,0.15153688826625078
64,0.0064,0,17,0,1198,604412,4,107952,5.5986883545148025,0.15154050457350457
65,0.0065,0,21,0,1219,604391,4,107952,5.598493830819963,0.1515449720148861
66,0.0066,0,33,0,1252,604358,4,107952,5.598188150728074,0.1515519928121183
67,0.0067,0,32,0,1284,604326,4,107952,5.597891733669273,0.15155880147919773
68,0.0068,0,23,0,1307,604303,4,107952,5.597678683908259,0.15156369558655258
69,0.0069,0,33,0,1340,604270,4,107952,5.59737300381637,0.1515707181187888
70,0.007,0,32,0,1372,604238,4,107952,5.597076586757568,0.15157752846852665
71,0.0071,0,33,0,1405,604205,4,107952,5.596770906665679,0.15158455228271295
72,0.0072,0,25,0,1430,604180,4,107952,5.59653933083849,0.1515898737874439
73,0.0073,1,34,1,1464,604146,5,107951,5.596224387713513,0.15159592021873425
74,0.0074,0,33,0,1497,604113,5,107951,5.595918707621624,0.15160294580262448
75,0.0075,0,22,0,1519,604091,5,107951,5.595714920893697,0.15160762988700105
76,0.0076,0,30,0,1549,604061,5,107951,5.5954370299010705,0.15161401774127403
77,0.0077,0,32,0,1581,604029,5,107951,5.595140612842269,0.15162083204584398
78,0.0078,0,34,0,1615,603995,5,107951,5.5948256697172924,0.15162807291564248
79,0.0079,0,30,0,1645,603965,5,107951,5.594547778724666,0.151634462492766
80,0.008,0,29,0,1674,603936,5,107951,5.594279150765127,0.1516406395958909
81,0.0081,0,27,0,1701,603909,5,107951,5.5940290488717626,0.15164639114432613
82,0.0082,0,27,0,1728,603882,5,107951,5.593778946978398,0.15165214312907663
83,0.0083,0,31,0,1759,603851,5,107951,5.593491792952684,0.15165874779784266
84,0.0084,0,27,0,1786,603824,5,107951,5.593241691059321,0.1516645007200309
85,0.0085,0,29,0,1815,603795,5,107951,5.592973063099781,0.15167068027077074
86,0.0086,0,19,0,1834,603776,5,107951,5.592797065471117,0.15167472921499395
87,0.0087,1,34,1,1868,603742,6,107950,5.592482122346141,0.15168078326017434
88,0.0088,0,32,0,1900,603710,6,107950,5.592185705287339,0.15168760363094735
89,0.0089,0,34,0,1934,603676,6,107950,5.591870762162363,0.1516948509469862
90,0.009,1,30,1,1964,603646,7,107949,5.591592871169736,0.15170005410380905
91,0.0091,0,31,0,1995,603615,7,107949,5.591305717144022,0.15170666306895797
92,0.0092,0,25,0,2020,603590,7,107949,5.591074141316833,0.1517119932990321
93,0.0093,1,29,1,2049,603561,8,107948,5.590805513357294,0.1517169846059572
94,0.0094,0,34,0,2083,603527,8,107948,5.590490570232316,0.1517242348641906
95,0.0095,0,36,0,2119,603491,8,107948,5.590157101041165,0.15173191236353362
96,0.0096,0,35,0,2154,603456,8,107948,5.5898328948831,0.15173937734395646
97,0.0097,0,25,0,2179,603431,8,107948,5.5896013190559115,0.15174470992255887
98,0.0098,1,20,1,2199,603411,9,107947,5.589416058394161,0.15174778381630627
99,0.0099,1,40,1,2239,603371,10,107946,5.589045537070659,0.15175512464906646
100,0.01,0,25,0,2264,603346,10,107946,5.58881396124347,0.151760458433386
101,0.0101,0,40,0,2304,603306,10,107946,5.588443439919968,0.15176899326820872
102,0.0102,0,31,0,2335,603275,10,107946,5.588156285894253,0.1517756084255105
103,0.0103,0,31,0,2366,603244,10,107946,5.587869131868539,0.15178222415950732
104,0.0104,0,35,0,2401,603209,10,107946,5.587544925710475,0.15178969422980926
105,0.0105,0,40,0,2441,603169,10,107946,5.587174404386973,0.15179823235341683
106,0.0106,0,31,0,2472,603138,10,107946,5.586887250361258,0.15180485005990854
107,0.0107,0,23,0,2495,603115,10,107946,5.586674200600244,0.15180976034404925
108,0.0108,1,39,1,2534,603076,11,107945,5.58631294230983,0.1518168942970742
109,0.0109,1,39,1,2573,603037,12,107944,5.585951684019415,0.15182402905281575
110,0.011,0,32,0,2605,603005,12,107944,5.585655266960614,0.15183086269197932
111,0.0111,0,32,0,2637,602973,12,107944,5.585358849901811,0.1518376969463383
112,0.0112,0,40,0,2677,602933,12,107944,5.5849883285783095,0.15184624062953225
113,0.0113,0,31,0,2708,602902,12,107944,5.584701174552595,0.15185286264535497
114,0.0114,0,42,0,2750,602860,12,107944,5.584312127162918,0.1518618353301332
115,0.0115,0,33,0,2783,602827,12,107944,5.584006447071029,0.15186888604065163
116,0.0116,0,41,0,2824,602786,12,107944,5.5836266627144395,0.15187764692639963
117,0.0117,0,30,0,2854,602756,12,107944,5.583348771721813,0.15188405797101448
118,0.0118,0,40,0,2894,602716,12,107944,5.582978250398311,0.15189260687248474
119,0.0119,0,36,0,2930,602680,12,107944,5.582644781207159,0.15190030170666907
120,0.012,0,37,0,2967,602643,12,107944,5.582302048982919,0.15190821109871136
121,0.0121,2,40,2,3007,602603,14,107942,5.581931527659417,0.1519143755849383
122,0.0122,0,31,0,3038,602572,14,107942,5.5816443736337025,0.15192100366776728
123,0.0123,0,42,0,3080,602530,14,107942,5.581255326244025,0.15192998457363555
124,0.0124,1,33,1,3113,602497,15,107941,5.580949646152136,0.15193584802614726
125,0.0125,0,39,0,3152,602458,15,107941,5.580588387861721,0.15194418911062657
126,0.0126,0,48,0,3200,602410,15,107941,5.580143762273519,0.15195445631807375
127,0.0127,0,31,0,3231,602379,15,107941,5.5798566082478045,0.1519610879603559
128,0.0128,0,40,0,3271,602339,15,107941,5.579486086924303,0.15196964577349778
129,0.0129,0,36,0,3307,602303,15,107941,5.5791526177331505,0.1519773486294851
130,0.013,0,42,0,3349,602261,15,107941,5.578763570343473,0.15198633628179026
131,0.0131,0,41,0,3390,602220,15,107941,5.578383785986883,0.15199511096779464
132,0.0132,0,42,0,3432,602178,15,107941,5.577994738597206,0.15200410072114673
133,0.0133,0,35,0,3467,602143,15,107941,5.577670532439142,0.15201159299463163
134,0.0134,0,52,0,3519,602091,15,107941,5.577188854718589,0.15202272573630485
135,0.0135,1,33,1,3552,602058,16,107940,5.576883174626699,0.15202859726365425
136,0.0136,0,39,0,3591,602019,16,107940,5.576521916336286,0.1520369486125255
137,0.0137,0,32,0,3623,601987,16,107940,5.576225499277483,0.1520438016866523
138,0.0138,0,35,0,3658,601952,16,107940,5.575901293119419,0.1520512979439126
139,0.0139,0,29,0,3687,601923,16,107940,5.57563266515988,0.1520575096884892
140,0.014,0,41,0,3728,601882,16,107940,5.575252880803291,0.15206629267619207
141,0.0141,0,35,0,3763,601847,16,107940,5.574928674645226,0.15207379115142994
142,0.0142,1,44,1,3807,601803,17,107939,5.574521101189373,0.15208202417216396
143,0.0143,0,62,0,3869,601741,17,107939,5.573946793137945,0.15209531056250705
144,0.0144,0,49,0,3918,601692,17,107939,5.573492904516655,0.1521058127392969
145,0.0145,0,48,0,3966,601644,17,107939,5.573048278928452,0.1521161019922969
146,0.0146,0,36,0,4002,601608,17,107939,5.572714809737301,0.15212381984561982
147,0.0147,0,45,0,4047,601563,17,107939,5.572297973248361,0.15213346826365534
148,0.0148,1,44,1,4091,601519,18,107938,5.571890399792508,0.15214170837697
149,0.0149,1,30,1,4121,601489,19,107937,5.571612508799881,0.15214694696839418
150,0.015,0,31,0,4152,601458,19,107937,5.571325354774167,0.15215359566954942
151,0.0151,1,45,1,4197,601413,20,107936,5.570908518285227,0.1521620528118035
152,0.0152,0,41,0,4238,601372,20,107936,5.570528733928637,0.15217084820698484
153,0.0153,0,45,0,4283,601327,20,107936,5.5701118974396975,0.15218050286001103
154,0.0154,0,36,0,4319,601291,20,107936,5.569778428248545,0.15218822746454944
155,0.0155,0,42,0,4361,601249,20,107936,5.569389380858868,0.1521972404943703
156,0.0156,0,47,0,4408,601202,20,107936,5.568954018303754,0.1522073277697712
157,0.0157,1,41,1,4449,601161,21,107935,5.568574233947164,0.15221493281586695
158,0.0158,1,45,1,4494,601116,22,107934,5.568157397458224,0.15222339750370215
159,0.0159,1,42,1,4536,601074,23,107933,5.567768350068547,0.15223121915580523
160,0.016,1,44,1,4580,601030,24,107932,5.567360776612694,0.1522394712269487
161,0.0161,0,46,0,4626,600984,24,107932,5.566934677090667,0.15224934971139034
162,0.0162,0,45,0,4671,600939,24,107932,5.566517840601727,0.15225901468673425
163,0.0163,2,32,2,4703,600907,26,107930,5.566221423542925,0.15226349640326337
164,0.0164,0,39,0,4742,600868,26,107930,5.56586016525251,0.15227187435630463
165,0.0165,1,48,1,4790,600820,27,107929,5.565415539664308,0.15228099087265026
166,0.0166,1,46,1,4836,600774,28,107928,5.564989440142281,0.15228967887772293
167,0.0167,0,43,0,4879,600731,28,107928,5.564591129719515,0.15229891950853655
168,0.0168,0,53,0,4932,600678,28,107928,5.564100188965875,0.1523103106662941
169,0.0169,0,40,0,4972,600638,28,107928,5.563729667642373,0.15231890889486654
170,0.017,0,45,0,5017,600593,28,107928,5.563312831153433,0.1523285830624639
171,0.0171,0,52,0,5069,600541,28,107928,5.56283115343288,0.15233976363115395
172,0.0172,0,33,0,5102,600508,28,107928,5.56252547334099,0.1523468598433733
173,0.0173,0,38,0,5140,600470,28,107928,5.562173478083664,0.15235503205824974
174,0.0174,1,58,1,5198,600412,29,107927,5.561636222164585,0.15236631048128085
175,0.0175,1,57,1,5255,600355,30,107926,5.561108229278595,0.15237737564610657
176,0.0176,0,38,0,5293,600317,30,107926,5.560756234021268,0.15238555128677586
177,0.0177,0,46,0,5339,600271,30,107926,5.560330134499241,0.15239544928882784
178,0.0178,1,48,1,5387,600223,31,107925,5.559885508911038,0.1524045820930088
179,0.0179,0,45,0,5432,600178,31,107925,5.559468672422098,0.15241426741589853
180,0.018,0,57,0,5489,600121,31,107925,5.558940679536107,0.15242653725887867
181,0.0181,0,52,0,5541,600069,31,107925,5.558459001815555,0.15243773252315698
182,0.0182,0,46,0,5587,600023,31,107925,5.558032902293527,0.15244763739709696
183,0.0183,0,46,0,5633,599977,31,107925,5.5576068027715,0.15245754355828914
184,0.0184,1,39,1,5672,599938,32,107924,5.557245544481085,0.15246474595330728
185,0.0185,1,56,1,5728,599882,33,107923,5.556726814628182,0.15247561122060455
186,0.0186,0,46,0,5774,599836,33,107923,5.556300715106154,0.15248552120142592
187,0.0187,1,39,1,5813,599797,34,107922,5.555939456815739,0.15249272663302807
188,0.0188,0,42,0,5855,599755,34,107922,5.555550409426062,0.1525017769406099
189,0.0189,0,34,0,5889,599721,34,107922,5.5552354663010854,0.15250910416693164
190,0.019,0,60,0,5949,599661,34,107922,5.554679684315833,0.15252203628408256
191,0.0191,2,52,2,6001,599609,36,107920,5.554198006595279,0.1525308503255697
192,0.0192,0,50,0,6051,599559,36,107920,5.553734854940902,0.15254163021093206
193,0.0193,2,56,2,6107,599503,38,107918,5.5532161250879986,0.15255130961619742
194,0.0194,0,37,0,6144,599466,38,107918,5.552873392863759,0.1525592888728046
195,0.0195,0,54,0,6198,599412,38,107918,5.552373189077032,0.15257093577255312
196,0.0196,0,55,0,6253,599357,38,107918,5.551863722257216,0.15258280018380405
197,0.0197,0,60,0,6313,599297,38,107918,5.551307940271963,0.152595745282552
198,0.0198,1,60,1,6373,599237,39,107917,5.550752158286709,0.15260749426574693
199,0.0199,1,40,1,6413,599197,40,107916,5.550381636963207,0.1526149285899142
200,0.02,1,57,1,6470,599140,41,107915,5.549853644077217,0.1526260333354548
201,0.0201,3,49,3,6519,599091,44,107912,5.5493997554559265,0.15263301570148924
202,0.0202,2,51,2,6570,599040,46,107910,5.548927340768461,0.1526416295353278
203,0.0203,1,55,1,6625,598985,47,107909,5.548417873948646,0.15265230713515746
204,0.0204,0,40,0,6665,598945,47,107909,5.548047352625144,0.15266094554179505
205,0.0205,1,55,1,6720,598890,48,107908,5.547537885805328,0.152671626122315
206,0.0206,1,53,1,6773,598837,49,107907,5.5470469450516875,0.15268187632296842
207,0.0207,0,50,0,6823,598787,49,107907,5.54658379339731,0.15269267886808152
208,0.0208,0,54,0,6877,598733,49,107907,5.546083589610582,0.15270434733386165
209,0.0209,1,65,1,6942,598668,50,107906,5.545481492459891,0.1527171959341838
210,0.021,0,36,0,6978,598632,50,107906,5.545148023268739,0.15272497728359974
211,0.0211,0,63,0,7041,598569,50,107906,5.544564452184223,0.15273859655331046
212,0.0212,2,43,2,7084,598526,52,107904,5.544166141761458,0.15274549495349857
213,0.0213,0,51,0,7135,598475,52,107904,5.543693727073993,0.15275652305631962
214,0.0214,0,65,0,7200,598410,52,107904,5.543091629923302,0.152770580789847
215,0.0215,2,52,2,7252,598358,54,107902,5.542609952202749,0.15277942967179226
216,0.0216,0,57,0,7309,598301,54,107902,5.542081959316759,0.15279176100922823
217,0.0217,1,65,1,7374,598236,55,107901,5.541479862166067,0.15280462573126743
218,0.0218,0,73,0,7447,598163,55,107901,5.540803660750676,0.15282042421083641
219,0.0219,0,59,0,7506,598104,55,107901,5.54025714179851,0.15283319523232838
220,0.022,2,54,2,7560,598050,57,107899,5.539756938011783,0.15284248578863346
221,0.0221,0,45,0,7605,598005,57,107899,5.539340101522843,0.15285222919830457
222,0.0222,0,41,0,7646,597964,57,107899,5.538960317166253,0.15286110760870028
223,0.0223,0,59,0,7705,597905,57,107899,5.538413798214087,0.1528738856679758
224,0.0224,1,62,1,7767,597843,58,107898,5.537839490162659,0.15288611544461778
225,0.0225,0,46,0,7813,597797,58,107898,5.537413390640632,0.15289608116821007
226,0.0226,0,49,0,7862,597748,58,107898,5.536959502019341,0.1529066982594672
227,0.0227,1,59,1,7921,597689,59,107897,5.5364129830671756,0.15291828352603368
228,0.0228,1,61,1,7982,597628,60,107896,5.535847938048835,0.15293030428447507
229,0.0229,0,47,0,8029,597581,60,107896,5.535412575493719,0.15294049274462526
230,0.023,0,51,0,8080,597530,60,107896,5.534940160806254,0.1529515498436406
231,0.0231,1,61,1,8141,597469,61,107895,5.534375115787913,0.15296357625282833
232,0.0232,1,55,1,8196,597414,62,107894,5.533865648968098,0.15297430342488672
233,0.0233,1,68,1,8264,597346,63,107893,5.533235762718144,0.15298785234509152
234,0.0234,0,50,0,8314,597296,63,107893,5.532772611063766,0.15299869963938745
235,0.0235,0,37,0,8351,597259,63,107893,5.532429878839527,0.1530067276275186
236,0.0236,0,43,0,8394,597216,63,107893,5.5320315684167625,0.1530160585101027
237,0.0237,0,63,0,8457,597153,63,107893,5.531447997332246,0.15302973139341264
238,0.0238,1,59,1,8516,597094,64,107892,5.5309014783800805,0.15304133699108918
239,0.0239,0,41,0,8557,597053,64,107892,5.530521694023491,0.15305023796182682
240,0.024,0,50,0,8607,597003,64,107892,5.5300585423691135,0.15306109420551997
241,0.0241,1,53,1,8660,596950,65,107891,5.529567601615473,0.15307140191901436
242,0.0242,0,60,0,8720,596890,65,107891,5.529011819630219,0.15308443332042151
243,0.0243,0,50,0,8770,596840,65,107891,5.528548667975842,0.15309529451663118
244,0.0244,0,54,0,8824,596786,65,107891,5.528048464189114,0.15310702633972728
245,0.0245,0,62,0,8886,596724,65,107891,5.527474156137686,0.15312049842821968
246,0.0246,0,60,0,8946,596664,65,107891,5.526918374152433,0.1531335381907729
247,0.0247,0,70,0,9016,596594,65,107891,5.526269961836304,0.15314875405438014
248,0.0248,2,68,2,9084,596526,67,107889,5.52564007558635,0.1531611337066928
249,0.0249,1,60,1,9144,596466,68,107888,5.525084293601097,0.15317297836031313
250,0.025,0,51,0,9195,596415,68,107888,5.524611878913632,0.15318406992445013
251,0.0251,0,62,0,9257,596353,68,107888,5.524037570862203,0.1531975559503068
252,0.0252,0,65,0,9322,596288,68,107888,5.523435473711512,0.15321169707573107
253,0.0253,1,57,1,9379,596231,69,107887,5.522907480825522,0.15322289729846417
254,0.0254,0,58,0,9437,596173,69,107887,5.522370224906443,0.15323551970002558
255,0.0255,0,63,0,9500,596110,69,107887,5.521786653821928,0.15324923259616163
256,0.0256,0,62,0,9562,596048,69,107887,5.521212345770499,0.1532627302236712
257,0.0257,0,54,0,9616,595994,69,107887,5.520712141983771,0.1532744881592201
258,0.0258,0,58,0,9674,595936,69,107887,5.520174886064693,0.15328711906260523
259,0.0259,0,54,0,9728,595882,69,107887,5.519674682277965,0.15329888074069759
260,0.026,1,62,1,9790,595820,70,107886,5.519100374226537,0.1533111839319261
261,0.0261,0,41,0,9831,595779,70,107886,5.518720589869947,0.15332011681695124
262,0.0262,1,55,1,9886,595724,71,107885,5.518211123050132,0.1533308982687828
263,0.0263,1,69,1,9955,595655,72,107884,5.51757197376709,0.15334473284352396
264,0.0264,0,65,0,10020,595590,72,107884,5.5169698766163995,0.15335890167937977
265,0.0265,0,57,0,10077,595533,72,107884,5.516441883730408,0.15337132881349186
266,0.0266,1,54,1,10131,595479,73,107883,5.515941679943681,0.15338190007421498
267,0.0267,1,41,1,10172,595438,74,107882,5.515561895587091,0.1533896377182506
268,0.0268,1,60,1,10232,595378,75,107881,5.515006113601838,0.15340152063464527
269,0.0269,0,55,0,10287,595323,75,107881,5.514496646782022,0.1534135186944329
270,0.027,2,56,2,10343,595267,77,107879,5.513977916929119,0.15342332886768892
271,0.0271,0,49,0,10392,595218,77,107879,5.513524028307829,0.15343402119479957
272,0.0272,1,54,1,10446,595164,78,107878,5.513023824521102,0.15344460217170525
273,0.0273,1,67,1,10513,595097,79,107877,5.5124032013042354,0.15345802262957095
274,0.0274,0,44,0,10557,595053,79,107877,5.511995627848383,0.1534676283555973
275,0.0275,0,52,0,10609,595001,79,107877,5.51151395012783,0.15347898212776612
276,0.0276,2,50,2,10659,594951,81,107875,5.511050798473452,0.15348749192545524
277,0.0277,1,55,1,10714,594896,82,107874,5.510541331653637,0.15349829958592426
278,0.0278,1,57,1,10771,594839,83,107873,5.510013338767646,0.15350954587370075
279,0.0279,0,58,0,10829,594781,83,107873,5.509476082848568,0.15352221719366857
280,0.028,0,64,0,10893,594717,83,107873,5.508883248730965,0.15353620176774505
281,0.0281,0,66,0,10959,594651,83,107873,5.508271888547186,0.1535506260284346
282,0.0282,1,59,1,11018,594592,84,107872,5.50772536959502,0.15356231778425655
283,0.0283,0,47,0,11065,594545,84,107872,5.507290007039905,0.15357259291845157
284,0.0284,0,48,0,11113,594497,84,107872,5.506845381451702,0.15358308809187193
285,0.0285,2,65,2,11178,594432,86,107870,5.506243284301012,0.15359489222585157
286,0.0286,0,71,0,11249,594361,86,107870,5.505585608951796,0.15361042164188138
287,0.0287,1,45,1,11294,594316,87,107869,5.505168772462855,0.15361906050399823
288,0.0288,0,52,0,11346,594264,87,107869,5.5046870947423026,0.1536304375381872
289,0.0289,1,68,1,11414,594196,88,107868,5.504057208492349,0.15364411221768956
290,0.029,1,57,1,11471,594139,89,107867,5.503529215606358,0.1536553818628331
291,0.0291,0,64,0,11535,594075,89,107867,5.502936381488754,0.15366939148818565
292,0.0292,0,56,0,11591,594019,89,107867,5.502417651635851,0.15368165200616624
293,0.0293,1,66,1,11657,593953,90,107866,5.501806291452073,0.1536948985422167
294,0.0294,0,53,0,11710,593900,90,107866,5.501315350698433,0.1537065061573231
295,0.0295,1,57,1,11767,593843,91,107865,5.500787357812442,0.1537177857456378
296,0.0296,0,69,0,11836,593774,91,107865,5.500148208529401,0.1537329025324989
297,0.0297,0,61,0,11897,593713,91,107865,5.49958316351106,0.1537462691247445
298,0.0298,1,73,1,11970,593640,92,107864,5.498906962095669,0.15376106194690264
299,0.0299,1,53,1,12023,593587,93,107863,5.498416021342028,0.1537714733765771
300,0.03,2,65,2,12088,593522,95,107861,5.4978139241913375,0.15378331097274955
301,0.0301,0,56,0,12144,593466,95,107861,5.4972951943384345,0.15379559035941864
302,0.0302,1,72,1,12216,593394,96,107860,5.49662825595613,0.15381017434481656
303,0.0303,3,66,3,12282,593328,99,107857,5.496016895772351,0.15382103153946533
304,0.0304,0,63,0,12345,593265,99,107857,5.495433324687836,0.1538348532780315
305,0.0305,0,76,0,12421,593189,99,107857,5.494729334173182,0.15385153042738992
306,0.0306,1,77,1,12498,593112,100,107856,5.49401608062544,0.15386722361077823
307,0.0307,0,67,0,12565,593045,100,107856,5.493395457408574,0.15388193197042094
308,0.0308,1,57,1,12622,592988,101,107855,5.4928674645225835,0.15389323999811655
309,0.0309,0,48,0,12670,592940,101,107855,5.492422838934381,0.15390378070619795
310,0.031,0,74,0,12744,592866,101,107855,5.4917373744859015,0.15392003379376384
311,0.0311,1,52,1,12796,592814,102,107854,5.491255696765349,0.15393024941912575
312,0.0312,0,75,0,12871,592739,102,107854,5.4905609692837825,0.1539467279861489
313,0.0313,1,64,1,12935,592675,103,107853,5.489968135166179,0.15395958477034466
314,0.0314,0,60,0,12995,592615,103,107853,5.489412353180925,0.15397277248925004
315,0.0315,1,54,1,13049,592561,104,107852,5.4889121493941975,0.1539834354873482
316,0.0316,0,52,0,13101,592509,104,107852,5.488430471673645,0.15399486836074538
317,0.0317,2,75,2,13176,592434,106,107850,5.487735744192078,0.1540089449423377
318,0.0318,1,54,1,13230,592380,107,107849,5.48723554040535,0.15401961358355623
319,0.0319,0,76,0,13306,592304,107,107849,5.486531549890696,0.15403633205885
320,0.032,1,70,1,13376,592234,108,107848,5.485883137574567,0.15405052550986884
321,0.0321,0,72,0,13448,592162,108,107848,5.485216199192264,0.1540663704804217
322,0.0322,2,71,2,13519,592091,110,107846,5.484558523843047,0.15407958144804462
323,0.0323,1,63,1,13582,592028,111,107845,5.4839749527585315,0.1540922424497016
324,0.0324,1,59,1,13641,591969,112,107844,5.483428433806366,0.1541040249323748
325,0.0325,2,44,2,13685,591925,114,107842,5.483020860350513,0.15411129704601675
326,0.0326,1,61,1,13746,591864,115,107841,5.482455815332172,0.15412352348489722
327,0.0327,0,61,0,13807,591803,115,107841,5.481890770313831,0.1541369610830651
328,0.0328,0,56,0,13863,591747,115,107841,5.481372040460928,0.15414929930187482
329,0.0329,0,56,0,13919,591691,115,107841,5.480853310608025,0.15416163949612027
330,0.033,0,61,0,13980,591630,115,107841,5.480288265589684,0.15417508374185634
331,0.0331,0,71,0,14051,591559,115,107841,5.479630590240468,0.15419073491564197
332,0.0332,0,63,0,14114,591496,115,107841,5.479047019155953,0.1542046252379039
333,0.0333,0,65,0,14179,591431,115,107841,5.478444922005261,0.15421895914608336
334,0.0334,0,68,0,14247,591363,115,107841,5.477815035755308,0.15423395747163918
335,0.0335,0,57,0,14304,591306,115,107841,5.4772870428693174,0.15424653184523426
336,0.0336,1,76,1,14380,591230,116,107840,5.476583052354663,0.15426209106384195
337,0.0337,1,59,1,14439,591171,117,107839,5.476036533402497,0.15427390166092045
338,0.0338,0,58,0,14497,591113,117,107839,5.4754992774834195,0.15428670352184412
339,0.0339,1,73,1,14570,591040,118,107838,5.474823076068028,0.1543016091506672
340,0.034,0,65,0,14635,590975,118,107838,5.474220978917336,0.15431596149470603
341,0.0341,0,67,0,14702,590908,118,107838,5.47360035570047,0.15433075824405434
342,0.0342,1,73,1,14775,590835,119,107837,5.472924154285079,0.1543456729337944
343,0.0343,2,70,2,14845,590765,121,107835,5.47227574196895,0.15435871743486973
344,0.0344,1,71,1,14916,590694,122,107834,5.471618066619734,0.15437319620688075
345,0.0345,2,77,2,14993,590617,124,107832,5.470904813071992,0.15438779352536836
346,0.0346,1,55,1,15048,590562,125,107831,5.470395346252177,0.1543987411099481
347,0.0347,1,48,1,15096,590514,126,107830,5.469950720663975,0.15440814269185388
348,0.0348,2,72,2,15168,590442,128,107828,5.4692837822816704,0.1544216420582296
349,0.0349,1,61,1,15229,590381,129,107827,5.4687187372633295,0.15443392226958155
350,0.035,0,66,0,15295,590315,129,107827,5.4681073770795505,0.1544485219339332
351,0.0351,0,78,0,15373,590237,129,107827,5.467384860498722,0.15446577964198124
352,0.0352,0,61,0,15434,590176,129,107827,5.466819815480381,0.15447927874235498
353,0.0353,1,60,1,15494,590116,130,107826,5.466264033495127,0.15449134741855342
354,0.0354,0,76,0,15570,590040,130,107826,5.465560042980473,0.15450817205595344
355,0.0355,1,54,1,15624,589986,131,107825,5.465059839193746,0.15451891701334602
356,0.0356,0,52,0,15676,589934,131,107825,5.4645781614731925,0.15453043242724207
357,0.0357,3,60,3,15736,589874,134,107822,5.46402237948794,0.15454008622666607
358,0.0358,0,57,0,15793,589817,134,107822,5.4634943866019485,0.15455271279271945
359,0.0359,1,70,1,15863,589747,135,107821,5.46284597428582,0.15456700995458508
360,0.036,1,71,1,15934,589676,136,107820,5.462188298936604,0.15458153165036073
361,0.0361,2,76,2,16010,589600,138,107818,5.46148430842195,0.15459595249907515
362,0.0362,2,61,2,16071,589539,140,107816,5.460919263403609,0.15460705092814994
363,0.0363,0,65,0,16136,589474,140,107816,5.460317166252918,0.1546214630928308
364,0.0364,1,52,1,16188,589422,141,107815,5.459835488532365,0.15463178230644672
365,0.0365,1,69,1,16257,589353,142,107814,5.459196339249324,0.15464587394411955
366,0.0366,1,63,1,16320,589290,143,107813,5.458612768164808,0.15465863724585893
367,0.0367,1,50,1,16370,589240,144,107812,5.45814961651043,0.15466851827410294
368,0.0368,2,62,2,16432,589178,146,107810,5.457575308459002,0.15467985101608636
369,0.0369,0,85,0,16517,589093,146,107810,5.45678795064656,0.15469871703809568
370,0.037,1,78,1,16595,589015,147,107809,5.456065434065731,0.15471482038506137
371,0.0371,1,49,1,16644,588966,148,107808,5.45561154544444,0.15472448742346873
372,0.0372,1,70,1,16714,588896,149,107807,5.454963133128311,0.15473881984145324
373,0.0373,1,66,1,16780,588830,150,107806,5.454351772944533,0.15475226660695113
374,0.0374,0,69,0,16849,588761,150,107806,5.453712623661492,0.1547675959383663
375,0.0375,1,53,1,16902,588708,151,107805,5.453221682907851,0.15477815920162294
376,0.0376,0,70,0,16972,588638,151,107805,5.4525732705917225,0.1547937160686517
377,0.0377,0,67,0,17039,588571,151,107805,5.451952647374856,0.15480860914218755
378,0.0378,0,64,0,17103,588507,151,107805,5.451359813257253,0.15482283803812083
379,0.0379,1,67,1,17170,588440,152,107804,5.4507391900403865,0.1548365228282039
380,0.038,0,65,0,17235,588375,152,107804,5.450137092889696,0.15485097941764978
381,0.0381,0,67,0,17302,588308,152,107804,5.4495164696728295,0.15486588365090675
382,0.0382,1,84,1,17386,588224,153,107803,5.448738374893475,0.15488335940990794
383,0.0383,0,68,0,17454,588156,153,107803,5.448108488643522,0.15489849258361485
384,0.0384,0,61,0,17515,588095,153,107803,5.447543443625181,0.15491207044710575
385,0.0385,4,68,4,17583,588027,157,107799,5.446913557375227,0.15492235127747453
386,0.0386,1,77,1,17660,587950,158,107798,5.446200303827485,0.15493828225161985
387,0.0387,0,69,0,17729,587881,158,107798,5.4455611545444444,0.1549536495998873
388,0.0388,2,56,2,17785,587825,160,107796,5.445042424691541,0.1549636943105513
389,0.0389,0,66,0,17851,587759,160,107796,5.4444310645077625,0.15497839854504677
390,0.039,0,92,0,17943,587667,160,107796,5.443578865463707,0.15499890001337238
391,0.0391,0,79,0,18022,587588,160,107796,5.442847085849791,0.15501650886416712
392,0.0392,0,47,0,18069,587541,160,107796,5.442411723294676,0.15502698691425884
393,0.0393,1,74,1,18143,587467,161,107795,5.441726258846197,0.155042271834215
394,0.0394,2,61,2,18204,587406,163,107793,5.441161213827856,0.155053445128661
395,0.0395,2,64,2,18268,587342,165,107791,5.440568379710252,0.15506528966399236
396,0.0396,1,62,1,18330,587280,166,107790,5.439994071658824,0.15507790582243516
397,0.0397,0,58,0,18388,587222,166,107790,5.439456815739746,0.15509084735227593
398,0.0398,1,65,1,18453,587157,167,107789,5.438854718589055,0.1551041375876687
399,0.0399,0,75,0,18528,587082,167,107789,5.438159991107488,0.15512087855155848
400,0.04,1,56,1,18584,587026,168,107788,5.437641261254585,0.1551321648671443
401,0.0401,0,65,0,18649,586961,168,107788,5.437039164103894,0.15514667887251368
402,0.0402,1,75,1,18724,586886,169,107787,5.436344436622328,0.15516221301245334
403,0.0403,1,95,1,18819,586791,170,107786,5.43546444847901,0.155182218818072
404,0.0404,0,85,0,18904,586706,170,107786,5.434677090666568,0.15520121182101448
405,0.0405,2,70,2,18974,586636,172,107784,5.4340286783504395,0.15521442354770887
406,0.0406,3,85,3,19059,586551,175,107781,5.433241320537997,0.15522977480513644
407,0.0407,0,63,0,19122,586488,175,107781,5.432657749453481,0.15524386080899477
408,0.0408,0,70,0,19192,586418,175,107781,5.432009337137353,0.15525951492295437
409,0.0409,1,58,1,19250,586360,176,107780,5.431472081218274,0.1552712709251736
410,0.041,0,54,0,19304,586306,176,107780,5.4309718774315465,0.15528335105448027
411,0.0411,0,64,0,19368,586242,176,107780,5.430379043313943,0.15529767067902747
412,0.0412,0,71,0,19439,586171,176,107780,5.429721367964726,0.15531355960291143
413,0.0413,1,80,1,19519,586091,177,107779,5.428980325317722,0.15533024918212346
414,0.0414,2,83,2,19602,586008,179,107777,5.428211493571455,0.15534639693853283
415,0.0415,0,61,0,19663,585947,179,107777,5.427646448553114,0.1553600567372615
416,0.0416,1,64,1,19727,585883,180,107776,5.42705361443551,0.1553731732738997
417,0.0417,1,87,1,19814,585796,181,107775,5.426247730556893,0.15539144514404438
418,0.0418,2,59,2,19873,585737,183,107773,5.425701211604728,0.1554022292396649
419,0.0419,0,80,0,19953,585657,183,107773,5.424960168957724,0.15542015776646526
420,0.042,0,56,0,20009,585601,183,107773,5.424441439104821,0.15543271019680577
421,0.0421,0,65,0,20074,585536,183,107773,5.423839341954129,0.15544728252481937
422,0.0422,0,71,0,20145,585465,183,107773,5.423181666604913,0.15546320311350503
423,0.0423,1,72,1,20217,585393,184,107772,5.422514728222609,0.1554781329120772
424,0.0424,1,66,1,20283,585327,185,107771,5.421903368038831,0.155491719785658
425,0.0425,1,68,1,20351,585259,186,107770,5.421273481788877,0.15550575805630068
426,0.0426,1,72,1,20423,585187,187,107769,5.420606543406573,0.15552069684078065
427,0.0427,2,88,2,20511,585099,189,107767,5.419791396494868,0.15553801167902595
428,0.0428,2,59,2,20570,585040,191,107765,5.4192448775427025,0.15554881965343784
429,0.0429,1,88,1,20658,584952,192,107764,5.418429730630998,0.15556736093868195
430,0.043,0,62,0,20720,584890,192,107764,5.41785542257957,0.15558128589454476
431,0.0431,3,69,3,20789,584821,195,107761,5.417216273296528,0.15559312832271124
432,0.0432,1,77,1,20866,584744,196,107760,5.416503019748786,0.15560920947749038
433,0.0433,2,66,2,20932,584678,198,107758,5.415891659565008,0.1556216025741007
434,0.0434,1,72,1,21004,584606,199,107757,5.415224721182704,0.15563656636764242
435,0.0435,4,85,4,21089,584521,203,107753,5.414437363370262,0.1556507972276873
436,0.0436,1,79,1,21168,584442,204,107752,5.413705583756345,0.155667341814578
437,0.0437,2,72,2,21240,584370,206,107750,5.413038645374042,0.1556810957637404
438,0.0438,2,60,2,21300,584310,208,107748,5.412482863388788,0.1556921529698378
439,0.0439,1,67,1,21367,584243,209,107747,5.411862240171922,0.1557060073122444
440,0.044,1,78,1,21445,584165,210,107746,5.411139723591092,0.15572234001193797
441,0.0441,1,57,1,21502,584108,211,107745,5.410611730705102,0.1557339492637887
442,0.0442,1,74,1,21576,584034,212,107744,5.409926266256623,0.15574938780938394
443,0.0443,0,62,0,21638,583972,212,107744,5.409351958205194,0.15576334796361513
444,0.0444,1,84,1,21722,583888,213,107743,5.40857386342584,0.1557810450948555
445,0.0445,1,84,1,21806,583804,214,107742,5.407795768646485,0.1557987465765112
446,0.0446,1,70,1,21876,583734,215,107741,5.4071473563303565,0.15581329766079757
447,0.0447,0,90,0,21966,583644,215,107741,5.406313683352477,0.15583358042190676
448,0.0448,0,66,0,22032,583578,215,107741,5.405702323168699,0.15584845780312706
449,0.0449,0,68,0,22100,583510,215,107741,5.405072436918744,0.15586378898547706
450,0.045,2,81,2,22181,583429,217,107739,5.4043221312386525,0.15587961248205937
451,0.0451,1,74,1,22255,583355,218,107738,5.403636666790174,0.15589508213800457
452,0.0452,0,80,0,22335,583275,218,107738,5.402895624143169,0.1559131304331467
453,0.0453,0,78,0,22413,583197,218,107738,5.40217310756234,0.15593073154493547
454,0.0454,1,79,1,22492,583118,219,107737,5.401441327948423,0.1559473406141665
455,0.0455,0,56,0,22548,583062,219,107737,5.40092259809552,0.155959982570907
456,0.0456,0,75,0,22623,582987,219,107737,5.4002278706139535,0.1559769169740736
457,0.0457,1,74,1,22697,582913,220,107736,5.399542406165475,0.15599240714168847
458,0.0458,0,67,0,22764,582846,220,107736,5.398921782948609,0.15600754146502516
459,0.0459,0,79,0,22843,582767,220,107736,5.398190003334692,0.15602539018657413
460,0.046,2,83,2,22926,582684,222,107734,5.397421171588425,0.1560417022731157
461,0.0461,0,67,0,22993,582617,222,107734,5.396800548371559,0.15605684644477955
462,0.0462,3,69,3,23062,582548,225,107731,5.396161399088517,0.15606877798687196
463,0.0463,3,77,3,23139,582471,228,107728,5.395448145540776,0.15608252112796453
464,0.0464,1,72,1,23211,582399,229,107727,5.394781207158472,0.15609758218064526
465,0.0465,1,76,1,23287,582323,230,107726,5.394077216643818,0.15611355135649788
466,0.0466,0,76,0,23363,582247,230,107726,5.393373226129164,0.15613074714517813
467,0.0467,0,96,0,23459,582151,230,107726,5.392483974952759,0.15615247355688042
468,0.0468,0,78,0,23537,582073,230,107726,5.3917614583719295,0.1561701307192385
469,0.0469,1,86,1,23623,581987,231,107725,5.3909648375264,0.15618838007748162
470,0.047,0,81,0,23704,581906,231,107725,5.390214531846308,0.15620672504571284
471,0.0471,1,60,1,23764,581846,232,107724,5.389658749861055,0.15621909305799267
472,0.0472,0,60,0,23824,581786,232,107724,5.389102967875801,0.1562326869806094
473,0.0473,2,79,2,23903,581707,234,107722,5.3883711882618845,0.15624814157803052
474,0.0474,1,87,1,23990,581620,235,107721,5.387565304383267,0.1562666372666068
475,0.0475,1,94,1,24084,581526,236,107720,5.386694579273037,0.15628672491389142
476,0.0476,0,71,0,24155,581455,236,107720,5.386036903923821,0.15630282584249283
477,0.0477,0,67,0,24222,581388,236,107720,5.385416280706955,0.15631802271922543
478,0.0478,1,68,1,24290,581320,237,107719,5.384786394457001,0.1563322250264499
479,0.0479,1,75,1,24365,581245,238,107718,5.384091666975435,0.15634801868895717
480,0.048,1,70,1,24435,581175,239,107717,5.383443254659306,0.15636268094273123
481,0.0481,2,75,2,24510,581100,241,107715,5.382748527177739,0.15637725659284424
482,0.0482,0,84,0,24594,581016,241,107715,5.381970432398385,0.15639632890054317
483,0.0483,0,75,0,24669,580941,241,107715,5.381275704916818,0.15641336167839967
484,0.0484,0,67,0,24736,580874,241,107715,5.380655081699952,0.15642858076443278
485,0.0485,2,94,2,24830,580780,243,107713,5.379784356589722,0.15644748748353288
486,0.0486,0,77,0,24907,580703,243,107713,5.37907110304198,0.15646498628736114
487,0.0487,1,78,1,24985,580625,244,107712,5.378348586461151,0.15648149089762717
488,0.0488,0,76,0,25061,580549,244,107712,5.377644595946497,0.15649877008867275
489,0.0489,0,82,0,25143,580467,244,107712,5.3768850272333175,0.15651741770673036
490,0.049,4,66,4,25209,580401,248,107708,5.376273667049539,0.15652752688890859
491,0.0491,0,66,0,25275,580335,248,107708,5.3756623068657605,0.1565425416725408
492,0.0492,1,87,1,25362,580248,249,107707,5.3748564229871425,0.15656111228205333
493,0.0493,1,73,1,25435,580175,250,107706,5.374180221571751,0.156576500877332
494,0.0494,2,80,2,25515,580095,252,107704,5.373439178924747,0.15659226023881978
495,0.0495,0,63,0,25578,580032,252,107704,5.372855607840231,0.1566066048600044
496,0.0496,2,82,2,25660,579950,254,107702,5.372096039127052,0.15662282666232338
497,0.0497,1,88,1,25748,579862,255,107701,5.371280892215347,0.15664164592917304
498,0.0498,3,82,3,25830,579780,258,107698,5.370521323502167,0.1566566493764164
499,0.0499,0,78,0,25908,579702,258,107698,5.369798806921338,0.15667442537096304
500,0.05,0,75,0,25983,579627,258,107698,5.369104079439772,0.15669152147819446
501,0.0501,1,84,1,26067,579543,259,107697,5.368325984660417,0.1567094464815785
502,0.0502,2,59,2,26126,579484,261,107695,5.367779465708251,0.15672044692867507
503,0.0503,0,81,0,26207,579403,261,107695,5.367029160028159,0.15673892224981006
504,0.0504,0,96,0,26303,579307,261,107695,5.366139908851754,0.15676082456819632
505,0.0505,1,76,1,26379,579231,262,107694,5.3654359183371,0.15677694071405177
506,0.0506,1,81,1,26460,579150,263,107693,5.364685612657008,0.1567942018772849
507,0.0507,1,74,1,26534,579076,264,107692,5.36400014820853,0.1568098688348904
508,0.0508,1,77,1,26611,578999,265,107691,5.363286894660788,0.1568262243515997
509,0.0509,1,70,1,26681,578929,266,107690,5.362638482344659,0.15684098459261978
510,0.051,1,62,1,26743,578867,267,107689,5.362064174293231,0.1568539201463537
511,0.0511,1,91,1,26834,578776,268,107688,5.361221238282263,0.15687348498974454
512,0.0512,0,78,0,26912,578698,268,107688,5.3604987217014335,0.15689131188573194
513,0.0513,2,87,2,26999,578611,270,107686,5.359692837822816,0.1569087435906029
514,0.0514,0,65,0,27064,578546,270,107686,5.3590907406721255,0.1569236060107952
515,0.0515,1,83,1,27147,578463,271,107685,5.358321908925858,0.15694135959005928
516,0.0516,1,67,1,27214,578396,272,107684,5.357701285708993,0.15695545708955225
517,0.0517,1,72,1,27286,578324,273,107683,5.357034347326689,0.1569707014651454
518,0.0518,0,78,0,27364,578246,273,107683,5.3563118307458595,0.15698855129320965
519,0.0519,2,69,2,27433,578177,275,107681,5.355672681462818,0.15700188668791498
520,0.052,0,78,0,27511,578099,275,107681,5.354950164881989,0.15701974394120563
521,0.0521,0,76,0,27587,578023,275,107681,5.354246174367335,0.15703714722387502
522,0.0522,1,88,1,27675,577935,276,107680,5.35343102745563,0.15705607374401084
523,0.0523,1,78,1,27753,577857,277,107679,5.352708510874801,0.15707271390561545
524,0.0524,1,69,1,27822,577788,278,107678,5.352069361591759,0.15708729535819427
525,0.0525,0,84,0,27906,577704,278,107678,5.351291266812405,0.1571065478813275
526,0.0526,0,81,0,27987,577623,278,107678,5.350540961132313,0.15712511728422984
527,0.0527,2,82,2,28069,577541,280,107676,5.349781392419134,0.1571414602965192
528,0.0528,1,67,1,28136,577474,281,107675,5.349160769202268,0.1571555968117884
529,0.0529,1,93,1,28229,577381,282,107674,5.348299307125125,0.15717570122106983
530,0.053,2,91,2,28320,577290,284,107672,5.347456371114157,0.15719412171770114
531,0.0531,1,79,1,28399,577211,285,107671,5.346724591500241,0.15721102321275782
532,0.0532,0,68,0,28467,577143,285,107671,5.346094705250287,0.15722663380129495
533,0.0533,0,80,0,28547,577063,285,107671,5.345353662603283,0.15724500316911386
534,0.0534,3,60,3,28607,577003,288,107668,5.34479788061803,0.15725509040108315
535,0.0535,1,82,1,28689,576921,289,107667,5.34403831190485,0.1572726954021981
536,0.0536,0,74,0,28763,576847,289,107667,5.343352847456371,0.15728969750801297
537,0.0537,2,73,2,28836,576774,291,107665,5.34267664604098,0.1573040110221656
538,0.0538,1,84,1,28920,576690,292,107664,5.341898551261625,0.15732208769145792
539,0.0539,0,69,0,28989,576621,292,107664,5.341259401978584,0.15733795129222472
540,0.054,5,75,5,29064,576546,297,107659,5.340564674497017,0.15734904012686257
541,0.0541,0,61,0,29125,576485,297,107659,5.339999629478677,0.1573630697630908
542,0.0542,4,58,4,29183,576427,301,107655,5.3394623735595985,0.15737148470504997
543,0.0543,1,82,1,29265,576345,302,107654,5.338702804846419,0.15738911898994004
544,0.0544,0,73,0,29338,576272,302,107654,5.338026603431027,0.15740591818413102
545,0.0545,5,77,5,29415,576195,307,107649,5.337313349883286,0.15741748117991822
546,0.0546,1,88,1,29503,576107,308,107648,5.336498202971581,0.1574365086909785
547,0.0547,0,75,0,29578,576032,308,107648,5.335803475490015,0.15745377954598644
548,0.0548,0,79,0,29657,575953,308,107648,5.335071695876097,0.15747197561150436
549,0.0549,2,96,2,29753,575857,310,107646,5.334182444699692,0.15749162768853978
550,0.055,0,80,0,29833,575777,310,107646,5.333441402052689,0.15751006331364323
551,0.0551,0,95,0,29928,575682,310,107646,5.332561413909371,0.15753196122506322
552,0.0552,2,89,2,30017,575593,312,107644,5.331737003964578,0.15755001558756332
553,0.0553,2,91,2,30108,575502,314,107642,5.3308940679536105,0.15756853606267493
554,0.0554,1,72,1,30180,575430,315,107641,5.330227129571306,0.15758391148211534
555,0.0555,1,86,1,30266,575344,316,107640,5.329430508725777,0.15760252070326683
556,0.0556,0,85,0,30351,575259,316,107640,5.328643150913335,0.15762213738781283
557,0.0557,3,82,3,30433,575177,319,107637,5.327883582200156,0.15763736537329345
558,0.0558,1,84,1,30517,575093,320,107636,5.327105487420801,0.1576555265705719
559,0.0559,1,91,1,30608,575002,321,107635,5.326262551409834,0.1576753091320863
560,0.056,2,80,2,30688,574922,323,107633,5.325521508762829,0.15769132157848084
561,0.0561,0,84,0,30772,574838,323,107633,5.324743413983475,0.1577107305658409
562,0.0562,1,83,1,30855,574755,324,107632,5.3239745822372075,0.15772867888749345
563,0.0563,0,63,0,30918,574692,324,107632,5.323391011152692,0.15774324221337663
564,0.0564,4,74,4,30992,574618,328,107628,5.322705546704213,0.1577554137363942
565,0.0565,1,85,1,31077,574533,329,107627,5.321918188891771,0.15777383605019352
566,0.0566,1,85,1,31162,574448,330,107626,5.321130831079329,0.15779226300958546
567,0.0567,2,74,2,31236,574374,332,107624,5.3204453666308495,0.15780691438977826
568,0.0568,1,78,1,31314,574296,333,107623,5.31972285005002,0.15782372979782056
569,0.0569,1,82,1,31396,574214,334,107622,5.318963281336841,0.157841475076118
570,0.057,0,75,0,31471,574139,334,107622,5.318268553855274,0.15785883909463874
571,0.0571,0,83,0,31554,574056,334,107622,5.317499722109007,0.1578780597290803
572,0.0572,1,98,1,31652,573958,335,107621,5.316591944866427,0.1578995244865232
573,0.0573,3,79,3,31731,573879,338,107618,5.31586016525251,0.15791412141212655
574,0.0574,1,75,1,31806,573804,339,107617,5.315165437770943,0.1579302663111351
575,0.0575,1,78,1,31884,573726,340,107616,5.314442921190114,0.15794711026180686
576,0.0576,2,81,2,31965,573645,342,107614,5.313692615510023,0.15796341773099512
577,0.0577,0,85,0,32050,573560,342,107614,5.31290525769758,0.1579831291270659
578,0.0578,0,66,0,32116,573494,342,107614,5.312293897513802,0.1579984378395203
579,0.0579,0,84,0,32200,573410,342,107614,5.311515802734448,0.15801792594680952
580,0.058,1,69,1,32269,573341,343,107613,5.310876653451406,0.1580327011809902
581,0.0581,0,90,0,32359,573251,343,107613,5.3100429804735265,0.1580535907317761
582,0.0582,2,78,2,32437,573173,345,107611,5.309320463892697,0.15806922606876778
583,0.0583,2,84,2,32521,573089,347,107609,5.308542369113343,0.15808625851699284
584,0.0584,0,99,0,32620,572990,347,107609,5.307625328837674,0.15810925376029056
585,0.0585,1,74,1,32694,572916,348,107608,5.306939864389196,0.1581252093974643
586,0.0586,2,76,2,32770,572840,350,107606,5.306235873874542,0.15814039615193565
587,0.0587,0,68,0,32838,572772,350,107606,5.305605987624588,0.1581562014056892
588,0.0588,0,80,0,32918,572692,350,107606,5.3048649449775835,0.15817479986711705
589,0.0589,4,70,4,32988,572622,354,107602,5.304216532661455,0.158186126922896
590,0.059,1,72,1,33060,572550,355,107601,5.303549594279151,0.15820163463701442
591,0.0591,1,87,1,33147,572463,356,107600,5.3027437104005335,0.15822063544112824
592,0.0592,0,72,0,33219,572391,356,107600,5.302076772018229,0.15823738843602342
593,0.0593,1,71,1,33290,572320,357,107599,5.301419096669013,0.1582526742156051
594,0.0594,2,88,2,33378,572232,359,107597,5.300603949757309,0.1582706827746389
595,0.0595,1,96,1,33474,572136,360,107596,5.299714698580903,0.1582917973554283
596,0.0596,2,71,2,33545,572065,362,107594,5.299057023231687,0.15830585631912475
597,0.0597,3,92,3,33637,571973,365,107591,5.298204824187632,0.15832357217274606
598,0.0598,3,72,3,33709,571901,368,107588,5.297537885805328,0.15833663238109816
599,0.0599,3,85,3,33794,571816,371,107585,5.296750527992886,0.1583527254154763
600,0.06,0,74,0,33868,571742,371,107585,5.296065063544407,0.15836997498995328
601,0.0601,0,82,0,33950,571660,371,107585,5.2953054948312275,0.1583890937732335
602,0.0602,2,86,2,34036,571574,373,107583,5.294508873985698,0.15840667180048207
603,0.0603,2,84,2,34120,571490,375,107581,5.293730779206343,0.15842378779243996
604,0.0604,1,77,1,34197,571413,376,107580,5.293017525658602,0.15844051411428395
605,0.0605,1,89,1,34286,571324,377,107579,5.292193115713809,0.15846004510217218
606,0.0606,0,71,0,34357,571253,377,107579,5.291535440364593,0.15847661866264406
607,0.0607,1,73,1,34430,571180,378,107578,5.290859238949202,0.15849242292540197
608,0.0608,0,68,0,34498,571112,378,107578,5.290229352699248,0.1585083027597283
609,0.0609,2,85,2,34583,571027,380,107576,5.289441994886806,0.15852567701586937
610,0.061,1,85,1,34668,570942,381,107575,5.288654637074363,0.15854429586878444
611,0.0611,1,73,1,34741,570869,382,107574,5.287978435658972,0.1585601148512108
612,0.0612,1,67,1,34808,570802,383,107573,5.287357812442106,0.15857453473373873
613,0.0613,1,89,1,34897,570713,384,107572,5.286533402497314,0.1585941012996012
614,0.0614,2,80,2,34977,570633,386,107570,5.285792359850309,0.15861032758628316
615,0.0615,3,85,3,35062,570548,389,107567,5.285005002037868,0.15862648665786777
616,0.0616,0,58,0,35120,570490,389,107567,5.284467746118789,0.158640055334581
617,0.0617,1,80,1,35200,570410,390,107566,5.2837267034717845,0.15865753360000945
618,0.0618,0,73,0,35273,570337,390,107566,5.283050502056393,0.15867461864012994
619,0.0619,0,68,0,35341,570269,390,107566,5.28242061580644,0.15869053678255032
620,0.062,3,60,3,35401,570209,393,107563,5.281864833821186,0.15870086105652048
621,0.0621,0,87,0,35488,570122,393,107563,5.281058949942569,0.1587212347919756
622,0.0622,1,85,1,35573,570037,394,107562,5.280271592130127,0.1587399036893502
623,0.0623,2,91,2,35664,569946,396,107560,5.279428656119159,0.15875874162000042
624,0.0624,1,99,1,35763,569847,397,107559,5.278511615843492,0.1587807016766902
625,0.0625,0,88,0,35851,569759,397,107559,5.277696468931787,0.15880133113249612
626,0.0626,2,87,2,35938,569672,399,107557,5.27689058505317,0.158819247256098
627,0.0627,1,88,1,36026,569584,400,107556,5.276075438141465,0.158838644888797
628,0.0628,1,81,1,36107,569503,401,107555,5.275325132461373,0.15885640521196115
629,0.0629,1,86,1,36193,569417,402,107554,5.274528511615843,0.15887534325694896
630,0.063,0,68,0,36261,569349,402,107554,5.27389862536589,0.15889130348070551
631,0.0631,1,77,1,36338,569272,403,107553,5.2731853718181485,0.15890813725852326
632,0.0632,1,66,1,36404,569206,404,107552,5.27257401163437,0.15892239175598957
633,0.0633,1,85,1,36489,569121,405,107551,5.271786653821928,0.15894111179419276
634,0.0634,3,84,3,36573,569037,408,107548,5.271008559042573,0.15895711551394134
635,0.0635,1,80,1,36653,568957,409,107547,5.270267516395569,0.1589746697728321
636,0.0636,1,88,1,36741,568869,410,107546,5.269452369483864,0.1589941086463192
637,0.0637,0,98,0,36839,568771,410,107546,5.268544592241284,0.15901714728448346
638,0.0638,0,77,0,36916,568694,410,107546,5.267831338693542,0.15903525375606295
639,0.0639,0,82,0,36998,568612,410,107546,5.267071769980363,0.15905454050680462
640,0.064,1,74,1,37072,568538,411,107545,5.266386305531883,0.15907070581570606
641,0.0641,1,83,1,37155,568455,412,107544,5.265617473785617,0.15908899273519636
642,0.0642,0,80,0,37235,568375,412,107544,5.264876431138612,0.15910782209110855
643,0.0643,3,76,3,37311,568299,415,107541,5.264172440623958,0.1591219815340909
644,0.0644,2,86,2,37397,568213,417,107539,5.263375819778428,0.1591397435745658
645,0.0645,0,82,0,37479,568131,417,107539,5.262616251065249,0.15915905693607826
646,0.0646,0,74,0,37553,568057,417,107539,5.2619307866167695,0.15917649009171161
647,0.0647,1,92,1,37645,567965,418,107538,5.261078587572714,0.15919692436599098
648,0.0648,1,75,1,37720,567890,419,107537,5.2603838600911486,0.15921335688386754
649,0.0649,1,76,1,37796,567814,420,107536,5.259679869576494,0.15923002887391724
650,0.065,1,71,1,37867,567743,421,107535,5.259022194227278,0.15924552554651566
651,0.0651,3,68,3,37935,567675,424,107532,5.258392307977324,0.15925782759953613
652,0.0652,1,90,1,38025,567585,425,107531,5.2575586349994445,0.15927781299806257
653,0.0653,0,82,0,38107,567503,425,107531,5.2567990662862645,0.15929716132817015
654,0.0654,2,75,2,38182,567428,427,107529,5.256104338804699,0.1593123710103014
655,0.0655,1,85,1,38267,567343,428,107528,5.255316980992256,0.15933119070163038
656,0.0656,3,65,3,38332,567278,431,107525,5.254714883841565,0.15934280078778548
657,0.0657,1,86,1,38418,567192,432,107524,5.253918262996035,0.15936186484387505
658,0.0658,4,85,4,38503,567107,436,107520,5.2531309051835935,0.15937695941609215
659,0.0659,1,83,1,38586,567024,437,107519,5.252362073437326,0.15939532394524886
660,0.066,1,84,1,38670,566940,438,107518,5.251583978657972,0.15941392940702015
661,0.0661,3,80,3,38750,566860,441,107515,5.250842936010968,0.15942910101946248
662,0.0662,1,78,1,38828,566782,442,107514,5.2501204194301385,0.15944629658191656
663,0.0663,1,74,1,38902,566708,443,107513,5.249434954981659,0.1594625501133901
664,0.0664,3,84,3,38986,566624,446,107510,5.2486568602023045,0.15947867931301493
665,0.0665,1,79,1,39065,566545,447,107509,5.247925080588388,0.15949612345598424
666,0.0666,0,82,0,39147,566463,447,107509,5.247165511875209,0.1595155288350258
667,0.0667,0,92,0,39239,566371,447,107509,5.246313312831154,0.15953730634534338
668,0.0668,0,85,0,39324,566286,447,107509,5.245525955018711,0.15955743215666487
669,0.0669,0,77,0,39401,566209,447,107509,5.24481270147097,0.15957566815789395
670,0.067,2,69,2,39470,566140,449,107507,5.244173552187928,0.15958951795228066
671,0.0671,1,93,1,39563,566047,450,107506,5.243312090110786,0.1596103053508781
672,0.0672,2,93,2,39656,565954,452,107504,5.242450628033644,0.15962985071080898
673,0.0673,2,90,2,39746,565864,454,107502,5.241616955055764,0.15964869031106413
674,0.0674,0,83,0,39829,565781,454,107502,5.240848123309497,0.159668371249534
675,0.0675,3,90,3,39919,565691,457,107499,5.240014450331617,0.1596859727565769
676,0.0676,0,90,0,40009,565601,457,107499,5.239180777353737,0.159707324320309
677,0.0677,1,75,1,40084,565526,458,107498,5.23848604987217,0.15972387314568276
678,0.0678,3,85,3,40169,565441,461,107495,5.237698692059728,0.1597403021981288
679,0.0679,2,77,2,40246,565364,463,107493,5.2369854385119865,0.15975608487390336
680,0.068,1,91,1,40337,565273,464,107492,5.236142502501019,0.15977644496964022
681,0.0681,1,72,1,40409,565201,465,107491,5.235475564118715,0.15979229721774602
682,0.0682,0,100,0,40509,565101,465,107491,5.23454926080996,0.15981605490401313
683,0.0683,3,86,3,40595,565015,468,107488,5.23375263996443,0.15983274424054614
684,0.0684,2,83,2,40678,564932,470,107486,5.232983808218163,0.15984997427195582
685,0.0685,2,91,2,40769,564841,472,107484,5.232140872207196,0.15986911092105752
686,0.0686,1,82,1,40851,564759,473,107483,5.231381303494016,0.15988736199166373
687,0.0687,1,84,1,40935,564675,474,107482,5.230603208714662,0.15990609336806727
688,0.0688,1,78,1,41013,564597,475,107481,5.2298806921338326,0.1599234017480114
689,0.0689,1,60,1,41073,564537,476,107480,5.229324910148579,0.15993643017959366
690,0.069,2,92,2,41165,564445,478,107478,5.228472711104524,0.1599558282719895
691,0.0691,0,86,0,41251,564359,478,107478,5.227676090258995,0.15997630377606473
692,0.0692,0,89,0,41340,564270,478,107478,5.226851680314202,0.1599974990621483
693,0.0693,0,100,0,41440,564170,478,107478,5.225925377005447,0.16002132069179092
694,0.0694,1,78,1,41518,564092,479,107477,5.225202860424617,0.1600386557449793
695,0.0695,2,86,2,41604,564006,481,107475,5.224406239579087,0.16005665089555773
696,0.0696,1,96,1,41700,563910,482,107474,5.223516988402682,0.16007828604792487
697,0.0697,4,98,4,41798,563812,486,107470,5.222609211160102,0.1600966508859168
698,0.0698,4,93,4,41891,563719,490,107466,5.22174774908296,0.1601138285271572
699,0.0699,1,75,1,41966,563644,491,107465,5.221053021601393,0.1601304706090963
700,0.07,1,83,1,42049,563561,492,107464,5.220284189855126,0.16014902574419732
701,0.0701,4,102,4,42151,563459,496,107460,5.219339360480196,0.16016836607697799
702,0.0702,1,91,1,42242,563368,497,107459,5.218496424469228,0.16018884153440455
703,0.0703,3,84,3,42326,563284,500,107456,5.217718329689873,0.1602051465545517
704,0.0704,5,104,5,42430,563180,505,107451,5.216754974248768,0.16022372959198128
705,0.0705,0,89,0,42519,563091,505,107451,5.215930564303975,0.1602449958391868
706,0.0706,0,84,0,42603,563007,505,107451,5.215152469524621,0.16026507253250763
707,0.0707,1,92,1,42695,562915,506,107450,5.2143002704805665,0.16028581444436985
708,0.0708,2,85,2,42780,562830,508,107448,5.213512912668124,0.16030363520807783
709,0.0709,2,104,2,42884,562726,510,107446,5.212549557227018,0.1603260058611819
710,0.071,1,73,1,42957,562653,511,107445,5.211873355811627,0.16034221860086137
711,0.0711,3,86,3,43043,562567,514,107442,5.211076734966097,0.16035903995319467
712,0.0712,3,85,3,43128,562482,517,107439,5.210289377153655,0.16037562637982689
713,0.0713,0,91,0,43219,562391,517,107439,5.2094464411426875,0.16039741426929222
714,0.0714,2,93,2,43312,562298,519,107437,5.208584979065545,0.16041717992937504
715,0.0715,1,104,1,43416,562194,520,107436,5.20762162362444,0.16044084046413692
716,0.0716,2,92,2,43508,562102,522,107434,5.206769424580385,0.16046037853080342
717,0.0717,1,74,1,43582,562028,523,107433,5.206083960131906,0.16047686123612875
718,0.0718,1,84,1,43666,561944,524,107432,5.2053058653525515,0.16049574529113683
719,0.0719,3,86,3,43752,561858,527,107429,5.204509244507022,0.1605126052052408
720,0.072,2,79,2,43831,561779,529,107427,5.203777464893105,0.1605290448680974
721,0.0721,2,77,2,43908,561702,531,107425,5.203064211345363,0.16054500864559343
722,0.0722,1,88,1,43996,561614,532,107424,5.2022490644336585,0.16056487075472545
723,0.0723,2,115,2,44111,561499,534,107422,5.201183815628589,0.1605899650332401
724,0.0724,2,82,2,44193,561417,536,107420,5.20042424691541,0.16060714344451638
725,0.0725,1,94,1,44287,561323,537,107419,5.19955352180518,0.1606284635928355
726,0.0726,0,76,0,44363,561247,537,107419,5.198849531290525,0.16064672048526468
727,0.0727,2,82,2,44445,561165,539,107417,5.198089962577346,0.16066391257916007
728,0.0728,3,97,3,44542,561068,542,107414,5.197191448367853,0.16068345894130284
729,0.0729,2,100,2,44642,560968,544,107412,5.196265145059098,0.16070498818037643
730,0.073,0,87,0,44729,560881,544,107412,5.195459261180481,0.16072590914464166
731,0.0731,0,89,0,44818,560792,544,107412,5.194634851235689,0.16074731668771813
732,0.0732,1,77,1,44895,560715,545,107411,5.193921597687947,0.16076458632054433
733,0.0733,2,100,2,44995,560615,547,107409,5.192995294379192,0.16078613942014058
734,0.0734,2,101,2,45096,560514,549,107407,5.192059728037348,0.16080793986115124
735,0.0735,3,89,3,45185,560425,552,107404,5.191235318092557,0.1608256005654142
736,0.0736,2,93,2,45278,560332,554,107402,5.190373856015413,0.16084548637631152
737,0.0737,0,94,0,45372,560238,554,107402,5.189503130905184,0.1608681325265113
738,0.0738,1,91,1,45463,560147,555,107401,5.188660194894216,0.16088880499979027
739,0.0739,2,103,2,45566,560044,557,107399,5.187706102486198,0.16091111900192226
740,0.074,3,86,3,45652,559958,560,107396,5.186909481640669,0.16092808314627619
741,0.0741,0,75,0,45727,559883,560,107396,5.186214754159102,0.1609461709419898
742,0.0742,5,95,5,45822,559788,565,107391,5.185334766015784,0.16096280008813227
743,0.0743,2,82,2,45904,559706,567,107389,5.184575197302605,0.16098007030482914
744,0.0744,1,99,1,46003,559607,568,107388,5.183658157026937,0.16100270616721266
745,0.0745,1,72,1,46075,559535,569,107387,5.182991218644633,0.16101882978819113
746,0.0746,3,86,3,46161,559449,572,107384,5.1821945977991035,0.16103582156252016
747,0.0747,2,99,2,46260,559350,574,107382,5.181277557523435,0.1610572163927935
748,0.0748,1,88,1,46348,559262,575,107381,5.180462410611731,0.16107721824124757
749,0.0749,0,103,0,46451,559159,575,107381,5.1795083182037125,0.16110210940078615
750,0.075,1,77,1,46528,559082,576,107380,5.178795064655971,0.16111946367534832
751,0.0751,0,84,0,46612,558998,576,107380,5.178016969876617,0.161139773521935
752,0.0752,0,89,0,46701,558909,576,107380,5.177192559931824,0.16116129787524633
753,0.0753,1,98,1,46799,558811,577,107379,5.176284782689244,0.16118374637866073
754,0.0754,3,97,3,46896,558714,580,107376,5.175386268479751,0.16120344097644462
755,0.0755,1,90,1,46986,558624,581,107375,5.174552595501871,0.16122396580175044
756,0.0756,1,98,1,47084,558526,582,107374,5.173644818259291,0.16124643339840816
757,0.0757,1,105,1,47189,558421,583,107373,5.172672199785097,0.16127060321961448
758,0.0758,1,77,1,47266,558344,584,107372,5.171958946237356,0.16128799668327035
759,0.0759,4,85,4,47351,558259,588,107368,5.171171588424913,0.1613035528907331
760,0.076,1,79,1,47430,558180,589,107367,5.170439808810997,0.16132143935740076
761,0.0761,1,94,1,47524,558086,590,107366,5.169569083700767,0.16134296688566568
762,0.0762,1,81,1,47605,558005,591,107365,5.168818778020675,0.16136134782151285
763,0.0763,1,75,1,47680,557930,592,107364,5.168124050539109,0.16137827787414286
764,0.0764,1,85,1,47765,557845,593,107363,5.167336692726667,0.16139763803201404
765,0.0765,1,99,1,47864,557746,594,107362,5.166419652450998,0.1614204008972979
766,0.0766,2,96,2,47960,557650,596,107360,5.1655304012745935,0.16144118133561902
767,0.0767,5,86,5,48046,557564,601,107355,5.164733780429064,0.16145575626504882
768,0.0768,0,82,0,48128,557482,601,107355,5.163974211715884,0.16147566997624982
769,0.0769,0,81,0,48209,557401,601,107355,5.1632239060357925,0.16149534566066345
770,0.077,1,77,1,48286,557324,602,107354,5.16251065248805,0.16151279266050628
771,0.0771,2,98,2,48384,557226,604,107352,5.16160287524547,0.16153408629235394
772,0.0772,2,85,2,48469,557141,606,107350,5.160815517433028,0.16155222568853453
773,0.0773,2,79,2,48548,557062,608,107348,5.160083737819112,0.16156891076293253
774,0.0774,2,86,2,48634,556976,610,107346,5.159287116973582,0.16158730254304388
775,0.0775,0,94,0,48728,556882,610,107346,5.158416391863351,0.16161017000186684
776,0.0776,1,75,1,48803,556807,611,107345,5.157721664381786,0.16162715763861285
777,0.0777,2,102,2,48905,556705,613,107343,5.156776835006855,0.16164945907524758
778,0.0778,1,66,1,48971,556639,614,107342,5.156165474823076,0.16166426448949595
779,0.0779,4,70,4,49041,556569,618,107338,5.155517062506947,0.1616762588736073
780,0.078,1,81,1,49122,556488,619,107337,5.154766756826856,0.1616947237600271
781,0.0781,2,71,2,49193,556417,621,107335,5.154109081477639,0.161709493907363
782,0.0782,1,102,1,49295,556315,622,107334,5.153164252102709,0.16173308480838516
783,0.0783,1,83,1,49378,556232,623,107333,5.1523954203564415,0.16175205141922797
784,0.0784,3,85,3,49463,556147,626,107330,5.151608062544,0.16176898370252474
785,0.0785,2,111,2,49574,556036,628,107328,5.150579865871281,0.16179352512346162
786,0.0786,2,84,2,49658,555952,630,107326,5.149801771091926,0.16181148779244903
787,0.0787,1,81,1,49739,555871,631,107325,5.1490514654118344,0.16182998691186315
788,0.0788,4,83,4,49822,555788,635,107321,5.148282633665567,0.16184518683956936
789,0.0789,0,103,0,49925,555685,635,107321,5.14732854125755,0.1618703299819308
790,0.079,6,79,6,50004,555606,641,107315,5.146596761643632,0.1618820342092044
791,0.0791,4,92,4,50096,555514,645,107311,5.145744562599577,0.16189944555501076
792,0.0792,1,75,1,50171,555439,646,107310,5.145049835118011,0.16191650232591825
793,0.0793,0,89,0,50260,555350,646,107310,5.144225425173219,0.1619382488757432
794,0.0794,3,81,3,50341,555269,649,107307,5.143475119493127,0.16195425128589022
795,0.0795,2,97,2,50438,555172,651,107305,5.142576605283634,0.16197543461886224
796,0.0796,1,83,1,50521,555089,652,107304,5.1418077735373675,0.16199446552122382
797,0.0797,0,90,0,50611,554999,652,107304,5.140974100559487,0.1620164788623938
798,0.0798,2,86,2,50697,554913,654,107302,5.140177479713958,0.16203498863662102
799,0.0799,3,84,3,50781,554829,657,107299,5.139399384934603,0.16205174830244304
800,0.08,3,85,3,50866,554744,660,107296,5.138612027122161,0.16206875717479308
801,0.0801,2,88,2,50954,554656,662,107294,5.137796880210456,0.16208777097968124
802,0.0802,0,84,0,51038,554572,662,107294,5.137018785431102,0.16210834217198042
803,0.0803,1,90,1,51128,554482,663,107293,5.136185112453222,0.1621291224358732
804,0.0804,2,83,2,51211,554399,665,107291,5.135416280706955,0.16214692680862638
805,0.0805,2,87,2,51298,554312,667,107289,5.134610396828338,0.16216571619450393
806,0.0806,0,94,0,51392,554218,667,107289,5.133739671718107,0.16218875990730258
807,0.0807,1,86,1,51478,554132,668,107288,5.132943050872577,0.1622085815366938
808,0.0808,2,97,2,51575,554035,670,107286,5.132044536663085,0.16222983997181398
809,0.0809,2,81,2,51656,553954,672,107284,5.131294230982993,0.16224717877677933
810,0.081,2,87,2,51743,553867,674,107282,5.130488347104376,0.1622659945035083
811,0.0811,1,82,1,51825,553785,675,107281,5.129728778391196,0.1622848550674214
812,0.0812,1,93,1,51918,553692,676,107280,5.128867316314054,0.16230642145204335
813,0.0813,2,106,2,52024,553586,678,107278,5.127885434806773,0.16232991962037574
814,0.0814,2,96,2,52120,553490,680,107276,5.126996183630368,0.16235096842149868
815,0.0815,2,75,2,52195,553415,682,107274,5.126301456148801,0.1623668624723584
816,0.0816,1,77,1,52272,553338,683,107273,5.12558820260106,0.16238451978547133
817,0.0817,0,90,0,52362,553248,683,107273,5.12475452962318,0.16240664566304477
818,0.0818,6,86,6,52448,553162,689,107267,5.12395790877765,0.16242018445586126
819,0.0819,1,90,1,52538,553072,690,107266,5.123124235799771,0.16244105291532518
820,0.082,2,88,2,52626,552984,692,107264,5.122309088888065,0.16246016648289732
821,0.0821,1,79,1,52705,552905,693,107263,5.121577309274149,0.16247833884708135
822,0.0822,2,87,2,52792,552818,695,107261,5.120771425395532,0.16249721624229826
823,0.0823,2,91,2,52883,552727,697,107259,5.119928489384564,0.16251708369571477
824,0.0824,1,90,1,52973,552637,698,107258,5.119094816406684,0.16253797952704596
825,0.0825,1,88,1,53061,552549,699,107257,5.11827966949498,0.16255838837476472
826,0.0826,3,88,3,53149,552461,702,107254,5.1174645225832744,0.16257626399278477
827,0.0827,0,87,0,53236,552374,702,107254,5.116658638704657,0.16259770658613643
828,0.0828,0,96,0,53332,552278,702,107254,5.115769387528252,0.16262137394394813
829,0.0829,2,72,2,53404,552206,704,107252,5.115102449145948,0.16263658944163237
830,0.083,3,88,3,53492,552118,707,107249,5.114287302234244,0.16265448528664614
831,0.0831,3,93,3,53585,552025,710,107246,5.113425840157101,0.16267361980126532
832,0.0832,1,95,1,53680,551930,711,107245,5.112545852013783,0.16269579398490538
833,0.0833,0,82,0,53762,551848,711,107245,5.111786283300604,0.16271603552154248
834,0.0834,1,91,1,53853,551757,712,107244,5.110943347289637,0.16273723408613947
835,0.0835,2,72,2,53925,551685,714,107242,5.110276408907333,0.1627524748568506
836,0.0836,1,84,1,54009,551601,715,107241,5.109498314127978,0.16277195442913475
837,0.0837,2,83,2,54092,551518,717,107239,5.108729482381711,0.1627899210179171
838,0.0838,0,81,0,54173,551437,717,107239,5.107979176701619,0.1628099399401223
839,0.0839,6,87,6,54260,551350,723,107233,5.107173292823002,0.16282382023222586
840,0.084,1,77,1,54337,551273,724,107232,5.106460039275261,0.1628415881428387
841,0.0841,1,100,1,54437,551173,725,107231,5.105533735966505,0.16286504942254298
842,0.0842,2,85,2,54522,551088,727,107229,5.104746378154063,0.16288353483200343
843,0.0843,2,102,2,54624,550986,729,107227,5.103801548779132,0.162906232480975
844,0.0844,3,80,3,54704,550906,732,107224,5.1030605061321275,0.16292221901448042
845,0.0845,0,85,0,54789,550821,732,107224,5.102273148319686,0.16294326375855755
846,0.0846,3,99,3,54888,550722,735,107221,5.101356108044018,0.16296396496353027
847,0.0847,1,91,1,54979,550631,736,107220,5.10051317203305,0.16298523525843997
848,0.0848,1,85,1,55064,550546,737,107219,5.0997258142206086,0.1630050245908493
849,0.0849,0,90,0,55154,550456,737,107219,5.098892141242729,0.16302733112859696
850,0.085,0,89,0,55243,550367,737,107219,5.098067731297936,0.16304939582047062
851,0.0851,3,95,3,55338,550272,740,107216,5.097187743154619,0.16306913586255567
852,0.0852,2,96,2,55434,550176,742,107214,5.096298491978214,0.16309040295714872
853,0.0853,3,72,3,55506,550104,745,107211,5.09563155359591,0.16310444763925971
854,0.0854,2,104,2,55610,550000,747,107209,5.094668198154804,0.16312771127601722
855,0.0855,2,95,2,55705,549905,749,107207,5.093788210011486,0.16314874785424707
856,0.0856,2,102,2,55807,549803,751,107205,5.092843380636555,0.16317152911380076
857,0.0857,3,103,3,55910,549700,754,107202,5.091889288228537,0.16319329215012285
858,0.0858,2,86,2,55996,549614,756,107200,5.091092667383008,0.16321211180029657
859,0.0859,3,80,3,56076,549534,759,107197,5.0903516247360034,0.16322817104720197
860,0.086,1,101,1,56177,549433,760,107196,5.089416058394161,0.16325200379514154
861,0.0861,3,80,3,56257,549353,763,107193,5.088675015747156,0.1632680726102969
862,0.0862,1,102,1,56359,549251,764,107192,5.087730186372226,0.16329216702744945
863,0.0863,3,89,3,56448,549162,767,107189,5.086905776427433,0.16331048478634144
864,0.0864,5,94,5,56542,549068,772,107184,5.086035051317204,0.16332750223999318
865,0.0865,0,97,0,56639,548971,772,107184,5.085136537107711,0.16335164709557956
866,0.0866,1,93,1,56732,548878,773,107183,5.084275075030568,0.16337352776647293
867,0.0867,1,96,1,56828,548782,774,107182,5.0833858238541625,0.16339616198449916
868,0.0868,2,93,2,56921,548689,776,107180,5.08252436177702,0.16341677987524947
869,0.0869,2,92,2,57013,548597,778,107178,5.081672162732965,0.16343715451183713
870,0.087,3,102,3,57115,548495,781,107175,5.080727333358035,0.163458752116156
871,0.0871,1,85,1,57200,548410,782,107174,5.079939975545592,0.16347866940010738
872,0.0872,1,96,1,57296,548314,783,107173,5.079050724369187,0.16350133564815167
873,0.0873,6,75,6,57371,548239,789,107167,5.078355996887621,0.16351238774133894
874,0.0874,1,92,1,57463,548147,790,107166,5.0775037978435655,0.1635340669267968
875,0.0875,2,97,2,57560,548050,792,107164,5.076605283634073,0.16355572377879593
876,0.0876,1,84,1,57644,547966,793,107163,5.075827188854719,0.16357541797111713
877,0.0877,1,94,1,57738,547872,794,107162,5.074956463744488,0.1635976147803015
878,0.0878,4,105,4,57843,547767,798,107158,5.073983845270296,0.163618734969653
879,0.0879,4,101,4,57944,547666,802,107154,5.073048278928452,0.16363886258819219
880,0.088,1,92,1,58036,547574,803,107153,5.072196079884398,0.16366057914214627
881,0.0881,2,86,2,58122,547488,805,107151,5.071399459038868,0.16367952413467576
882,0.0882,2,106,2,58228,547382,807,107149,5.070417577531587,0.1637034762295445
883,0.0883,1,103,1,58331,547279,808,107148,5.069463485123569,0.1637279635467363
884,0.0884,1,86,1,58417,547193,809,107147,5.068666864278039,0.16374820429746004
885,0.0885,0,91,0,58508,547102,809,107147,5.067823928267072,0.16377098016198727
886,0.0886,1,75,1,58583,547027,810,107146,5.067129200785505,0.16378847797142346
887,0.0887,1,101,1,58684,546926,811,107145,5.066193634443662,0.16381249130446082
888,0.0888,4,106,4,58790,546820,815,107141,5.065211752936381,0.16383392893460008
889,0.0889,1,87,1,58877,546733,816,107140,5.064405869057764,0.16385444879969047
890,0.089,0,93,0,58970,546640,816,107140,5.063544406980622,0.16387775704365382
891,0.0891,0,113,0,59083,546527,816,107140,5.062497684241728,0.16390608673835455
892,0.0892,1,92,1,59175,546435,817,107139,5.0616454851976735,0.16392787962801458
893,0.0893,3,76,3,59251,546359,820,107136,5.060941494683019,0.16394310591511793
894,0.0894,3,110,3,59361,546249,823,107133,5.059922561043388,0.1639668677741352
895,0.0895,2,82,2,59443,546167,825,107131,5.059162992330209,0.16398488897868965
896,0.0896,1,82,1,59525,546085,826,107130,5.058403423617029,0.164004194637294
897,0.0897,2,75,2,59600,546010,828,107128,5.057708696135463,0.1640204673438079
898,0.0898,3,103,3,59703,545907,831,107125,5.056754603727445,0.16404249715174754
899,0.0899,2,91,2,59794,545816,833,107123,5.055911667716477,0.16406279912824934
900,0.09,0,93,0,59887,545723,833,107123,5.0550502056393345,0.16408617039853196
901,0.0901,4,77,4,59964,545646,837,107119,5.054336952091593,0.16410040366747605
902,0.0902,0,87,0,60051,545559,837,107119,5.053531068212975,0.1641222777541146
903,0.0903,2,98,2,60149,545461,839,107117,5.052623290970395,0.16414436281946373
904,0.0904,3,94,3,60243,545367,842,107114,5.051752565860165,0.1641641672324558
905,0.0905,1,87,1,60330,545280,843,107113,5.050946681981548,0.16418477819351218
906,0.0906,2,96,2,60426,545184,845,107111,5.0500574308051425,0.16420637901562943
907,0.0907,1,93,1,60519,545091,846,107110,5.049195968728,0.16422851237578598
908,0.0908,2,96,2,60615,544995,848,107108,5.048306717551595,0.16425012613038123
909,0.0909,2,98,2,60713,544897,850,107106,5.047398940309015,0.164272250281057
910,0.091,1,106,1,60819,544791,851,107105,5.046417058801734,0.1642976793844417
911,0.0911,2,96,2,60915,544695,853,107103,5.045527807625329,0.16431931365238925
912,0.0912,1,90,1,61005,544605,854,107102,5.0446941346474485,0.16434072366876526
913,0.0913,1,99,1,61104,544506,855,107101,5.043777094371781,0.1643644098359901
914,0.0914,0,88,0,61192,544418,855,107101,5.042961947460077,0.16438661036746435
915,0.0915,2,92,2,61284,544326,857,107099,5.0421097484160216,0.16440726100472042
916,0.0916,2,90,2,61374,544236,859,107097,5.041276075438142,0.16442741270594305
917,0.0917,0,93,0,61467,544143,859,107097,5.040414613360999,0.1644508936797494
918,0.0918,3,102,3,61569,544041,862,107094,5.0394697839860685,0.1644728051786496
919,0.0919,0,87,0,61656,543954,862,107094,5.038663900107451,0.16449478379474325
920,0.092,1,80,1,61736,543874,863,107093,5.037922857460447,0.1645137157490318
921,0.0921,1,87,1,61823,543787,864,107092,5.0371169735818295,0.16453442191252138
922,0.0922,4,97,4,61920,543690,868,107088,5.0362184593723365,0.1645538109770152
923,0.0923,1,86,1,62006,543604,869,107087,5.0354218385268075,0.16457427565465022
924,0.0924,3,85,3,62091,543519,872,107084,5.034634480714365,0.16459192472214237
925,0.0925,2,90,2,62181,543429,874,107082,5.033800807736485,0.16461212800398456
926,0.0926,2,99,2,62280,543330,876,107080,5.032883767460818,0.1646346150889439
927,0.0927,3,95,3,62375,543235,879,107077,5.0320037793175,0.16465481184416095
928,0.0928,3,82,3,62457,543153,882,107074,5.031244210604321,0.16467172233696847
929,0.0929,0,87,0,62544,543066,882,107074,5.030438326725703,0.16469375826745009
930,0.093,2,100,2,62644,542966,884,107072,5.029512023416948,0.1647165242647353
931,0.0931,4,95,4,62739,542871,888,107068,5.02863203527363,0.1647354597893033
932,0.0932,4,100,4,62839,542771,892,107064,5.027705731964875,0.16475566874668185
933,0.0933,2,94,2,62933,542677,894,107062,5.026835006854644,0.16477693350714673
934,0.0934,1,104,1,63037,542573,895,107061,5.025871651413539,0.16480202698750374
935,0.0935,2,103,2,63140,542470,897,107059,5.02491755900552,0.16482558900372424
936,0.0936,1,91,1,63231,542379,898,107058,5.024074622994553,0.16484739859293512
937,0.0937,1,114,1,63345,542265,899,107057,5.023018637222572,0.16487505428739516
938,0.0938,1,97,1,63442,542168,900,107056,5.022120123013079,0.164898401784284
939,0.0939,3,111,3,63553,542057,903,107053,5.021091926340361,0.16492274036758023
940,0.094,5,82,5,63635,541975,908,107048,5.020332357627182,0.1649371439841115
941,0.0941,1,92,1,63727,541883,909,107047,5.019480158583127,0.16495924059605813
942,0.0942,5,94,5,63821,541789,914,107042,5.018609433472896,0.16497670425734898
943,0.0943,2,94,2,63915,541695,916,107040,5.017738708362666,0.164998034636639
944,0.0944,2,97,2,64012,541598,918,107038,5.016840194153174,0.16502013455929057
945,0.0945,1,106,1,64118,541492,919,107037,5.015858312645893,0.16504581907671054
946,0.0946,1,107,1,64225,541385,920,107036,5.014867168105525,0.1650717666454356
947,0.0947,2,84,2,64309,541301,922,107034,5.01408907332617,0.1650905781733209
948,0.0948,1,77,1,64386,541224,923,107033,5.013375819778428,0.16510889971107137
949,0.0949,0,80,0,64466,541144,923,107033,5.012634777131424,0.1651292779595697
950,0.095,0,106,0,64572,541038,923,107033,5.0116528956241435,0.16515628688831935
951,0.0951,3,95,3,64667,540943,926,107030,5.010772907480826,0.16517663544623
952,0.0952,2,88,2,64755,540855,928,107028,5.009957760569121,0.1651964938113826
953,0.0953,3,100,3,64855,540755,931,107025,5.009031457260365,0.16521812961190527
954,0.0954,3,91,3,64946,540664,934,107022,5.008188521249398,0.1652374761844474
955,0.0955,2,93,2,65039,540571,936,107020,5.007327059172256,0.165258627744981
956,0.0956,0,101,0,65140,540470,936,107020,5.006391492830413,0.1652844059367712
957,0.0957,1,82,1,65222,540388,937,107019,5.005631924117233,0.16530405139270968
958,0.0958,7,92,7,65314,540296,944,107012,5.004779725073178,0.16531851915934917
959,0.0959,2,91,2,65405,540205,946,107010,5.003936789062211,0.16533918404239703
960,0.096,6,95,6,65500,540110,952,107004,5.003056800918893,0.16535571784878708
961,0.0961,4,99,4,65599,540011,956,107000,5.002139760643225,0.16537585914304392
962,0.0962,0,88,0,65687,539923,956,107000,5.00132461373152,0.16539835498196848
963,0.0963,1,94,1,65781,539829,957,106999,5.000453888621291,0.16542110112734762
964,0.0964,1,82,1,65863,539747,958,106998,4.9996943199081105,0.16544078423489939
965,0.0965,1,85,1,65948,539662,959,106997,4.998906962095669,0.1654612400043918
966,0.0966,1,91,1,66039,539571,960,106996,4.998064026084701,0.1654832368493907
967,0.0967,2,92,2,66131,539479,962,106994,4.997211827040646,0.16550420512534939
968,0.0968,2,92,2,66223,539387,964,106992,4.996359627996592,0.16552517949995282
969,0.0969,0,97,0,66320,539290,964,106992,4.995461113787099,0.16555002305495126
970,0.097,2,101,2,66421,539189,966,106990,4.994525547445256,0.16557331637208886
971,0.0971,5,97,5,66518,539092,971,106985,4.993627033235763,0.1655917173959141
972,0.0972,1,98,1,66616,538994,972,106984,4.992719255993182,0.1656155472786999
973,0.0973,0,87,0,66703,538907,972,106984,4.991913372114565,0.16563785530375869
974,0.0974,4,92,4,66795,538815,976,106980,4.99106117307051,0.1656562841149281
975,0.0975,4,95,4,66890,538720,980,106976,4.990181184927192,0.1656754881554168
976,0.0976,5,82,5,66972,538638,985,106971,4.989421616214013,0.16569006937635627
977,0.0977,2,101,2,67073,538537,987,106969,4.98848604987217,0.16571340932539744
978,0.0978,0,94,0,67167,538443,987,106969,4.98761532476194,0.16573754439024996
979,0.0979,3,80,3,67247,538363,990,106966,4.986874282114936,0.16575421219254055
980,0.098,2,93,2,67340,538270,992,106964,4.986012820037793,0.16577551709922292
981,0.0981,0,118,0,67458,538152,992,106964,4.984919782133462,0.1658058395699378
982,0.0982,2,95,2,67553,538057,994,106962,4.984039793990144,0.16582767329334486
983,0.0983,0,80,0,67633,537977,994,106962,4.98329875134314,0.16584824301212983
984,0.0984,2,93,2,67726,537884,996,106960,4.982437289265997,0.16586957465681623
985,0.0985,5,91,5,67817,537793,1001,106955,4.98159435325503,0.16588651690272788
986,0.0986,3,91,3,67908,537702,1004,106952,4.980751417244062,0.16590605192863148
987,0.0987,2,87,2,67995,537615,1006,106950,4.979945533365445,0.16592585697330758
988,0.0988,1,100,1,68095,537515,1007,106949,4.979019230056689,0.16595030909406888
989,0.0989,2,91,2,68186,537424,1009,106947,4.978176294045722,0.16597115636799298
990,0.099,1,88,1,68274,537336,1010,106946,4.977361147134018,0.16599253122080082
991,0.0991,1,86,1,68360,537250,1011,106945,4.976564526288488,0.1660133965647048
992,0.0992,3,87,3,68447,537163,1014,106942,4.975758642409871,0.16603193578686704
993,0.0993,1,102,1,68549,537061,1015,106941,4.97481381303494,0.16605693771137356
994,0.0994,0,92,0,68641,536969,1015,106941,4.973961613990885,0.16608066344675498
995,0.0995,6,92,6,68733,536877,1021,106935,4.97310941494683,0.16609662448043838
996,0.0996,1,89,1,68822,536788,1022,106934,4.972285005002038,0.16611829330052413
997,0.0997,3,101,3,68923,536687,1025,106931,4.971349438660195,0.1661404746293609
998,0.0998,0,91,0,69014,536596,1025,106931,4.970506502649227,0.16616396825618815
999,0.0999,4,102,4,69116,536494,1029,106927,4.969561673274297,0.16618512606831298
1000,0.1,0,88,0,69204,536406,1029,106927,4.968746526362592,0.1662078581387866
1001,0.1001,2,78,2,69282,536328,1031,106925,4.968024009781763,0.16622541985812736
1002,0.1002,4,99,4,69381,536229,1035,106921,4.967106969506095,0.16624582134805255
1003,0.1003,2,76,2,69457,536153,1037,106919,4.966402978991441,0.16626287569665604
1004,0.1004,2,85,2,69542,536068,1039,106917,4.965615621178999,0.166282261639074
1005,0.1005,4,96,4,69638,535972,1043,106913,4.964726370002594,0.16630190469524098
1006,0.1006,1,103,1,69741,535869,1044,106912,4.963772277594575,0.1663272560949997
1007,0.1007,6,101,6,69842,535768,1050,106906,4.9628367112527325,0.1663456122388645
1008,0.1008,3,98,3,69940,535670,1053,106903,4.961928934010152,0.16636708980925125
1009,0.1009,3,99,3,70039,535571,1056,106900,4.961011893734485,0.16638883311464642
1010,0.101,1,81,1,70120,535490,1057,106899,4.960261588054393,0.16640851571244214
1011,0.1011,2,100,2,70220,535390,1059,106897,4.959335284745637,0.16643182876190862
1012,0.1012,2,74,2,70294,535316,1061,106895,4.9586498202971585,0.1664484102576879
1013,0.1013,0,74,0,70368,535242,1061,106895,4.957964355848679,0.16646759180673282
1014,0.1014,4,82,4,70450,535160,1065,106891,4.9572047871355,0.1664836593977737
1015,0.1015,1,106,1,70556,535054,1066,106890,4.956222905628219,0.16650985132659546
1016,0.1016,2,85,2,70641,534969,1068,106888,4.955435547815777,0.16652930481400063
1017,0.1017,3,91,3,70732,534878,1071,106885,4.954592611804809,0.1665490219909842
1018,0.1018,2,93,2,70825,534785,1073,106883,4.953731149727667,0.16657056297025877
1019,0.1019,2,109,2,70934,534676,1075,106881,4.952721479121124,0.1665962650239963
1020,0.102,1,84,1,71018,534592,1076,106880,4.951943384341769,0.1666167814027736
1021,0.1021,2,92,2,71110,534500,1078,106878,4.951091185297714,0.16663808237887798
1022,0.1022,1,82,1,71192,534418,1079,106877,4.950331616584535,0.16665809027046835
1023,0.1023,2,104,2,71296,534314,1081,106875,4.949368261143428,0.166682522625934
1024,0.1024,4,99,4,71395,534215,1085,106871,4.948451220867761,0.16670306323956535
1025,0.1025,5,93,5,71488,534122,1090,106866,4.947589758790619,0.16672074984243074
1026,0.1026,1,84,1,71572,534038,1091,106865,4.946811664011264,0.16674130094569692
1027,0.1027,0,97,0,71669,533941,1091,106865,4.945913149801771,0.1667665408875697
1028,0.1028,4,90,4,71759,533851,1095,106861,4.945079476823891,0.16678476444954987
1029,0.1029,2,105,2,71864,533746,1097,106859,4.944106858349698,0.16680950039415865
1030,0.103,3,85,3,71949,533661,1100,106856,4.943319500537256,0.16682773447074786
1031,0.1031,4,102,4,72051,533559,1104,106852,4.942374671162326,0.16684910159257102
1032,0.1032,4,79,4,72130,533480,1108,106848,4.941642891548408,0.16686448195299908
1033,0.1033,2,96,2,72226,533384,1110,106846,4.940753640372003,0.1668869000203052
1034,0.1034,2,102,2,72328,533282,1112,106844,4.939808810997073,0.1669108894186457
1035,0.1035,3,101,3,72429,533181,1115,106841,4.9388732446552295,0.16693332416698176
1036,0.1036,2,75,2,72504,533106,1117,106839,4.938178517173664,0.16695028479009916
1037,0.1037,2,104,2,72608,533002,1119,106837,4.937215161732558,0.16697481710242734
1038,0.1038,2,96,2,72704,532906,1121,106835,4.936325910556152,0.16699726920738237
1039,0.1039,2,83,2,72787,532823,1123,106833,4.935557078809886,0.16701633377940642
1040,0.104,0,76,0,72863,532747,1123,106833,4.934853088295231,0.16703617999312048
1041,0.1041,0,100,0,72963,532647,1123,106833,4.933926784986476,0.16706230061925315
1042,0.1042,1,89,1,73052,532558,1124,106832,4.933102375041684,0.16708425217785702
1043,0.1043,5,84,5,73136,532474,1129,106827,4.932324280262329,0.1670996916945226
1044,0.1044,2,88,2,73224,532386,1131,106825,4.931509133350624,0.16712009023624436
1045,0.1045,3,95,3,73319,532291,1134,106822,4.930629145207306,0.16714102201019226
1046,0.1046,3,89,3,73408,532202,1137,106819,4.929804735262515,0.16716039066008787
1047,0.1047,0,110,0,73518,532092,1137,106819,4.928785801622883,0.1671891703226271
1048,0.1048,1,82,1,73600,532010,1138,106818,4.928026232909704,0.16720932708021566
1049,0.1049,4,90,4,73690,531920,1142,106814,4.927192559931824,0.16722767223914806
1050,0.105,3,103,3,73793,531817,1145,106811,4.926238467523806,0.16725073125512818
1051,0.1051,1,98,1,73891,531719,1146,106810,4.925330690281226,0.1672750963542768
1052,0.1052,2,109,2,74000,531610,1148,106808,4.924321019674682,0.16730104727623596
1053,0.1053,1,78,1,74078,531532,1149,106807,4.923598503093853,0.16732018566937004
1054,0.1054,2,84,2,74162,531448,1151,106805,4.922820408314498,0.16733959730702402
1055,0.1055,3,100,3,74262,531348,1154,106802,4.921894105005743,0.16736190550810937
1056,0.1056,2,70,2,74332,531278,1156,106800,4.921245692689614,0.1673776560232448
1057,0.1057,3,89,3,74421,531189,1159,106797,4.920421282744822,0.16739709021828064
1058,0.1058,3,96,3,74517,531093,1162,106794,4.919532031568417,0.16741836720296854
1059,0.1059,1,106,1,74623,530987,1163,106793,4.918550150061136,0.16744488695161341
1060,0.106,6,100,6,74723,530887,1169,106787,4.917623846752381,0.16746331197445716
1061,0.1061,0,112,0,74835,530775,1169,106787,4.916586387046575,0.16749273011879628
1062,0.1062,2,92,2,74927,530683,1171,106785,4.91573418800252,0.16751429091342623
1063,0.1063,3,97,3,75024,530586,1174,106782,4.914835673793027,0.16753586624995292
1064,0.1064,1,96,1,75120,530490,1175,106781,4.913946422616622,0.16755979795095022
1065,0.1065,3,97,3,75217,530393,1178,106778,4.913047908407129,0.1675813871001662
1066,0.1066,1,85,1,75302,530308,1179,106777,4.912260550594687,0.16760243923495294
1067,0.1067,5,79,5,75381,530229,1184,106772,4.91152877098077,0.16761669133957405
1068,0.1068,2,96,2,75477,530133,1186,106770,4.910639519804365,0.16763934225462904
1069,0.1069,2,105,2,75582,530028,1188,106768,4.909666901330172,0.16766436975106627
1070,0.107,3,84,3,75666,529944,1191,106765,4.908888806550817,0.16768256770361342
1071,0.1071,1,93,1,75759,529851,1192,106764,4.908027344473674,0.1677057562262906
1072,0.1072,2,90,2,75849,529761,1194,106762,4.907193671495794,0.16772685354653327
1073,0.1073,4,71,4,75920,529690,1198,106758,4.906535996146578,0.1677403338528835
1074,0.1074,2,93,2,76013,529597,1200,106756,4.905674534069436,0.16776223259731626
1075,0.1075,3,96,3,76109,529501,1203,106753,4.90478528289303,0.16778362100670488
1076,0.1076,4,89,4,76198,529412,1207,106749,4.903960872948238,0.1678018614784622
1077,0.1077,3,96,3,76294,529316,1210,106746,4.903071621771833,0.16782326251214505
1078,0.1078,3,79,3,76373,529237,1213,106743,4.902339842157916,0.167840183653574
1079,0.1079,3,90,3,76463,529147,1216,106740,4.901506169180037,0.1678600128639208
1080,0.108,3,77,3,76540,529070,1219,106737,4.9007929156322945,0.16787641532729272
1081,0.1081,3,98,3,76638,528972,1222,106734,4.899885138389714,0.16789836811356193
1082,0.1082,2,111,2,76749,528861,1224,106732,4.898856941716995,0.16792507154735814
1083,0.1083,2,98,2,76847,528763,1226,106730,4.897949164474415,0.1679483487622995
1084,0.1084,0,87,0,76934,528676,1226,106730,4.897143280595798,0.1679713443058454
1085,0.1085,2,95,2,77029,528581,1228,106728,4.89626329245248,0.1679938423664705
1086,0.1086,0,88,0,77117,528493,1228,106728,4.895448145540776,0.16801711530317795
1087,0.1087,3,95,3,77212,528398,1231,106725,4.894568157397458,0.1680383169874182
1088,0.1088,3,93,3,77305,528305,1234,106722,4.893706695320316,0.16805899591670906
1089,0.1089,2,90,2,77395,528215,1236,106720,4.892873022342436,0.16808019718553868
1090,0.109,4,98,4,77493,528117,1240,106716,4.891965245099856,0.1681009021270161
1091,0.1091,1,100,1,77593,528017,1241,106715,4.8910389417911,0.16812607525695883
1092,0.1092,5,78,5,77671,527939,1246,106710,4.890316425210271,0.16814018457446558
1093,0.1093,4,86,4,77757,527853,1250,106706,4.889519804364741,0.16815772843817517
1094,0.1094,3,102,3,77859,527751,1253,106703,4.888574974989811,0.1681808295006415
1095,0.1095,1,93,1,77952,527658,1254,106702,4.8877135129126685,0.16820417428589443
1096,0.1096,3,118,3,78070,527540,1257,106699,4.886620475008336,0.16823153416929582
1097,0.1097,9,92,9,78162,527448,1266,106690,4.885768275964281,0.16824413613440609
1098,0.1098,3,99,3,78261,527349,1269,106687,4.884851235688614,0.16826647067358952
1099,0.1099,2,114,2,78375,527235,1271,106685,4.883795249916632,0.1682941065118627
1100,0.11,2,89,2,78464,527146,1273,106683,4.882970839971841,0.16831511338231606
1101,0.1101,2,81,2,78545,527065,1275,106681,4.882220534291749,0.16833400131914047
1102,0.1102,2,100,2,78645,526965,1277,106679,4.881294230982993,0.16835794231461199
1103,0.1103,4,93,4,78738,526872,1281,106675,4.880432768905851,0.16837740530694645
1104,0.1104,3,95,3,78833,526777,1284,106672,4.879552780762533,0.16839871876031062
1105,0.1105,5,103,5,78936,526674,1289,106667,4.878598688354515,0.16841954018451355
1106,0.1106,4,98,4,79034,526576,1293,106663,4.877690911111935,0.16844035190504691
1107,0.1107,2,104,2,79138,526472,1295,106661,4.876727555670829,0.16846539352711043
1108,0.1108,0,111,0,79249,526361,1295,106661,4.87569935899811,0.16849493382536468
1109,0.1109,4,88,4,79337,526273,1299,106657,4.874884212086406,0.168513105714692
1110,0.111,3,92,3,79429,526181,1302,106654,4.874032013042351,0.16853366201300496
1111,0.1111,4,120,4,79549,526061,1306,106650,4.872920449071844,0.16856036958421775
1112,0.1112,2,89,2,79638,525972,1308,106648,4.872096039127052,0.16858145490183682
1113,0.1113,3,110,3,79748,525862,1311,106645,4.871077105487421,0.16860682964773513
1114,0.1114,2,98,2,79846,525764,1313,106643,4.870169328244841,0.1686303282537986
1115,0.1115,2,97,2,79943,525667,1315,106641,4.869270814035348,0.16865356756517394
1116,0.1116,2,84,2,80027,525583,1317,106639,4.868492719255993,0.16867334575513032
1117,0.1117,2,88,2,80115,525495,1319,106637,4.867677572344288,0.16869419678168485
1118,0.1118,4,95,4,80210,525400,1323,106633,4.866797584200971,0.1687142918170412
1119,0.1119,2,94,2,80304,525306,1325,106631,4.865926859090741,0.16873675698685153
1120,0.112,2,97,2,80401,525209,1327,106629,4.865028344881248,0.16876003026092132
1121,0.1121,0,88,0,80489,525121,1327,106629,4.864213197969543,0.16878353779184804
1122,0.1122,1,76,1,80565,525045,1328,106628,4.863509207454889,0.16880252915669974
1123,0.1123,0,89,0,80654,524956,1328,106628,4.862684797510097,0.1688263160561382
1124,0.1124,0,88,0,80742,524868,1328,106628,4.861869650598392,0.168849842279286
1125,0.1125,2,80,2,80822,524788,1330,106626,4.861128607951388,0.16886860285011102
1126,0.1126,4,84,4,80906,524704,1334,106622,4.860350513172033,0.1688858054317421
1127,0.1127,1,123,1,81029,524581,1335,106621,4.859211160102264,0.16891739886755747
1128,0.1128,2,81,2,81110,524500,1337,106619,4.858460854422172,0.16893644463247026
1129,0.1129,2,116,2,81226,524384,1339,106617,4.857386342584015,0.16896486693364987
1130,0.113,2,81,2,81307,524303,1341,106615,4.856636036903923,0.16898392501085718
1131,0.1131,4,93,4,81400,524210,1345,106611,4.855774574826781,0.1690035683656695
1132,0.1132,3,95,3,81495,524115,1348,106608,4.854894586683463,0.16902507122778146
1133,0.1133,2,108,2,81603,524007,1350,106606,4.853894179110008,0.16905138333653127
1134,0.1134,3,115,3,81718,523892,1353,106603,4.8528289303049394,0.16907826390375816
1135,0.1135,2,101,2,81819,523791,1355,106601,4.851893363963096,0.16910271703955634
1136,0.1136,1,79,1,81898,523712,1356,106600,4.851161584349179,0.16912259325540369
1137,0.1137,1,97,1,81995,523615,1357,106599,4.850263070139687,0.16914730551844295
1138,0.1138,0,79,0,82074,523536,1357,106599,4.8495312905257695,0.16916851150943846
1139,0.1139,0,94,0,82168,523442,1357,106599,4.84866056541554,0.16919375088287905
1140,0.114,4,104,4,82272,523338,1361,106595,4.847697209974434,0.1692164087291823
1141,0.1141,0,90,0,82362,523248,1361,106595,4.846863536996554,0.1692405885276172
1142,0.1142,1,99,1,82461,523149,1362,106594,4.845946496720886,0.16926587512683747
1143,0.1143,2,100,2,82561,523049,1364,106592,4.845020193412131,0.1692901192901987
1144,0.1144,3,92,3,82653,522957,1367,106589,4.8441679943680755,0.16931090023604312
1145,0.1145,3,87,3,82740,522870,1370,106586,4.843362110489458,0.1693303423908899
1146,0.1146,4,85,4,82825,522785,1374,106582,4.842574752677017,0.16934793212863083
1147,0.1147,3,91,3,82916,522694,1377,106579,4.841731816666049,0.1693684617010423
1148,0.1148,7,104,7,83020,522590,1384,106572,4.840768461224943,0.16938721664690493
1149,0.1149,1,114,1,83134,522476,1385,106571,4.839712475452962,0.16941659367265086
1150,0.115,3,113,3,83247,522363,1388,106568,4.838665752714069,0.16944307086150945
1151,0.1151,0,103,0,83350,522260,1388,106568,4.83771166030605,0.1694708250904858
1152,0.1152,2,86,2,83436,522174,1390,106566,4.836915039460521,0.16949136367974044
1153,0.1153,2,100,2,83536,522074,1392,106564,4.835988736151766,0.16951568311174317
1154,0.1154,3,101,3,83637,521973,1395,106561,4.835053169809923,0.16953895891073514
1155,0.1155,4,91,4,83728,521882,1399,106557,4.834210233798955,0.16955822283467448
1156,0.1156,3,94,3,83822,521788,1402,106554,4.833339508688725,0.1695796238354272
1157,0.1157,1,91,1,83913,521697,1403,106553,4.832496572677758,0.16960286510147235
1158,0.1158,2,104,2,84017,521593,1405,106551,4.831533217236652,0.1696283017906722
1159,0.1159,3,97,3,84114,521496,1408,106548,4.830634703027159,0.16965053403901637
1160,0.116,2,98,2,84212,521398,1410,106546,4.829726925784579,0.16967436586701998
1161,0.1161,0,96,0,84308,521302,1410,106546,4.828837674608174,0.1697003096290822
1162,0.1162,2,96,2,84404,521206,1412,106544,4.827948423431769,0.1697236160892075
1163,0.1163,2,104,2,84508,521102,1414,106542,4.8269850679906625,0.16974909343513203
1164,0.1164,1,87,1,84595,521015,1415,106541,4.826179184112045,0.16977130327811382
1165,0.1165,0,80,0,84675,520935,1415,106541,4.825438141465042,0.1697929482561883
1166,0.1166,2,85,2,84760,520850,1417,106539,4.824650783652599,0.16981330562059582
1167,0.1167,3,112,3,84872,520738,1420,106536,4.823613323946793,0.16983965539780063
1168,0.1168,2,92,2,84964,520646,1422,106534,4.822761124902738,0.16986192161739852
1169,0.1169,1,105,1,85069,520541,1423,106533,4.821788506428545,0.16988904020897055
1170,0.117,2,101,2,85170,520440,1425,106531,4.820852940086702,0.16991375996656943
1171,0.1171,5,99,5,85269,520341,1430,106526,4.819935899811034,0.16993397323515194
1172,0.1172,2,91,2,85360,520250,1432,106524,4.819092963800067,0.16995599689840357
1173,0.1173,5,91,5,85451,520159,1437,106519,4.818250027789099,0.16997405366073168
1174,0.1174,2,93,2,85544,520066,1439,106517,4.817388565711957,0.16999663252913022
1175,0.1175,1,104,1,85648,519962,1440,106516,4.816425210270851,0.17002352836013396
1176,0.1176,4,105,4,85753,519857,1444,106512,4.8154525917966575,0.17004672964338913
1177,0.1177,1,120,1,85873,519737,1445,106511,4.814341027826152,0.17007798827301643
1178,0.1178,2,90,2,85963,519647,1447,106509,4.813507354848271,0.17009978344054835
1179,0.1179,2,99,2,86062,519548,1449,106507,4.812590314572604,0.17012403063628595
1180,0.118,1,98,1,86160,519450,1450,106506,4.811682537330023,0.17014933957019343
1181,0.1181,2,83,2,86243,519367,1452,106504,4.810913705583756,0.17016925213023132
1182,0.1182,2,95,2,86338,519272,1454,106502,4.810033717440438,0.17019243369011816
1183,0.1183,1,83,1,86421,519189,1455,106501,4.809264885694172,0.17021368409276158
1184,0.1184,2,95,2,86516,519094,1457,106499,4.808384897550854,0.17023687924896858
1185,0.1185,3,84,3,86600,519010,1460,106496,4.8076068027715,0.17025576093594627
1186,0.1186,6,100,6,86700,518910,1466,106490,4.806680499462744,0.17027502398464983
1187,0.1187,2,107,2,86807,518803,1468,106488,4.805689354922376,0.17030150761805304
1188,0.1188,6,111,6,86918,518692,1474,106482,4.804661158249657,0.1703237818591304
1189,0.1189,5,111,5,87029,518581,1479,106477,4.803632961576938,0.17034739176204447
1190,0.119,3,103,3,87132,518478,1482,106474,4.802678869168921,0.1703714845300119
1191,0.1191,1,97,1,87229,518381,1483,106473,4.801780354959428,0.1703966046468455
1192,0.1192,1,98,1,87327,518283,1484,106472,4.800872577716848,0.17042200542612704
1193,0.1193,0,70,0,87397,518213,1484,106472,4.800224165400719,0.17044110231556706
1194,0.1194,6,105,6,87502,518108,1490,106466,4.799251546926525,0.17046178675385143
1195,0.1195,0,101,0,87603,518007,1490,106466,4.7983159805846824,0.17048935662550663
1196,0.1196,2,91,2,87694,517916,1492,106464,4.7974730445737155,0.17051154745507544
1197,0.1197,5,90,5,87784,517826,1497,106459,4.796639371595836,0.17052948573167703
1198,0.1198,2,82,2,87866,517744,1499,106457,4.795879802882656,0.1705492301358056
1199,0.1199,4,101,4,87967,517643,1503,106453,4.794944236540813,0.1705715146387735
1200,0.12,2,86,2,88053,517557,1505,106451,4.794147615695283,0.17059236420045898
1201,0.1201,2,89,2,88142,517468,1507,106449,4.793323205750491,0.17061404000852678
1202,0.1202,5,104,5,88246,517364,1512,106444,4.792359850309385,0.17063583666769264
1203,0.1203,4,104,4,88350,517260,1516,106440,4.7913964948682795,0.17065897065897065
1204,0.1204,1,112,1,88462,517148,1517,106439,4.790359035162473,0.17068829209075878
1205,0.1205,5,101,5,88563,517047,1522,106434,4.7894234688206305,0.1707092918629437
1206,0.1206,5,99,5,88662,516948,1527,106429,4.788506428544963,0.1707297510174421
1207,0.1207,3,89,3,88751,516859,1530,106426,4.7876820186001705,0.17075013837971392
1208,0.1208,2,125,2,88876,516734,1532,106424,4.786524139464226,0.17078172790849191
1209,0.1209,4,81,4,88957,516653,1536,106420,4.785773833784134,0.17079860626282956
1210,0.121,1,101,1,89058,516552,1537,106419,4.784838267442291,0.17082496617017487
1211,0.1211,2,114,2,89172,516438,1539,106417,4.78378228167031,0.17085356945035363
1212,0.1212,5,89,5,89261,516349,1544,106412,4.782957871725518,0.17087132945062392
1213,0.1213,2,112,2,89373,516237,1546,106410,4.781920412019712,0.17089940206890902
1214,0.1214,4,99,4,89472,516138,1550,106406,4.781003371744044,0.1709212521524583
1215,0.1215,4,96,4,89568,516042,1554,106402,4.780114120567639,0.17094228557107147
1216,0.1216,1,109,1,89677,515933,1555,106401,4.779104449961095,0.17097089344307076
1217,0.1217,2,110,2,89787,515823,1557,106399,4.778085516321465,0.17099845392801927
1218,0.1218,2,82,2,89869,515741,1559,106397,4.7773259476082846,0.1710183271235642
1219,0.1219,4,93,4,89962,515648,1563,106393,4.776464485531142,0.17103856498205103
1220,0.122,3,67,3,90029,515581,1566,106390,4.775843862314276,0.17105299121663228
1221,0.1221,2,103,2,90132,515478,1568,106388,4.774889769906258,0.17107865681674186
1222,0.1222,1,106,1,90238,515372,1569,106387,4.773907888398977,0.1711064898135773
1223,0.1223,2,103,2,90341,515269,1571,106385,4.77295379599096,0.17113217320245666
1224,0.1224,4,88,4,90429,515181,1575,106381,4.772138649079254,0.1711510677937197
1225,0.1225,2,86,2,90515,515095,1577,106379,4.771342028233724,0.17117208443152893
1226,0.1226,2,101,2,90616,514994,1579,106377,4.7704064618918816,0.1711972396523172
1227,0.1227,11,94,11,90710,514900,1590,106366,4.769535736781652,0.1712084678704452
1228,0.1228,2,88,2,90798,514812,1592,106364,4.768720589869947,0.1712300539621621
1229,0.1229,2,93,2,90891,514719,1594,106362,4.767859127792804,0.17125302496775782
1230,0.123,1,92,1,90983,514627,1595,106361,4.767006928748749,0.1712770617145581
1231,0.1231,2,112,2,91095,514515,1597,106359,4.765969469042943,0.17130528899583491
1232,0.1232,1,107,1,91202,514408,1598,106358,4.764978324502575,0.17133348153732647
1233,0.1233,2,94,2,91296,514314,1600,106356,4.764107599392345,0.17135675963072164
1234,0.1234,5,78,5,91374,514236,1605,106351,4.763385082811515,0.171371620739719
1235,0.1235,3,94,3,91468,514142,1608,106348,4.762514357701286,0.17139357604473884
1236,0.1236,2,93,2,91561,514049,1610,106346,4.7616528956241435,0.1714165974903086
1237,0.1237,3,91,3,91652,513958,1613,106343,4.760809959613176,0.17143773748551105
1238,0.1238,6,90,6,91742,513868,1619,106337,4.759976286635296,0.17145459968881258
1239,0.1239,7,102,7,91844,513766,1626,106330,4.759031457260365,0.17147344927237074
1240,0.124,3,114,3,91958,513652,1629,106327,4.757975471488384,0.17150097019415173
1241,0.1241,3,111,3,92069,513541,1632,106324,4.756947274815666,0.17152767134779348
1242,0.1242,1,101,1,92170,513440,1633,106323,4.756011708473823,0.17155428768739017
1243,0.1243,4,79,4,92249,513361,1637,106319,4.755279928859906,0.17157081074102762
1244,0.1244,5,111,5,92360,513250,1642,106314,4.754251732187187,0.17159486348464403
1245,0.1245,5,94,5,92454,513156,1647,106309,4.753381007076957,0.1716142154924007
1246,0.1246,3,86,3,92540,513070,1650,106306,4.752584386231428,0.17163403167058458
1247,0.1247,5,97,5,92637,512973,1655,106301,4.751685872021935,0.17165422736946812
1248,0.1248,3,100,3,92737,512873,1658,106298,4.750759568713179,0.17167793711268778
1249,0.1249,4,97,4,92834,512776,1662,106294,4.749861054503687,0.17169948471093738
1250,0.125,2,92,2,92926,512684,1664,106292,4.749008855459632,0.17172232849092695
1251,0.1251,9,99,9,93025,512585,1673,106283,4.7480918151839635,0.17173775344661543
1252,0.1252,1,88,1,93113,512497,1674,106282,4.747276668272259,0.1717608386839243
1253,0.1253,2,93,2,93206,512404,1676,106280,4.746415206195117,0.17178398019021018
1254,0.1254,2,122,2,93328,512282,1678,106278,4.745285116158435,0.17181518365235385
1255,0.1255,4,84,4,93412,512198,1682,106274,4.74450702137908,0.17183316302112303
1256,0.1256,2,97,2,93509,512101,1684,106272,4.743608507169587,0.1718574387950315
1257,0.1257,1,82,1,93591,512019,1685,106271,4.742848938456408,0.17187889178217342
1258,0.1258,4,102,4,93693,511917,1689,106267,4.741904109081478,0.17190189328743546
1259,0.1259,0,92,0,93785,511825,1689,106267,4.741051910037423,0.17192748005151337
1260,0.126,0,94,0,93879,511731,1689,106267,4.740181184927192,0.17195363091789942
1261,0.1261,5,78,5,93957,511653,1694,106262,4.739458668346363,0.17196863646294394
1262,0.1262,4,103,4,94060,511550,1698,106258,4.738504575938345,0.17199194571776344
1263,0.1263,1,94,1,94154,511456,1699,106257,4.737633850828115,0.17201677801827062
1264,0.1264,2,91,2,94245,511365,1701,106255,4.736790914817147,0.17203944172792332
1265,0.1265,2,90,2,94335,511275,1703,106253,4.735957241839268,0.17206183363345467
1266,0.1266,1,96,1,94431,511179,1704,106252,4.735067990662863,0.17208724537640643
1267,0.1267,3,81,3,94512,511098,1707,106249,4.734317684982771,0.17210580111347426
1268,0.1268,4,85,4,94597,511013,1711,106245,4.733530327170329,0.1721241360986816
1269,0.1269,1,81,1,94678,510932,1712,106244,4.732780021490237,0.1721453847848912
1270,0.127,1,93,1,94771,510839,1713,106243,4.731918559413094,0.17216998713299042
1271,0.1271,4,96,4,94867,510743,1717,106239,4.731029308236689,0.17219140914969966
1272,0.1272,1,93,1,94960,510650,1718,106238,4.730167846159547,0.17221602624787644
1273,0.1273,1,113,1,95073,510537,1719,106237,4.7291211234206525,0.17224623606053432
1274,0.1274,7,107,7,95180,510430,1726,106230,4.728129978880284,0.1722667272078617
1275,0.1275,2,102,2,95282,510328,1728,106228,4.727185149505354,0.17229254114792492
1276,0.1276,5,102,5,95384,510226,1733,106223,4.726240320130423,0.17231433581691266
1277,0.1277,3,93,3,95477,510133,1736,106220,4.725378858053281,0.17233630727845894
1278,0.1278,1,108,1,95585,510025,1737,106219,4.724378450479825,0.17236516704422275
1279,0.1279,2,98,2,95683,509927,1739,106217,4.7234706732372445,0.17238989586849826
1280,0.128,2,86,2,95769,509841,1741,106215,4.7226740523917154,0.172411274299739
1281,0.1281,1,105,1,95874,509736,1742,106214,4.721701433917522,0.1724393213734881
1282,0.1282,5,105,5,95979,509631,1747,106209,4.720728815443329,0.1724620031176929
1283,0.1283,0,84,0,96063,509547,1747,106209,4.719950720663975,0.17248552998265546
1284,0.1284,1,89,1,96152,509458,1748,106208,4.719126310719182,0.17250912020478637
1285,0.1285,2,101,2,96253,509357,1750,106206,4.718190744377339,0.172534736493259
1286,0.1286,2,118,2,96371,509239,1752,106204,4.717097706473007,0.17256512788349204
1287,0.1287,4,100,4,96471,509139,1756,106200,4.716171403164252,0.17258779307016134
1288,0.1288,7,105,7,96576,509034,1763,106193,4.715198784690059,0.17260783418152975
1289,0.1289,4,93,4,96669,508941,1767,106189,4.714337322612916,0.1726285500625884
1290,0.129,2,91,2,96760,508850,1769,106187,4.7134943866019485,0.17265140146039995
1291,0.1291,3,89,3,96849,508761,1772,106184,4.712669976657157,0.1726723528120401
1292,0.1292,3,108,3,96957,508653,1775,106181,4.711669569083701,0.1726986471145057
1293,0.1293,3,96,3,97053,508557,1778,106178,4.710780317907296,0.17272157921706102
1294,0.1294,1,109,1,97162,508448,1779,106177,4.709770647300752,0.1727508643481798
1295,0.1295,3,94,3,97256,508354,1782,106174,4.708899922190522,0.17277325036450739
1296,0.1296,4,96,4,97352,508258,1786,106170,4.708010671014117,0.1727948596092626
1297,0.1297,0,75,0,97427,508183,1786,106170,4.70731594353255,0.17281595434546587
1298,0.1298,1,98,1,97525,508085,1787,106169,4.70640816628997,0.17284217929390774
1299,0.1299,2,101,2,97626,507984,1789,106167,4.705472599948127,0.17286791033475482
1300,0.13,2,93,2,97719,507891,1791,106165,4.704611137870985,0.17289139752726135
1301,0.1301,1,120,1,97839,507771,1792,106164,4.703499573900478,0.17292384372938505
1302,0.1302,4,111,4,97950,507660,1796,106160,4.702471377227759,0.17294972467498615
1303,0.1303,5,100,5,98050,507560,1801,106155,4.701545073919004,0.17297116739854818
1304,0.1304,5,90,5,98140,507470,1806,106150,4.700711400941124,0.17298979824647176
1305,0.1305,0,105,0,98245,507365,1806,106150,4.699738782466931,0.17301940457853515
1306,0.1306,3,93,3,98338,507272,1809,106147,4.698877320389788,0.17304159147336487
1307,0.1307,2,112,2,98450,507160,1811,106145,4.697839860683982,0.1730704951043934
1308,0.1308,5,101,5,98551,507059,1816,106140,4.696904294342139,0.17309225879363796
1309,0.1309,2,81,2,98632,506978,1818,106138,4.696153988662047,0.1731124289693957
1310,0.131,4,106,4,98738,506872,1822,106134,4.695172107154767,0.17313696766426429
1311,0.1311,2,102,2,98840,506770,1824,106132,4.694227277779836,0.1731630831682716
1312,0.1312,2,86,2,98926,506684,1826,106130,4.693430656934306,0.17318468572845921
1313,0.1313,1,93,1,99019,506591,1827,106129,4.692569194857164,0.1732096226661444
1314,0.1314,4,110,4,99129,506481,1831,106125,4.691550261217533,0.1732353258048403
1315,0.1315,3,114,3,99243,506367,1834,106122,4.690494275445552,0.17326351983464192
1316,0.1316,4,92,4,99335,506275,1838,106118,4.689642076401497,0.1732841492309677
1317,0.1317,3,95,3,99430,506180,1841,106115,4.688762088258179,0.17330698437844502
1318,0.1318,2,92,2,99522,506088,1843,106113,4.687909889214124,0.17333032778450214
1319,0.1319,5,95,5,99617,505993,1848,106108,4.687029901070806,0.17335047647365387
1320,0.132,0,96,0,99713,505897,1848,106108,4.686140649894401,0.17337766848310063
1321,0.1321,2,94,2,99807,505803,1850,106106,4.685269924784171,0.17340160056478987
1322,0.1322,5,112,5,99919,505691,1855,106101,4.684232465078365,0.173426589429087
1323,0.1323,2,94,2,100013,505597,1857,106099,4.683361739968135,0.1734505375219063
1324,0.1324,1,128,1,100141,505469,1858,106098,4.682176071732928,0.17348548891617763
1325,0.1325,4,107,4,100248,505362,1862,106094,4.68118492719256,0.17351044065312957
1326,0.1326,6,102,6,100350,505260,1868,106088,4.680240097817629,0.17353127842080124
1327,0.1327,4,97,4,100447,505163,1872,106084,4.679341583608137,0.17355340803308647
1328,0.1328,7,86,7,100533,505077,1879,106077,4.678544962762607,0.1735683641111733
1329,0.1329,4,72,4,100605,505005,1883,106073,4.677878024380303,0.17358340506449257
1330,0.133,6,88,6,100693,504917,1889,106067,4.6770628774685985,0.17360029067864297
1331,0.1331,3,90,3,100783,504827,1892,106064,4.676229204490719,0.1736218081458067
1332,0.1332,4,102,4,100885,504725,1896,106060,4.675284375115788,0.17364539076761873
1333,0.1333,4,85,4,100970,504640,1900,106056,4.674497017303346,0.1736641471370371
1334,0.1334,2,104,2,101074,504536,1902,106054,4.6735336618622405,0.17369102016082805
1335,0.1335,2,99,2,101173,504437,1904,106052,4.672616621586572,0.1737164797400117
1336,0.1336,2,103,2,101276,504334,1906,106050,4.671662529178554,0.1737430863194317
1337,0.1337,2,95,2,101371,504239,1908,106048,4.670782541035236,0.17376742417911573
1338,0.1338,2,90,2,101461,504149,1910,106046,4.669948868057356,0.17379034570915855
1339,0.1339,5,101,5,101562,504048,1915,106041,4.6690133017155135,0.1738123454118989
1340,0.134,2,93,2,101655,503955,1917,106039,4.668151839638371,0.1738361360931419
1341,0.1341,4,98,4,101753,503857,1921,106035,4.667244062395791,0.17385865038400242
1342,0.1342,3,100,3,101853,503757,1924,106032,4.666317759087035,0.1738830972680714
1343,0.1343,4,92,4,101945,503665,1928,106028,4.66546556004298,0.17390391557718393
1344,0.1344,4,83,4,102028,503582,1932,106024,4.664696728296714,0.17392217268202742
1345,0.1345,4,89,4,102117,503493,1936,106020,4.663872318351921,0.17394214725526774
1346,0.1346,5,101,5,102218,503392,1941,106015,4.662936752010078,0.17396419798262902
1347,0.1347,5,95,5,102313,503297,1946,106010,4.662056763866761,0.17398454309568084
1348,0.1348,3,99,3,102412,503198,1949,106007,4.661139723591092,0.1740087491074433
1349,0.1349,4,98,4,102510,503100,1953,106003,4.660231946348512,0.17403132146779773
1350,0.135,2,99,2,102609,503001,1955,106001,4.6593149060728445,0.17405689964893384
1351,0.1351,4,93,4,102702,502908,1959,105997,4.658453443995702,0.17407805815357075
1352,0.1352,3,88,3,102790,502820,1962,105994,4.657638297083997,0.17409915015094923
1353,0.1353,3,103,3,102893,502717,1965,105991,4.6566842046759795,0.17412453918791934
1354,0.1354,6,88,6,102981,502629,1971,105985,4.655869057764274,0.174141574134016
1355,0.1355,1,96,1,103077,502533,1972,105984,4.654979806587869,0.17416768964548238
1356,0.1356,3,101,3,103178,502432,1975,105981,4.6540442402460265,0.17419253040286778
1357,0.1357,2,101,2,103279,502331,1977,105979,4.653108673904184,0.17421873715704164
1358,0.1358,1,94,1,103373,502237,1978,105978,4.652237948793953,0.17424430505660005
1359,0.1359,2,106,2,103479,502131,1980,105976,4.651256067286672,0.17427196200668632
1360,0.136,4,114,4,103593,502017,1984,105972,4.650200081514691,0.17429920607116248
1361,0.1361,3,83,3,103676,501934,1987,105969,4.6494312497684245,0.17431892917126582
1362,0.1362,4,99,4,103775,501835,1991,105965,4.648514209492756,0.17434188877920367
1363,0.1363,3,116,3,103891,501719,1994,105962,4.6474396976546,0.17437109272792797
1364,0.1364,4,104,4,103995,501615,1998,105958,4.646476342213495,0.1743955047377023
1365,0.1365,3,93,3,104088,501522,2001,105955,4.6456148801363515,0.1744181261183551
1366,0.1366,3,100,3,104188,501422,2004,105952,4.644688576827597,0.17444276508378692
1367,0.1367,3,97,3,104285,501325,2007,105949,4.643790062618104,0.1744665505192055
1368,0.1368,5,90,5,104375,501235,2012,105944,4.642956389640224,0.17448561297409826
1369,0.1369,5,96,5,104471,501139,2017,105939,4.642067138463819,0.1745064060960865
1370,0.137,6,92,6,104563,501047,2023,105933,4.641214939419764,0.1745246960361132
1371,0.1371,2,102,2,104665,500945,2025,105931,4.640270110044833,0.1745513086693163
1372,0.1372,3,107,3,104772,500838,2028,105928,4.639278965504465,0.1745780086557256
1373,0.1373,3,109,3,104881,500729,2031,105925,4.638269294897921,0.174605293956687
1374,0.1374,2,92,2,104973,500637,2033,105923,4.637417095853866,0.1746290556581377
1375,0.1375,2,96,2,105069,500541,2035,105921,4.636527844677461,0.17465397667125063
1376,0.1376,5,102,5,105171,500439,2040,105916,4.63558301530253,0.1746765508654171
1377,0.1377,1,96,1,105267,500343,2041,105915,4.634693764126125,0.17470284928198887
1378,0.1378,6,103,6,105370,500240,2047,105909,4.633739671718107,0.1747243664511531
1379,0.1379,2,83,2,105453,500157,2049,105907,4.632970839971841,0.17474557142480002
1380,0.138,3,102,3,105555,500055,2052,105904,4.63202601059691,0.17477090034144224
1381,0.1381,7,110,7,105665,499945,2059,105897,4.631007076957279,0.17479309787040184
1382,0.1382,6,98,6,105763,499847,2065,105891,4.630099299714699,0.17481320306799308
1383,0.1383,3,93,3,105856,499754,2068,105888,4.6292378376375565,0.1748359591970174
1384,0.1384,4,98,4,105954,499656,2072,105884,4.628330060394975,0.17485880371238893
1385,0.1385,4,103,4,106057,499553,2076,105880,4.627375967986958,0.1748831001944063
1386,0.1386,2,114,2,106171,499439,2078,105878,4.6263199822149765,0.17491330988556408
1387,0.1387,1,94,1,106265,499345,2079,105877,4.625449257104746,0.17493911325100542
1388,0.1388,1,104,1,106369,499241,2080,105876,4.624485901663641,0.17496781614134127
1389,0.1389,4,104,4,106473,499137,2084,105872,4.623522546222535,0.17499243812901957
1390,0.139,5,104,5,106577,499033,2089,105867,4.62255919078143,0.17501570507521905
1391,0.1391,2,87,2,106664,498946,2091,105865,4.6217533069028125,0.17503815241455595
1392,0.1392,2,112,2,106776,498834,2093,105863,4.6207158471970065,0.1750678438953724
1393,0.1393,0,78,0,106854,498756,2093,105863,4.619993330616177,0.17509042884858067
1394,0.1394,5,93,5,106947,498663,2098,105858,4.619131868539035,0.1751105420655362
1395,0.1395,0,94,0,107041,498569,2098,105858,4.618261143428804,0.17513777511593626
1396,0.1396,3,93,3,107134,498476,2101,105855,4.617399681351662,0.17516063217011868
1397,0.1397,4,95,4,107229,498381,2105,105851,4.616519693208344,0.17518271127646334
1398,0.1398,6,93,6,107322,498288,2111,105845,4.615658231131202,0.17520148708976335
1399,0.1399,3,95,3,107417,498193,2114,105842,4.614778242987884,0.17522494557434587
1400,0.14,6,93,6,107510,498100,2120,105836,4.613916780910741,0.17524373443543687
1401,0.1401,3,92,3,107602,498008,2123,105833,4.613064581866686,0.1752663366680964
1402,0.1402,1,112,1,107714,497896,2124,105832,4.61202712216088,0.1752974849601145
1403,0.1403,3,93,3,107807,497803,2127,105829,4.611165660083738,0.17532039388236542
1404,0.1404,3,92,3,107899,497711,2130,105826,4.6103134610396825,0.1753430195663232
1405,0.1405,3,106,3,108005,497605,2133,105823,4.609331579532402,0.17536972099405398
1406,0.1406,2,92,2,108097,497513,2135,105821,4.6084793804883475,0.17539372884670845
1407,0.1407,2,99,2,108196,497414,2137,105819,4.607562340212679,0.1754197797534286
1408,0.1408,3,102,3,108298,497312,2140,105816,4.606617510837749,0.17544534493507183
1409,0.1409,0,115,0,108413,497197,2140,105816,4.60555226203268,0.17547880393955023
1410,0.141,4,99,4,108512,497098,2144,105812,4.604635221757012,0.17550214791594101
1411,0.1411,1,91,1,108603,497007,2145,105811,4.603792285746045,0.17552727357179115
1412,0.1412,5,84,5,108687,496923,2150,105806,4.60301419096669,0.17554489662850137
1413,0.1413,2,80,2,108767,496843,2152,105804,4.602273148319686,0.17556546369599452
1414,0.1414,1,108,1,108875,496735,2153,105803,4.60127274074623,0.17559556409720217
1415,0.1415,3,87,3,108962,496648,2156,105800,4.600466856867612,0.1756168167211112
1416,0.1416,1,109,1,109071,496539,2157,105799,4.599457186261069,0.17564722796835
1417,0.1417,4,102,4,109173,496437,2161,105795,4.598512356886139,0.17567150201251344
1418,0.1418,1,80,1,109253,496357,2162,105794,4.597771314239134,0.17569347223536955
1419,0.1419,7,100,7,109353,496257,2169,105787,4.596845010930379,0.1757130708054561
1420,0.142,2,90,2,109443,496167,2171,105785,4.5960113379525,0.17573660358300994
1421,0.1421,2,93,2,109536,496074,2173,105783,4.595149875875356,0.1757610196442012
1422,0.1422,5,95,5,109631,495979,2178,105778,4.594269887732039,0.1757819186149891
1423,0.1423,3,92,3,109723,495887,2181,105775,4.593417688687984,0.1758046876817881
1424,0.1424,11,109,11,109832,495778,2192,105764,4.59240801808144,0.17582147214990806
1425,0.1425,3,106,3,109938,495672,2195,105761,4.59142613657416,0.17584834886013903
1426,0.1426,4,90,4,110028,495582,2199,105757,4.59059246359628,0.17586918526820977
1427,0.1427,4,102,4,110130,495480,2203,105753,4.5896476342213495,0.1758935387778116
1428,0.1428,3,97,3,110227,495383,2206,105750,4.588749120011856,0.17591780853821035
1429,0.1429,5,121,5,110348,495262,2211,105745,4.587628293008263,0.17594637000900157
1430,0.143,1,105,1,110453,495157,2212,105744,4.58665567453407,0.17597574309245617
1431,0.1431,3,107,3,110560,495050,2215,105741,4.585664529993701,0.17600296941864974
1432,0.1432,5,89,5,110649,494961,2220,105736,4.584840120048908,0.17602218755878588
1433,0.1433,4,95,4,110744,494866,2224,105732,4.583960131905592,0.17604454227286803
1434,0.1434,3,106,3,110850,494760,2227,105729,4.582978250398311,0.17607150172609323
1435,0.1435,8,85,8,110935,494675,2235,105721,4.582190892585868,0.1760854502694888
1436,0.1436,3,114,3,111049,494561,2238,105718,4.581134906813888,0.17611477329708353
1437,0.1437,4,98,4,111147,494463,2242,105714,4.580227129571306,0.17613803927841287
1438,0.1438,1,84,1,111231,494379,2243,105713,4.579449034791952,0.1761613219306373
1439,0.1439,2,94,2,111325,494285,2245,105711,4.578578309681722,0.17618617457449717
1440,0.144,0,82,0,111407,494203,2245,105711,4.577818740968543,0.17621025680347516
1441,0.1441,3,91,3,111498,494112,2248,105708,4.576975804957575,0.1762328698609583
1442,0.1442,3,101,3,111599,494011,2251,105705,4.576040238615732,0.1762584289897218
1443,0.1443,3,98,3,111697,493913,2254,105702,4.575132461373152,0.1762831149987909
1444,0.1444,4,100,4,111797,493813,2258,105698,4.5742061580643965,0.17630702355753272
1445,0.1445,5,93,5,111890,493720,2263,105693,4.573344695987254,0.17632750707775774
1446,0.1446,3,111,3,112001,493609,2266,105690,4.572316499314535,0.17635604264315474
1447,0.1447,4,74,4,112075,493535,2270,105686,4.571631034866057,0.17637232339988085
1448,0.1448,6,98,6,112173,493437,2276,105680,4.570723257623476,0.17639292492117567
1449,0.1449,3,93,3,112266,493344,2279,105677,4.569861795546334,0.17641618574307077
1450,0.145,2,106,2,112372,493238,2281,105675,4.568879914039053,0.17644465890705327
1451,0.1451,5,100,5,112472,493138,2286,105670,4.567953610730298,0.17646724826655621
1452,0.1452,2,92,2,112564,493046,2288,105668,4.5671014116862425,0.17649161369201322
1453,0.1453,1,117,1,112681,492929,2289,105667,4.5660176368149985,0.17652473454550313
1454,0.1454,3,95,3,112776,492834,2292,105664,4.565137648671681,0.17654862672891136
1455,0.1455,4,85,4,112861,492749,2296,105660,4.564350290859239,0.1765682000103608
1456,0.1456,2,105,2,112966,492644,2298,105658,4.563377672385045,0.17659643457651822
1457,0.1457,1,91,1,113057,492553,2299,105657,4.5625347363740785,0.17662192206750138
1458,0.1458,0,100,0,113157,492453,2299,105657,4.561608433065323,0.1766514520740332
1459,0.1459,8,92,8,113249,492361,2307,105649,4.560756234021268,0.17666761425394223
1460,0.146,5,76,5,113325,492285,2312,105644,4.560052243506614,0.17668318479284328
1461,0.1461,4,95,4,113420,492190,2316,105640,4.559172255363296,0.17670575247143838
1462,0.1462,1,80,1,113500,492110,2317,105639,4.558431212716292,0.17672802463910436
1463,0.1463,5,89,5,113589,492021,2322,105634,4.5576068027715,0.17674745463519922
1464,0.1464,4,106,4,113695,491915,2326,105630,4.556624921264219,0.17677329740856337
1465,0.1465,3,95,3,113790,491820,2329,105627,4.555744933120901,0.17679727239403661
1466,0.1466,2,93,2,113883,491727,2331,105625,4.554883471043759,0.17682204127549586
1467,0.1467,2,108,2,113991,491619,2333,105623,4.553883063470303,0.17685125962340223
1468,0.1468,2,103,2,114094,491516,2335,105621,4.5529289710622844,0.17687900766490772
1469,0.1469,7,91,7,114185,491425,2342,105614,4.5520860350513175,0.17689631665603084
1470,0.147,2,99,2,114284,491326,2344,105612,4.551168994775649,0.17692289651521598
1471,0.1471,4,104,4,114388,491222,2348,105608,4.550205639334544,0.17694820970795705
1472,0.1472,1,93,1,114481,491129,2349,105607,4.549344177257401,0.17697440744315746
1473,0.1473,7,108,7,114589,491021,2356,105600,4.548343769683945,0.17699678690491955
1474,0.1474,5,90,5,114679,490931,2361,105595,4.547510096706065,0.1770165927386233
1475,0.1475,4,85,4,114764,490846,2365,105591,4.5467227388936235,0.17703630056485428
1476,0.1476,4,76,4,114840,490770,2369,105587,4.54601874837897,0.17705334220944838
1477,0.1477,3,123,3,114963,490647,2372,105584,4.5448793953092,0.17708572684077145
1478,0.1478,1,102,1,115065,490545,2373,105583,4.543934565934269,0.17711464651886843
1479,0.1479,1,104,1,115169,490441,2374,105582,4.542971210493164,0.17714417061086568
1480,0.148,3,94,3,115263,490347,2377,105579,4.542100485382933,0.17716797051982963
1481,0.1481,1,105,1,115368,490242,2378,105578,4.541127866908741,0.17719781141955623
1482,0.1482,4,97,4,115465,490145,2382,105574,4.540229352699248,0.1772211394969776
1483,0.1483,1,107,1,115572,490038,2383,105573,4.53923820815888,0.17725159542050095
1484,0.1484,7,95,7,115667,489943,2390,105566,4.538358220015562,0.17727020078621816
1485,0.1485,2,91,2,115758,489852,2392,105564,4.537515284004594,0.1772945302108106
1486,0.1486,1,92,1,115850,489760,2393,105563,4.53666308496054,0.1773205469971763
1487,0.1487,6,99,6,115949,489661,2399,105557,4.535746044684871,0.17734174705738065
1488,0.1488,3,74,3,116023,489587,2402,105554,4.535060580236393,0.17735965090625583
1489,0.1489,3,79,3,116102,489508,2405,105551,4.534328800622476,0.17737904980850638
1490,0.149,2,136,2,116238,489372,2407,105549,4.5330690281225685,0.17741683349553974
1491,0.1491,1,74,1,116312,489298,2408,105548,4.532383563674089,0.1774375216442575
1492,0.1492,3,121,3,116433,489177,2411,105545,4.531262736670495,0.17746947313198436
1493,0.1493,6,90,6,116523,489087,2417,105539,4.530429063692615,0.17748803449563255
1494,0.1494,1,89,1,116612,488998,2418,105538,4.529604653747823,0.1775132203937188
1495,0.1495,1,99,1,116711,488899,2419,105537,4.528687613472155,0.1775414005881205
1496,0.1496,5,94,5,116805,488805,2424,105532,4.527816888361925,0.1775625613078102
1497,0.1497,1,97,1,116902,488708,2425,105531,4.526918374152433,0.17759016153433216
1498,0.1498,9,112,9,117014,488596,2434,105522,4.525880914446627,0.17761118161711983
1499,0.1499,3,105,3,117119,488491,2437,105519,4.524908295972433,0.17763842359556237
1500,0.15,1,99,1,117218,488392,2438,105518,4.523991255696766,0.1776666498290987
1501,0.1501,4,82,4,117300,488310,2442,105514,4.523231686983586,0.17768564423128738
1502,0.1502,7,105,7,117405,488205,2449,105507,4.522259068509393,0.1777073732718894
1503,0.1503,4,82,4,117487,488123,2453,105503,4.521499499796214,0.1777263799092358
1504,0.1504,3,104,3,117591,488019,2456,105500,4.520536144355107,0.1777533659411072
1505,0.1505,7,90,7,117681,487929,2463,105493,4.519702471377228,0.17777062528858048
1506,0.1506,1,90,1,117771,487839,2464,105492,4.518868798399348,0.1777962048165358
1507,0.1507,3,83,3,117854,487756,2467,105489,4.518099966653081,0.177816922182235
1508,0.1508,1,103,1,117957,487653,2468,105488,4.517145874245063,0.1778464142590042
1509,0.1509,5,94,5,118051,487559,2473,105483,4.516275149134833,0.177867672104168
1510,0.151,3,83,3,118134,487476,2476,105480,4.5155063173885654,0.17788840993260882
1511,0.1511,1,88,1,118222,487388,2477,105479,4.514691170476861,0.17791342746349517
1512,0.1512,3,96,3,118318,487292,2480,105476,4.513801919300456,0.17793808032822284
1513,0.1513,4,86,4,118404,487206,2484,105472,4.513005298454926,0.17795835175255367
1514,0.1514,4,96,4,118500,487110,2488,105468,4.5121160472785204,0.17798163279770765
1515,0.1515,4,100,4,118600,487010,2492,105464,4.511189743969766,0.17800612347546052
1516,0.1516,1,97,1,118697,486913,2493,105463,4.510291229760273,0.17803388388455982
1517,0.1517,1,105,1,118802,486808,2494,105462,4.50931861128608,0.1780640586219123
1518,0.1518,5,89,5,118891,486719,2499,105457,4.508494201341287,0.17808388046796897
1519,0.1519,7,94,7,118985,486625,2506,105450,4.507623476231057,0.1781024363467466
1520,0.152,3,105,3,119090,486520,2509,105447,4.506650857756864,0.17812986196865704
1521,0.1521,3,89,3,119179,486431,2512,105444,4.505826447812072,0.17815248152059135
1522,0.1522,4,105,4,119284,486326,2516,105440,4.504853829337878,0.17817853678650006
1523,0.1523,3,86,3,119370,486240,2519,105437,4.504057208492349,0.17820026805165656
1524,0.1524,3,88,3,119458,486152,2522,105434,4.503242061580644,0.17822260837815634
1525,0.1525,3,104,3,119562,486048,2525,105431,4.502278706139538,0.17824977725329216
1526,0.1526,5,106,5,119668,485942,2530,105426,4.5012968246322576,0.1782747798325239
1527,0.1527,6,96,6,119764,485846,2536,105420,4.500407573455853,0.17829538650962512
1528,0.1528,4,88,4,119852,485758,2540,105416,4.499592426544147,0.17831636709327542
1529,0.1529,4,89,4,119941,485669,2544,105412,4.498768016599355,0.1783376559219464
1530,0.153,4,116,4,120057,485553,2548,105408,4.497693504761199,0.1783671003670293
1531,0.1531,2,89,2,120146,485464,2550,105406,4.4968690948164065,0.17839118587845043
1532,0.1532,5,119,5,120265,485345,2555,105401,4.495766793878988,0.17842016704302696
1533,0.1533,1,90,1,120355,485255,2556,105400,4.494933120901107,0.17844596253312
1534,0.1534,0,96,0,120451,485159,2556,105400,4.4940438697247025,0.17847497032472623
1535,0.1535,4,104,4,120555,485055,2560,105396,4.493080514283597,0.17850084088264734
1536,0.1536,1,101,1,120656,484954,2561,105395,4.492144947941754,0.17852998819342455
1537,0.1537,3,88,3,120744,484866,2564,105392,4.491329801030049,0.17855242961552406
1538,0.1538,2,100,2,120844,484766,2566,105390,4.490403497721294,0.17857990090755665
1539,0.1539,4,95,4,120939,484671,2570,105386,4.489523509577976,0.1786030841088234
1540,0.154,4,116,4,121055,484555,2574,105382,4.48844899773982,0.17863263365410204
1541,0.1541,3,113,3,121168,484442,2577,105379,4.487402275000926,0.1786626790161761
1542,0.1542,7,83,7,121251,484359,2584,105372,4.486633443254659,0.17867807525804139
1543,0.1543,2,120,2,121371,484239,2586,105370,4.4855218792841525,0.1787116546728425
1544,0.1544,5,107,5,121478,484132,2591,105365,4.484530734743784,0.1787371267368621
1545,0.1545,1,99,1,121577,484033,2592,105364,4.483613694468117,0.1787657555094444
1546,0.1546,3,95,3,121672,483938,2595,105361,4.482733706324799,0.1787903933317382
1547,0.1547,5,79,5,121751,483859,2600,105356,4.482001926710883,0.17880739628149317
1548,0.1548,6,97,6,121848,483762,2606,105350,4.4811034125013895,0.17882847404228738
1549,0.1549,4,88,4,121936,483674,2610,105346,4.480288265589684,0.17884961461410478
1550,0.155,5,107,5,122043,483567,2615,105341,4.479297121049316,0.17887513839173522
1551,0.1551,9,93,9,122136,483474,2624,105332,4.478435658972174,0.17889084010692827
1552,0.1552,5,98,5,122234,483376,2629,105327,4.477527881729594,0.178913645760256
1553,0.1553,3,102,3,122336,483274,2632,105324,4.476583052354663,0.1789404653090904
1554,0.1554,7,75,7,122411,483199,2639,105317,4.475888324873097,0.17895350338818317
1555,0.1555,3,95,3,122506,483104,2642,105314,4.475008336729779,0.17897820936817024
1556,0.1556,2,101,2,122607,483003,2644,105312,4.474072770387936,0.17900614466739756
1557,0.1557,5,96,5,122703,482907,2649,105307,4.47318351921153,0.17902838082738595
1558,0.1558,7,104,7,122807,482803,2656,105300,4.472220163770425,0.17905026840536437
1559,0.1559,2,107,2,122914,482696,2658,105298,4.471229019230057,0.17908005864005416
1560,0.156,3,98,3,123012,482598,2661,105295,4.4703212419874765,0.17910572161941032
1561,0.1561,2,78,2,123090,482520,2663,105293,4.469598725406647,0.17912669505437953
1562,0.1562,5,114,5,123204,482406,2668,105288,4.468542739634666,0.1791544579321892
1563,0.1563,4,90,4,123294,482316,2672,105284,4.467709066656786,0.17917631041524848
1564,0.1564,4,100,4,123394,482216,2676,105280,4.46678276334803,0.1792012200934134
1565,0.1565,3,100,3,123494,482116,2679,105277,4.465856460039276,0.17922753590866763
1566,0.1566,5,92,5,123586,482024,2684,105272,4.4650042609952205,0.17924862420312757
1567,0.1567,4,105,4,123691,481919,2688,105268,4.464031642521027,0.17927508613099405
1568,0.1568,4,96,4,123787,481823,2692,105264,4.463142391344622,0.17929880920544997
1569,0.1569,2,98,2,123885,481725,2694,105262,4.462234614102042,0.17932594759338794
1570,0.157,5,94,5,123979,481631,2699,105257,4.461363888991811,0.17934767792151143
1571,0.1571,7,102,7,124081,481529,2706,105250,4.460419059616881,0.1793690639917243
1572,0.1572,5,101,5,124182,481428,2711,105245,4.459483493275038,0.17939294973520173
1573,0.1573,2,88,2,124270,481340,2713,105243,4.458668346363333,0.17941706459273454
1574,0.1574,6,84,6,124354,481256,2719,105237,4.4578902515839784,0.17943436665058235
1575,0.1575,1,97,1,124451,481159,2720,105236,4.456991737374486,0.1794626488970745
1576,0.1576,10,101,10,124552,481058,2730,105226,4.4560561710326425,0.17947956962837122
1577,0.1577,3,96,3,124648,480962,2733,105223,4.455166919856238,0.17950476385441455
1578,0.1578,4,93,4,124741,480869,2737,105219,4.454305457779095,0.17952764772525628
1579,0.1579,5,87,5,124828,480782,2742,105214,4.453499573900478,0.17954730066416835
1580,0.158,3,107,3,124935,480675,2745,105211,4.45250842936011,0.17957589019024178
1581,0.1581,1,112,1,125047,480563,2746,105210,4.451470969654304,0.17960882457880442
1582,0.1582,6,103,6,125150,480460,2752,105204,4.450516877246286,0.17963200743088187
1583,0.1583,1,91,1,125241,480369,2753,105203,4.449673941235318,0.17965852192386247
1584,0.1584,5,102,5,125343,480267,2758,105198,4.448729111860388,0.17968281622300222
1585,0.1585,4,106,4,125449,480161,2762,105194,4.447747230353107,0.17970974878492538
1586,0.1586,4,92,4,125541,480069,2766,105190,4.446895031309052,0.17973239198372004
1587,0.1587,8,94,8,125635,479975,2774,105182,4.446024306198821,0.1797500499865848
1588,0.1588,5,98,5,125733,479877,2779,105177,4.445116528956241,0.17977314914520712
1589,0.1589,6,75,6,125808,479802,2785,105171,4.444421801474675,0.17978778507725998
1590,0.159,2,98,2,125906,479704,2787,105169,4.443514024232095,0.17981510515958166
1591,0.1591,0,94,0,126000,479610,2787,105169,4.4426432991218645,0.17984400944630366
1592,0.1592,6,102,6,126102,479508,2793,105163,4.4416984697469335,0.17986696791870985
1593,0.1593,5,93,5,126195,479415,2798,105158,4.440837007669791,0.17988856823698665
1594,0.1594,5,104,5,126299,479311,2803,105153,4.439873652228686,0.17991356182758905
1595,0.1595,1,91,1,126390,479220,2804,105152,4.439030716217719,0.179940175093947
1596,0.1596,3,85,3,126475,479135,2807,105149,4.438243358405276,0.17996214169821526
1597,0.1597,5,87,5,126562,479048,2812,105144,4.437437474526659,0.17998192375109553
1598,0.1598,4,97,4,126659,478951,2816,105140,4.436538960317166,0.18000619766440504
1599,0.1599,4,85,4,126744,478866,2820,105136,4.435751602504724,0.18002678073020298
1600,0.16,2,104,2,126848,478762,2822,105134,4.434788247063619,0.1800560373765191
1601,0.1601,4,101,4,126949,478661,2826,105130,4.433852680721776,0.1800815702879969
1602,0.1602,3,92,3,127041,478569,2829,105127,4.433000481677721,0.18010573997423315
1603,0.1603,4,93,4,127134,478476,2833,105123,4.432139019600578,0.1801288213310852
1604,0.1604,2,94,2,127228,478382,2835,105121,4.431268294490348,0.18015502919436574
1605,0.1605,1,105,1,127333,478277,2836,105120,4.430295676016155,0.1801860482655893
1606,0.1606,4,91,4,127424,478186,2840,105116,4.429452740005187,0.1802085369156972
1607,0.1607,3,101,3,127525,478085,2843,105113,4.428517173663344,0.18023552892842568
1608,0.1608,5,101,5,127626,477984,2848,105108,4.4275816073215015,0.1802597188779815
1609,0.1609,3,96,3,127722,477888,2851,105105,4.426692356145096,0.18028518352707493
1610,0.161,2,96,2,127818,477792,2853,105103,4.425803104968691,0.18031206306453135
1611,0.1611,3,112,3,127930,477680,2856,105100,4.424765645262885,0.18034249631078622
1612,0.1612,6,103,6,128033,477577,2862,105094,4.4238115528548665,0.18036593549361474
1613,0.1613,3,99,3,128132,477478,2865,105091,4.422894512579199,0.18039236553953267
1614,0.1614,6,106,6,128238,477372,2871,105085,4.421912631071918,0.18041675179455308
1615,0.1615,6,95,6,128333,477277,2877,105079,4.4210326429286,0.18043773911490565
1616,0.1616,2,92,2,128425,477185,2879,105077,4.420180443884545,0.18046343398676198
1617,0.1617,5,98,5,128523,477087,2884,105072,4.419272666641965,0.18048677423178203
1618,0.1618,5,96,5,128619,476991,2889,105067,4.41838341546556,0.18050950248944264
1619,0.1619,6,94,6,128713,476897,2895,105061,4.41751269035533,0.18053021008388923
1620,0.162,5,105,5,128818,476792,2900,105056,4.416540071881137,0.18055574651799094
1621,0.1621,4,102,4,128920,476690,2904,105052,4.415595242506206,0.18058176992549962
1622,0.1622,5,96,5,129016,476594,2909,105047,4.414705991329801,0.18060453097357304
1623,0.1623,6,97,6,129113,476497,2915,105041,4.413807477120308,0.1806262015551864
1624,0.1624,6,105,6,129218,476392,2921,105035,4.412834858646115,0.18065036539410795
1625,0.1625,1,99,1,129317,476293,2922,105034,4.411917818370447,0.18067972070796642
1626,0.1626,4,99,4,129416,476194,2926,105030,4.411000778094779,0.18070485733555394
1627,0.1627,2,94,2,129510,476100,2928,105028,4.410130052984549,0.18073126746603158
1628,0.1628,4,109,4,129619,475991,2932,105024,4.409120382378006,0.1807595328864143
1629,0.1629,4,93,4,129712,475898,2936,105020,4.408258920300863,0.18078282993468958
1630,0.163,5,99,5,129811,475799,2941,105015,4.407341880025196,0.18080659212760022
1631,0.1631,6,82,6,129893,475717,2947,105009,4.406582311312016,0.1808236586617441
1632,0.1632,4,113,4,130006,475604,2951,105005,4.405535588573122,0.18085320758031653
1633,0.1633,2,94,2,130100,475510,2953,105003,4.404664863462893,0.1808796702227168
1634,0.1634,5,84,5,130184,475426,2958,104998,4.403886768683538,0.18089879122848124
1635,0.1635,7,101,7,130285,475325,2965,104991,4.402951202341694,0.18092039509508612
1636,0.1636,8,97,8,130382,475228,2973,104983,4.402052688132202,0.18093934792687488
1637,0.1637,2,76,2,130458,475152,2975,104981,4.401348697617548,0.18096022808562864
1638,0.1638,2,109,2,130567,475043,2977,104979,4.400339027011005,0.18099141067062974
1639,0.1639,5,102,5,130669,474941,2982,104974,4.399394197636074,0.18101618340618883
1640,0.164,5,97,5,130766,474844,2987,104969,4.398495683426582,0.18103940408373045
1641,0.1641,3,108,3,130874,474736,2990,104966,4.397495275853125,0.18106889401796095
1642,0.1642,4,101,4,130975,474635,2994,104962,4.3965597095112825,0.18109479517664862
1643,0.1643,3,91,3,131066,474544,2997,104959,4.395716773500315,0.18111899334429676
1644,0.1644,1,89,1,131155,474455,2998,104958,4.394892363555523,0.18114540060371445
1645,0.1645,4,94,4,131249,474361,3002,104954,4.394021638445293,0.1811691394146535
1646,0.1646,4,98,4,131347,474263,3006,104950,4.393113861202712,0.18119413756252017
1647,0.1647,2,98,2,131445,474165,3008,104948,4.392206083960132,0.18122197222303765
1648,0.1648,4,98,4,131543,474067,3012,104944,4.391298306717552,0.18124698839918413
1649,0.1649,4,94,4,131637,473973,3016,104940,4.390427581607321,0.18127076089153293
1650,0.165,4,110,4,131747,473863,3020,104936,4.389408647967691,0.1812995530400018
1651,0.1651,5,114,5,131861,473749,3025,104931,4.388352662195709,0.18132819520287552
1652,0.1652,1,92,1,131953,473657,3026,104930,4.387500463151654,0.18135561289831953
1653,0.1653,3,107,3,132060,473550,3029,104927,4.386509318611286,0.18138491245114327
1654,0.1654,3,106,3,132166,473444,3032,104924,4.385527437104005,0.18141390948323557
1655,0.1655,6,112,6,132278,473332,3038,104918,4.384489977398199,0.18144055339386078
1656,0.1656,6,94,6,132372,473238,3044,104912,4.38361925228797,0.1814615584190954
1657,0.1657,5,87,5,132459,473151,3049,104907,4.3828133684093515,0.18148178902463075
1658,0.1658,4,87,4,132546,473064,3053,104903,4.382007484530734,0.18150344223805165
1659,0.1659,5,107,5,132653,472957,3058,104898,4.381016339990366,0.18152996859073642
1660,0.166,6,86,6,132739,472871,3064,104892,4.380219719144836,0.18154848960559952
1661,0.1661,3,104,3,132843,472767,3067,104889,4.379256363703731,0.181576924674893
1662,0.1662,3,83,3,132926,472684,3070,104886,4.3784875319574645,0.18159876724899146
1663,0.1663,2,96,2,133022,472588,3072,104884,4.377598280781059,0.18162612213232848
1664,0.1664,8,79,8,133101,472509,3080,104876,4.376866501167142,0.18163963386648424
1665,0.1665,3,85,3,133186,472424,3083,104873,4.3760791433547,0.18166212538779866
1666,0.1666,6,94,6,133280,472330,3089,104867,4.37520841824447,0.18168320348165357
1667,0.1667,4,80,4,133360,472250,3093,104863,4.374467375597465,0.1817027167989631
1668,0.1668,2,99,2,133459,472151,3095,104861,4.373550335321798,0.18173105585325783
1669,0.1669,2,103,2,133562,472048,3097,104859,4.3725962429137795,0.18176066506386646
1670,0.167,2,78,2,133640,471970,3099,104857,4.37187372633295,0.18178240616337307
1671,0.1671,5,90,5,133730,471880,3104,104852,4.37104005335507,0.18180368004549774
1672,0.1672,2,109,2,133839,471771,3106,104850,4.370030382748527,0.1818352089153881
1673,0.1673,4,108,4,133947,471663,3110,104846,4.369029975175072,0.1818635962318021
1674,0.1674,2,82,2,134029,471581,3112,104844,4.368270406461892,0.1818866287895216
1675,0.1675,3,114,3,134143,471467,3115,104841,4.367214420689911,0.1819183492160442
1676,0.1676,5,110,5,134253,471357,3120,104836,4.3661954870502795,0.18194597990603842
1677,0.1677,3,97,3,134350,471260,3123,104833,4.365296972840787,0.18197235515793456
1678,0.1678,4,93,4,134443,471167,3127,104829,4.364435510763644,0.1819960555281634
1679,0.1679,3,84,3,134527,471083,3130,104826,4.36365741598429,0.1820183397029739
1680,0.168,5,84,5,134611,470999,3135,104821,4.362879321204935,0.1820377895870237
1681,0.1681,3,101,3,134712,470898,3138,104818,4.361943754863092,0.18206546283236874
1682,0.1682,5,101,5,134813,470797,3143,104813,4.361008188521249,0.18209030419902364
1683,0.1683,2,87,2,134900,470710,3145,104811,4.360202304642632,0.18211498798479986
1684,0.1684,4,95,4,134995,470615,3149,104807,4.3593223164993145,0.18213936901960648
1685,0.1685,3,107,3,135102,470508,3152,104804,4.358331171958946,0.1821689796145396
1686,0.1686,5,93,5,135195,470415,3157,104799,4.357469709881804,0.1821913235769644
1687,0.1687,5,79,5,135274,470336,3162,104794,4.356737930267887,0.18220923965016605
1688,0.1688,6,96,6,135370,470240,3168,104788,4.355848679091482,0.1822311261364664
1689,0.1689,5,88,5,135458,470152,3173,104783,4.355033532179777,0.18225190673728334
1690,0.169,2,97,2,135555,470055,3175,104781,4.354135017970284,0.18227981546040958
1691,0.1691,4,99,4,135654,469956,3179,104777,4.353217977694617,0.1823055227383846
1692,0.1692,2,101,2,135755,469855,3181,104775,4.352282411352773,0.18233471973269758
1693,0.1693,7,118,7,135873,469737,3188,104768,4.351189373448442,0.1823622074655573
1694,0.1694,2,101,2,135974,469636,3190,104766,4.350253807106599,0.18239142621369703
1695,0.1695,4,86,4,136060,469550,3194,104762,4.349457186261069,0.18241304378108067
1696,0.1696,4,103,4,136163,469447,3198,104758,4.348503093853052,0.18244006931322437
1697,0.1697,5,109,5,136272,469338,3203,104753,4.347493423246508,0.1824675878911183
1698,0.1698,7,87,7,136359,469251,3210,104746,4.346687539367891,0.18248527431328038
1699,0.1699,8,77,8,136436,469174,3218,104738,4.345974285820149,0.18249836211823414
1700,0.17,4,106,4,136542,469068,3222,104734,4.344992404312868,0.1825263766943998
1701,0.1701,1,83,1,136625,468985,3223,104733,4.344223572566602,0.18255135798423616
1702,0.1702,2,89,2,136714,468896,3225,104731,4.343399162621809,0.18257683128583557
1703,0.1703,2,94,2,136808,468802,3227,104729,4.342528437511579,0.1826039045840591
1704,0.1704,0,80,0,136888,468722,3227,104729,4.341787394864575,0.18262937897047873
1705,0.1705,3,107,3,136995,468615,3230,104726,4.340796250324206,0.18265918537135842
1706,0.1706,4,86,4,137081,468529,3234,104722,4.339999629478677,0.18268088498755344
1707,0.1707,4,84,4,137165,468445,3238,104718,4.339221534699322,0.18270195389444188
1708,0.1708,3,121,3,137286,468324,3241,104715,4.338100707695728,0.18273625355342307
1709,0.1709,5,105,5,137391,468219,3246,104710,4.337128089221535,0.18276261107397251
1710,0.171,5,99,5,137490,468120,3251,104705,4.3362110489458665,0.18278706411207613
1711,0.1711,6,94,6,137584,468026,3257,104699,4.335340323835637,0.18280850320834607
1712,0.1712,6,98,6,137682,467928,3263,104693,4.334432546593057,0.1828312269371888
1713,0.1713,3,79,3,137761,467849,3266,104690,4.33370076697914,0.18285217251575875
1714,0.1714,4,114,4,137875,467735,3270,104686,4.332644781207159,0.18288287816135326
1715,0.1715,5,103,5,137978,467632,3275,104681,4.33169068879914,0.18290865313211477
1716,0.1716,2,104,2,138082,467528,3277,104679,4.330727333358035,0.18293904129100133
1717,0.1717,4,92,4,138174,467436,3281,104675,4.32987513431398,0.1829627467397061
1718,0.1718,3,107,3,138281,467329,3284,104672,4.328883989773612,0.1829926870757219
1719,0.1719,6,94,6,138375,467235,3290,104666,4.328013264663381,0.1830141930159241
1720,0.172,3,104,3,138479,467131,3293,104663,4.327049909222276,0.18304319387751533
1721,0.1721,3,102,3,138581,467029,3296,104660,4.326105079847345,0.1830715651341901
1722,0.1722,3,100,3,138681,466929,3299,104657,4.32517877653859,0.1830993061411581
1723,0.1723,2,107,2,138788,466822,3301,104655,4.324187631998221,0.1831307296706604
1724,0.1724,4,101,4,138889,466721,3305,104651,4.323252065656378,0.1831573825808755
1725,0.1725,6,84,6,138973,466637,3311,104645,4.322473970877024,0.18317573457591874
1726,0.1726,4,85,4,139058,466552,3315,104641,4.321686613064582,0.1831972730758255
1727,0.1727,4,73,4,139131,466479,3319,104637,4.3210104116491905,0.18321496858781752
1728,0.1728,7,103,7,139234,466376,3326,104630,4.320056319241172,0.18323800450433095
1729,0.1729,8,92,8,139326,466284,3334,104622,4.319204120197117,0.1832560876921945
1730,0.173,5,100,5,139426,466184,3339,104617,4.3182778168883615,0.18328103840042326
1731,0.1731,6,93,6,139519,466091,3345,104611,4.317416354811219,0.18330231889847942
1732,0.1732,3,95,3,139614,465996,3348,104608,4.3165363666679015,0.18332854308767552
1733,0.1733,4,90,4,139704,465906,3352,104604,4.315702693690022,0.18335173791870432
1734,0.1734,3,93,3,139797,465813,3355,104601,4.3148412316128795,0.1833773364608863
1735,0.1735,4,103,4,139900,465710,3359,104597,4.313887139204861,0.18340472762915414
1736,0.1736,5,91,5,139991,465619,3364,104592,4.313044203193893,0.18342683673236748
1737,0.1737,8,96,8,140087,465523,3372,104584,4.312154952017488,0.18344626535018865
1738,0.1738,2,84,2,140171,465439,3374,104582,4.311376857238134,0.18347043354543077
1739,0.1739,2,89,2,140260,465350,3376,104580,4.310552447293341,0.1834962188338919
1740,0.174,4,82,4,140342,465268,3380,104576,4.309792878580162,0.18351689234246565
1741,0.1741,3,93,3,140435,465175,3383,104573,4.30893141650302,0.18354254863553712
1742,0.1742,10,93,10,140528,465082,3393,104563,4.308069954425878,0.18355818097235999
1743,0.1743,3,90,3,140618,464992,3396,104560,4.307236281447997,0.18358288619827515
1744,0.1744,1,87,1,140705,464905,3397,104559,4.30643039756938,0.1836094994591405
1745,0.1745,4,101,4,140806,464804,3401,104555,4.305494831227537,0.18363633489590925
1746,0.1746,4,95,4,140901,464709,3405,104551,4.304614843084219,0.1836612444225837
1747,0.1747,2,111,2,141012,464598,3407,104549,4.303586646411501,0.18369419499707457
1748,0.1748,3,107,3,141119,464491,3410,104546,4.302595501871132,0.18372443268188185
1749,0.1749,4,111,4,141230,464380,3414,104542,4.3015673051984145,0.1837545392865806
1750,0.175,7,98,7,141328,464282,3421,104535,4.300659527955834,0.1837761529630795
1751,0.1751,2,92,2,141420,464190,3423,104533,4.299807328911779,0.18380301130778956
1752,0.1752,12,89,12,141509,464101,3435,104521,4.298982918966987,0.1838145551878049
1753,0.1753,7,74,7,141583,464027,3442,104514,4.298297454518508,0.183828431019047
1754,0.1754,4,89,4,141672,463938,3446,104510,4.2974730445737155,0.18385146926367935
1755,0.1755,3,89,3,141761,463849,3449,104507,4.296648634628923,0.183875950988465
1756,0.1756,8,95,8,141856,463754,3457,104499,4.295768646485605,0.1838952016091424
1757,0.1757,5,106,5,141962,463648,3462,104494,4.2947867649783245,0.18392232927683572
1758,0.1758,5,114,5,142076,463534,3467,104489,4.293730779206343,0.18395205827933023
1759,0.1759,4,95,4,142171,463439,3471,104485,4.292850791063025,0.18397708144047442
1760,0.176,10,96,10,142267,463343,3481,104475,4.29196153988662,0.1839938149195693
1761,0.1761,2,87,2,142354,463256,3483,104473,4.291155656008003,0.18401913589053934
1762,0.1762,4,104,4,142458,463152,3487,104469,4.290192300566898,0.1840471018514114
1763,0.1763,7,86,7,142544,463066,3494,104462,4.289395679721368,0.18406492719301956
1764,0.1764,4,87,4,142631,462979,3498,104458,4.288589795842751,0.18408739648630598
1765,0.1765,10,93,10,142724,462886,3508,104448,4.2877283337656085,0.18410319141810644
1766,0.1766,3,85,3,142809,462801,3511,104445,4.286940975953166,0.18412646365069124
1767,0.1767,4,90,4,142899,462711,3515,104441,4.286107302975286,0.18414992806161312
1768,0.1768,6,90,6,142989,462621,3521,104435,4.285273629997406,0.18417052284077762
1769,0.1769,2,98,2,143087,462523,3523,104433,4.284365852754826,0.18419947932467423
1770,0.177,9,86,9,143173,462437,3532,104424,4.283569231909296,0.18421447233095944
1771,0.1771,2,90,2,143263,462347,3534,104422,4.282735558931416,0.18424084591782544
1772,0.1772,8,97,8,143360,462250,3542,104414,4.281837044721923,0.18426086710996287
1773,0.1773,7,89,7,143449,462161,3549,104407,4.281012634777132,0.18427973341240592
1774,0.1774,1,89,1,143538,462072,3550,104406,4.280188224832339,0.18430724582419794
1775,0.1775,2,98,2,143636,461974,3552,104404,4.279280447589759,0.184336255998644
1776,0.1776,4,99,4,143735,461875,3556,104400,4.278363407314091,0.18436272129265815
1777,0.1777,2,97,2,143832,461778,3558,104398,4.277464893104598,0.18439142598767874
1778,0.1778,7,93,7,143925,461685,3565,104391,4.276603431027455,0.1844116337735569
1779,0.1779,3,106,3,144031,461579,3568,104388,4.275621549520175,0.18444184908307376
1780,0.178,3,97,3,144128,461482,3571,104385,4.274723035310682,0.18446914204221132
1781,0.1781,5,86,5,144214,461396,3576,104380,4.273926414465152,0.18448997483102852
1782,0.1782,5,102,5,144316,461294,3581,104375,4.272981585090222,0.18451603322791243
1783,0.1783,4,100,4,144416,461194,3585,104371,4.2720552817814665,0.184542890737581
1784,0.1784,8,99,8,144515,461095,3593,104363,4.271138241505799,0.18456366343742595
1785,0.1785,6,91,6,144606,461004,3599,104357,4.270295305494831,0.18458471666775741
1786,0.1786,4,95,4,144701,460909,3603,104353,4.2694153173515135,0.18460996847479577
1787,0.1787,3,107,3,144808,460802,3606,104350,4.268424172811145,0.18464059226544363
1788,0.1788,8,103,8,144911,460699,3614,104342,4.267470080403127,0.1846627058921388
1789,0.1789,3,102,3,145013,460597,3617,104339,4.266525251028197,0.18469171729187023
1790,0.179,4,107,4,145120,460490,3621,104335,4.265534106487828,0.1847209312618953
1791,0.1791,3,110,3,145230,460380,3624,104332,4.264515172848197,0.18475258184703
1792,0.1792,1,104,1,145334,460276,3625,104331,4.263551817407092,0.1847851691530569
1793,0.1793,4,94,4,145428,460182,3629,104327,4.262681092296861,0.18481016245976592
1794,0.1794,7,89,7,145517,460093,3636,104320,4.261856682352069,0.18482919422479638
1795,0.1795,4,108,4,145625,459985,3640,104316,4.260856274778614,0.18485878990113433
1796,0.1796,3,98,3,145723,459887,3643,104313,4.259948497536033,0.18488656504785536
1797,0.1797,5,102,5,145825,459785,3648,104308,4.259003668161102,0.18491277147562546
1798,0.1798,4,87,4,145912,459698,3652,104304,4.258197784282485,0.18493551441306946
1799,0.1799,2,103,2,146015,459595,3654,104302,4.257243691874467,0.1849664034389259
1800,0.18,3,94,3,146109,459501,3657,104299,4.256372966764237,0.18499290528556225
1801,0.1801,3,106,3,146215,459395,3660,104296,4.2553910852569565,0.18502335499413686
1802,0.1802,1,124,1,146339,459271,3661,104295,4.2542424691541,0.18506261910761118
1803,0.1803,4,91,4,146430,459180,3665,104291,4.253399533143132,0.18508672141068486
1804,0.1804,4,121,4,146551,459059,3669,104287,4.252278706139538,0.1851206895939618
1805,0.1805,2,90,2,146641,458969,3671,104285,4.251445033161659,0.18514737578428206
1806,0.1806,5,112,5,146753,458857,3676,104280,4.250407573455853,0.18517696404249764
1807,0.1807,4,94,4,146847,458763,3680,104276,4.249536848345622,0.18520209079655228
1808,0.1808,5,101,5,146948,458662,3685,104271,4.248601282003779,0.18522808220516473
1809,0.1809,4,96,4,147044,458566,3689,104267,4.247712030827374,0.1852538852554843
1810,0.181,3,79,3,147123,458487,3692,104264,4.246980251213457,0.18527554815540087
1811,0.1811,5,89,5,147212,458398,3697,104259,4.246155841268665,0.18529761471020534
1812,0.1812,5,96,5,147308,458302,3702,104254,4.2452665900922595,0.18532199461031434
1813,0.1813,6,86,6,147394,458216,3708,104248,4.2444699692467305,0.1853416396427149
1814,0.1814,5,119,5,147513,458097,3713,104243,4.243367668309311,0.18537361738450048
1815,0.1815,6,83,6,147596,458014,3719,104237,4.242598836563044,0.18539228920891204
1816,0.1816,8,104,8,147700,457910,3727,104229,4.241635481121938,0.18541499522360128
1817,0.1817,2,108,2,147808,457802,3729,104227,4.240635073548483,0.185447726007021
1818,0.1818,7,95,7,147903,457707,3736,104220,4.239755085405165,0.18546893101773007
1819,0.1819,4,83,4,147986,457624,3740,104216,4.238986253658898,0.18549053111206038
1820,0.182,5,117,5,148103,457507,3745,104211,4.237902478787654,0.1855219166912935
1821,0.1821,5,116,5,148219,457391,3750,104206,4.236827966949498,0.18555298550383995
1822,0.1822,4,105,4,148324,457286,3754,104202,4.2358553484753045,0.1855818824266948
1823,0.1823,9,105,9,148429,457181,3763,104193,4.234882730001112,0.18560353703591545
1824,0.1824,3,92,3,148521,457089,3766,104190,4.234030530957057,0.18562960666620343
1825,0.1825,5,89,5,148610,457000,3771,104185,4.233206121012264,0.18565179040779778
1826,0.1826,5,98,5,148708,456902,3776,104180,4.232298343769684,0.18567695987395783
1827,0.1827,2,86,2,148794,456816,3778,104178,4.231501722924154,0.18570252088257627
1828,0.1828,5,102,5,148896,456714,3783,104173,4.230556893549224,0.18572903276417532
1829,0.1829,5,115,5,149011,456599,3788,104168,4.229491644744155,0.1857598610474582
1830,0.183,5,114,5,149125,456485,3793,104163,4.228435658972174,0.1857903711419643
1831,0.1831,5,87,5,149212,456398,3798,104158,4.227629775093557,0.18581194385574323
1832,0.1832,3,99,3,149311,456299,3801,104155,4.226712734817888,0.18584040795497936
1833,0.1833,5,115,5,149426,456184,3806,104150,4.22564748601282,0.18587128391280916
1834,0.1834,6,85,6,149511,456099,3812,104144,4.224860128200378,0.18589076525721873
1835,0.1835,5,97,5,149608,456002,3817,104139,4.223961613990885,0.18591568908542672
1836,0.1836,3,100,3,149708,455902,3820,104136,4.22303531068213,0.18594452519293334
1837,0.1837,6,87,6,149795,455815,3826,104130,4.222229426803513,0.1859646929609158
1838,0.1838,6,117,6,149912,455698,3832,104124,4.221145651932269,0.18599483407225867
1839,0.1839,2,88,2,150000,455610,3834,104122,4.220330505020564,0.18602116727290918
1840,0.184,4,97,4,150097,455513,3838,104118,4.219431990811072,0.1860475920740631
1841,0.1841,4,94,4,150191,455419,3842,104114,4.218561265700841,0.18607302875791062
1842,0.1842,8,80,8,150271,455339,3850,104106,4.217820223053836,0.18608799792651645
1843,0.1843,2,103,2,150374,455236,3852,104104,4.216866130645819,0.186119354954053
1844,0.1844,6,97,6,150471,455139,3858,104098,4.215967616436326,0.18614290542292444
1845,0.1845,5,85,5,150556,455054,3863,104093,4.215180258623884,0.18616392469243329
1846,0.1846,5,98,5,150654,454956,3868,104088,4.214272481381303,0.1861892802713203
1847,0.1847,3,85,3,150739,454871,3871,104085,4.213485123568861,0.1862132260857742
1848,0.1848,3,115,3,150854,454756,3874,104082,4.212419874763793,0.18624717717835937
1849,0.1849,2,121,2,150975,454635,3876,104080,4.211299047760199,0.18628459948274165
1850,0.185,1,108,1,151083,454527,3877,104079,4.210298640186743,0.18631915876306376
1851,0.1851,4,101,4,151184,454426,3881,104075,4.2093630738449,0.18634702534104683
1852,0.1852,2,90,2,151274,454336,3883,104073,4.20852940086702,0.18637414511585593
1853,0.1853,4,85,4,151359,454251,3887,104069,4.207742043054578,0.18639669007021062
1854,0.1854,3,99,3,151458,454152,3890,104066,4.20682500277891,0.18642537503269332
1855,0.1855,12,91,12,151549,454061,3902,104054,4.205982066767943,0.18643827884934108
1856,0.1856,3,79,3,151628,453982,3905,104051,4.205250287154025,0.18646029894289406
1857,0.1857,4,98,4,151726,453884,3909,104047,4.204342509911445,0.18648721795347453
1858,0.1858,5,103,5,151829,453781,3914,104042,4.203388417503428,0.18651436028991275
1859,0.1859,4,99,4,151928,453682,3918,104038,4.202471377227759,0.1865416337947357
1860,0.186,5,101,5,152029,453581,3923,104033,4.201535810885916,0.18656812777297557
1861,0.1861,4,84,4,152113,453497,3927,104029,4.200757716106562,0.18659040116514747
1862,0.1862,3,102,3,152215,453395,3930,104026,4.199812886731632,0.18662016680390583
1863,0.1863,6,102,6,152317,453293,3936,104020,4.198868057356701,0.18664556541835559
1864,0.1864,4,92,4,152409,453201,3940,104016,4.198015858312646,0.18667054307388325
1865,0.1865,3,69,3,152478,453132,3943,104013,4.197376709029605,0.18668928196430012
1866,0.1866,2,117,2,152595,453015,3945,104011,4.196292934158361,0.186725574748755
1867,0.1867,7,103,7,152698,452912,3952,104004,4.195338841750343,0.18674988687701558
1868,0.1868,5,102,5,152800,452810,3957,103999,4.194394012375412,0.18677679419693288
1869,0.1869,5,116,5,152916,452694,3962,103994,4.193319500537256,0.18680840973759089
1870,0.187,5,103,5,153019,452591,3967,103989,4.192365408129238,0.18683567501527185
1871,0.1871,5,95,5,153114,452496,3972,103984,4.19148541998592,0.18686026451983898
1872,0.1872,2,101,2,153215,452395,3974,103982,4.190549853644077,0.18689126257915048
1873,0.1873,6,94,6,153309,452301,3980,103976,4.1896791285338475,0.18691407338430313
1874,0.1874,5,104,5,153413,452197,3985,103971,4.188715773092741,0.18694171545288474
1875,0.1875,3,88,3,153501,452109,3988,103968,4.187900626181037,0.18696691285559375
1876,0.1876,4,91,4,153592,452018,3992,103964,4.187057690170069,0.18699166519779417
1877,0.1877,6,91,6,153683,451927,3998,103958,4.186214754159102,0.18701350099391062
1878,0.1878,3,105,3,153788,451822,4001,103955,4.185242135684908,0.1870444440845879
1879,0.1879,6,91,6,153879,451731,4007,103949,4.184399199673941,0.18706629714943854
1880,0.188,8,99,8,153978,451632,4015,103941,4.183482159398273,0.1870879254391412
1881,0.1881,5,105,5,154083,451527,4020,103936,4.18250954092408,0.18711597352118864
1882,0.1882,0,100,0,154183,451427,4020,103936,4.181583237615325,0.18714966607426134
1883,0.1883,8,96,8,154279,451331,4028,103928,4.18069398643892,0.18717031151228525
1884,0.1884,4,84,4,154363,451247,4032,103924,4.179915891659565,0.1871927748387434
1885,0.1885,5,90,5,154453,451157,4037,103919,4.179082218681685,0.18721580468260202
1886,0.1886,2,95,2,154548,451062,4039,103917,4.178202230538368,0.18724492278086197
1887,0.1887,3,112,3,154660,450950,4042,103914,4.177164770832562,0.18727832405778713
1888,0.1888,4,86,4,154746,450864,4046,103910,4.176368149987032,0.18730149574421295
1889,0.1889,10,95,10,154841,450769,4056,103900,4.175488161843714,0.18731892353818222
1890,0.189,2,109,2,154950,450660,4058,103898,4.174478491237171,0.18735281070690532
1891,0.1891,9,84,9,155034,450576,4067,103889,4.173700396457816,0.18736800339065585
1892,0.1892,7,88,7,155122,450488,4074,103882,4.172885249546112,0.18738748489276116
1893,0.1893,2,85,2,155207,450403,4076,103880,4.172097891733669,0.1874132888795074
1894,0.1894,3,98,3,155305,450305,4079,103877,4.171190114491089,0.18744203167912346
1895,0.1895,4,90,4,155395,450215,4083,103873,4.170356441513209,0.18746661180173546
1896,0.1896,0,85,0,155480,450130,4083,103873,4.169569083700767,0.1874953745737839
1897,0.1897,5,92,5,155572,450038,4088,103868,4.168716884656712,0.18751918195506095
1898,0.1898,3,90,3,155662,449948,4091,103865,4.1678832116788325,0.18754525444509249
1899,0.1899,4,103,4,155765,449845,4095,103861,4.166929119270814,0.18757427226723206
1900,0.19,5,102,5,155867,449743,4100,103856,4.165984289895883,0.18760149494489695
1901,0.1901,0,83,0,155950,449660,4100,103856,4.165215458149617,0.18762962588253998
1902,0.1902,4,114,4,156064,449546,4104,103852,4.164159472377635,0.18766240571884973
1903,0.1903,5,90,5,156154,449456,4109,103847,4.163325799399756,0.18768558999318638
1904,0.1904,4,102,4,156256,449354,4113,103843,4.162380970024825,0.1877143223842501
1905,0.1905,3,115,3,156371,449239,4116,103840,4.161315721219756,0.18774894725708263
1906,0.1906,5,105,5,156476,449134,4121,103835,4.160343102745563,0.18777725333608214
1907,0.1907,4,110,4,156586,449024,4125,103831,4.159324169105932,0.18780873827676334
1908,0.1908,6,103,6,156689,448921,4131,103825,4.158370076697914,0.1878349187511081
1909,0.1909,9,86,9,156775,448835,4140,103816,4.1575734558523845,0.1878509221914011
1910,0.191,3,95,3,156870,448740,4143,103813,4.156693467709067,0.187878809815529
1911,0.1911,5,89,5,156959,448651,4148,103808,4.155869057764274,0.18790172664396815
1912,0.1912,5,93,5,157052,448558,4153,103803,4.155007595687132,0.18792601215509422
1913,0.1913,4,101,4,157153,448457,4157,103799,4.154072029345289,0.18795449936261444
1914,0.1914,3,86,3,157239,448371,4160,103796,4.153275408499759,0.18797936131641332
1915,0.1915,5,93,5,157332,448278,4165,103791,4.152413946422617,0.18800367345386174
1916,0.1916,6,99,6,157431,448179,4171,103785,4.151496906146948,0.18802856708046176
1917,0.1917,7,94,7,157525,448085,4178,103778,4.150626181036719,0.1880502950913542
1918,0.1918,7,96,7,157621,447989,4185,103771,4.149736929860313,0.18807271277366971
1919,0.1919,1,102,1,157723,447887,4186,103770,4.148792100485383,0.18810601515071865
1920,0.192,8,105,8,157828,447782,4194,103762,4.147819482011189,0.18813004946114906
1921,0.1921,6,89,6,157917,447693,4200,103756,4.146995072066398,0.188151578840473
1922,0.1922,6,88,6,158005,447605,4206,103750,4.1461799251546925,0.18817277434683644
1923,0.1923,3,99,3,158104,447506,4209,103747,4.145262884879025,0.18820215037378482
1924,0.1924,7,105,7,158209,447401,4216,103740,4.144290266404831,0.18822769490928817
1925,0.1925,7,87,7,158296,447314,4223,103733,4.143484382526214,0.1882471005195564
1926,0.1926,5,110,5,158406,447204,4228,103728,4.1424654488865835,0.1882773191609854
1927,0.1927,6,100,6,158506,447104,4234,103722,4.141539145577828,0.18830265818970057
1928,0.1928,6,107,6,158613,446997,4240,103716,4.14054800103746,0.18833040077136368
1929,0.1929,5,97,5,158710,446900,4245,103711,4.139649486827967,0.18835620792174512
1930,0.193,5,95,5,158805,446805,4250,103706,4.138769498684649,0.188381340245699
1931,0.1931,5,99,5,158904,446706,4255,103701,4.1378524584089815,0.1884078509175937
1932,0.1932,6,95,6,158999,446611,4261,103695,4.136972470265664,0.18843152718669248
1933,0.1933,6,116,6,159115,446495,4267,103689,4.135897958427507,0.18846240530440725
1934,0.1934,4,114,4,159229,446381,4271,103685,4.1348419726555266,0.18849556235069972
1935,0.1935,2,92,2,159321,446289,4273,103683,4.1339897736114715,0.1885241430472824
1936,0.1936,6,96,6,159417,446193,4279,103677,4.1331005224350665,0.18854820230236238
1937,0.1937,7,100,7,159517,446093,4286,103670,4.132174219126311,0.18857216655176867
1938,0.1938,2,113,2,159630,445980,4288,103668,4.131127496387417,0.18860798183564753
1939,0.1939,7,86,7,159716,445894,4295,103661,4.130330875541888,0.18862716197650828
1940,0.194,4,103,4,159819,445791,4299,103657,4.1293767831338695,0.1886566153666953
1941,0.1941,2,90,2,159909,445701,4301,103655,4.12854311015599,0.18868456884060608
1942,0.1942,6,86,6,159995,445615,4307,103649,4.12774648931046,0.18870524920621048
1943,0.1943,1,109,1,160104,445506,4308,103648,4.126736818703916,0.18874122741526056
1944,0.1944,4,94,4,160198,445412,4312,103644,4.125866093593686,0.18876763025993706
1945,0.1945,8,108,8,160306,445304,4320,103636,4.124865686020231,0.18879294640580027
1946,0.1946,5,97,5,160403,445207,4325,103631,4.123967171810738,0.18881892288799246
1947,0.1947,6,99,6,160502,445108,4331,103625,4.12305013153507,0.18884411908888293
1948,0.1948,5,102,5,160604,445006,4336,103620,4.122105302160139,0.1888718361871293
1949,0.1949,5,79,5,160683,444927,4341,103615,4.1213735225462225,0.18889164366630085
1950,0.195,4,104,4,160787,444823,4345,103611,4.120410167105117,0.18892154753352272
1951,0.1951,6,94,6,160881,444729,4351,103605,4.1195394419948865,0.18894505903336287
1952,0.1952,4,82,4,160963,444647,4355,103601,4.118779873281707,0.18896740161386819
1953,0.1953,1,99,1,161062,444548,4356,103600,4.11786283300604,0.18900005108109488
1954,0.1954,5,95,5,161157,444453,4361,103595,4.116982844862722,0.18902541383236504
1955,0.1955,7,96,7,161253,444357,4368,103588,4.116093593686316,0.18904817089306408
1956,0.1956,8,95,8,161348,444262,4376,103580,4.115213605542999,0.18906911116708833
1957,0.1957,5,116,5,161464,444146,4381,103575,4.114139093704843,0.1891017507088463
1958,0.1958,8,94,8,161558,444052,4389,103567,4.113268368594612,0.18912236427150994
1959,0.1959,6,94,6,161652,443958,4395,103561,4.112397643484383,0.18914594744657262
1960,0.196,8,92,8,161744,443866,4403,103553,4.111545444440328,0.18916588572921292
1961,0.1961,7,88,7,161832,443778,4410,103546,4.110730297528622,0.18918593008894183
1962,0.1962,4,99,4,161931,443679,4414,103542,4.109813257252955,0.1892142297170613
1963,0.1963,5,87,5,162018,443592,4419,103537,4.109007373374338,0.1892369075665885
1964,0.1964,6,75,6,162093,443517,4425,103531,4.108312645892771,0.18925395943317588
1965,0.1965,6,83,6,162176,443434,4431,103525,4.107543814146504,0.18927378468952882
1966,0.1966,6,92,6,162268,443342,4437,103519,4.1066916151024495,0.1892967317106175
1967,0.1967,6,100,6,162368,443242,4443,103513,4.105765311793694,0.18932245704200235
1968,0.1968,7,94,7,162462,443148,4450,103506,4.104894586683463,0.18934463115608777
1969,0.1969,3,107,3,162569,443041,4453,103503,4.103903442143095,0.18937725050499135
1970,0.197,6,88,6,162657,442953,4459,103497,4.103088295231391,0.18939884710403512
1971,0.1971,4,84,4,162741,442869,4463,103493,4.102310200452036,0.1894220315468499
1972,0.1972,6,109,6,162850,442760,4469,103487,4.101300529845493,0.18945092604627578
1973,0.1973,6,98,6,162948,442662,4475,103481,4.100392752602913,0.189476016354691
1974,0.1974,4,106,4,163054,442556,4479,103477,4.099410871095632,0.18950686130691735
1975,0.1975,5,94,5,163148,442462,4484,103472,4.098540145985401,0.1895320679789132
1976,0.1976,10,96,10,163244,442366,4494,103462,4.0976508948089965,0.1895505543870963
1977,0.1977,3,104,3,163348,442262,4497,103459,4.096687539367891,0.1895822224176823
1978,0.1978,6,103,6,163451,442159,4503,103453,4.095733446959873,0.1896090995066091
1979,0.1979,1,77,1,163528,442082,4504,103452,4.095020193412131,0.18963437659247637
1980,0.198,4,85,4,163613,441997,4508,103448,4.094232835599689,0.1896579856814161
1981,0.1981,4,112,4,163725,441885,4512,103444,4.093195375893883,0.1896909938770907
1982,0.1982,8,103,8,163828,441782,4520,103436,4.092241283485865,0.18971493971218853
1983,0.1983,3,97,3,163925,441685,4523,103433,4.0913427692763715,0.18974423886204456
1984,0.1984,2,112,2,164037,441573,4525,103431,4.0903053095705655,0.18978025849351565
1985,0.1985,8,93,8,164130,441480,4533,103423,4.089443847493423,0.18980075352860967
1986,0.1986,2,98,2,164228,441382,4535,103421,4.088536070250843,0.18983192089617715
1987,0.1987,3,85,3,164313,441297,4538,103418,4.087748712438401,0.1898570812259622
1988,0.1988,6,86,6,164399,441211,4544,103412,4.086952091592871,0.18987813588482308
1989,0.1989,4,115,4,164514,441096,4548,103408,4.085886842787803,0.18991228714573263
1990,0.199,3,99,3,164613,440997,4551,103405,4.084969802512134,0.189942358771643
1991,0.1991,8,94,8,164707,440903,4559,103397,4.084099077401905,0.1899632555575969
1992,0.1992,1,97,1,164804,440806,4560,103396,4.0832005631924115,0.18999562662393743
1993,0.1993,7,106,7,164910,440700,4567,103389,4.082218681685131,0.19002222062934557
1994,0.1994,9,117,9,165027,440583,4576,103380,4.081134906813888,0.19004969087971058
1995,0.1995,9,103,9,165130,440480,4585,103371,4.080180814405869,0.19007228082691766
1996,0.1996,4,100,4,165230,440380,4589,103367,4.079254511097114,0.19010127871969867
1997,0.1997,3,93,3,165323,440287,4592,103364,4.078393049019971,0.1901293292939772
1998,0.1998,5,94,5,165417,440193,4597,103359,4.077522323909741,0.19015475980219004
1999,0.1999,8,85,8,165502,440108,4605,103351,4.076734966097299,0.19017257971622514
2000,0.2,5,95,5,165597,440013,4610,103346,4.075854977953981,0.19019837713187782
2001,0.2001,10,98,10,165695,439915,4620,103336,4.074947200711401,0.19021778146749846
2002,0.2002,3,110,3,165805,439805,4623,103333,4.07392826707177,0.1902518328675217
2003,0.2003,9,82,9,165887,439723,4632,103324,4.07316869835859,0.190267140781553
2004,0.2004,4,90,4,165977,439633,4636,103320,4.072335025380711,0.19029271410232562
2005,0.2005,6,100,6,166077,439533,4642,103314,4.071408722071955,0.1903188191147782
2006,0.2006,4,99,4,166176,439434,4646,103310,4.0704916817962875,0.19034756717715903
2007,0.2007,6,108,6,166284,439326,4652,103304,4.069491274222831,0.1903764996406391
2008,0.2008,4,98,4,166382,439228,4656,103300,4.068583496980251,0.19040491919311078
2009,0.2009,5,106,5,166488,439122,4661,103295,4.06760161547297,0.19043466558017172
2010,0.201,7,90,7,166578,439032,4668,103288,4.06676794249509,0.19045581944239565
2011,0.2011,4,78,4,166656,438954,4672,103284,4.066045425914261,0.19047724430969426
2012,0.2012,1,113,1,166769,438841,4673,103283,4.064998703175368,0.19051545402896755
2013,0.2013,7,94,7,166863,438747,4680,103276,4.064127978065137,0.19053803989867588
2014,0.2014,6,96,6,166959,438651,4686,103270,4.063238726888732,0.19056283111376013
2015,0.2015,2,78,2,167037,438573,4688,103268,4.062516210307903,0.19058727560299055
2016,0.2016,9,100,9,167137,438473,4697,103259,4.0615899069991475,0.19060900962099342
2017,0.2017,9,89,9,167226,438384,4706,103250,4.060765497054356,0.19062688088266247
2018,0.2018,5,111,5,167337,438273,4711,103245,4.059737300381637,0.19065848226651746
2019,0.2019,6,116,6,167453,438157,4717,103239,4.05866278854348,0.19069036343083437
2020,0.202,7,89,7,167542,438068,4724,103232,4.057838378598689,0.19071125069277664
2021,0.2021,3,89,3,167631,437979,4727,103229,4.057013968653896,0.19073812656132208
2022,0.2022,2,76,2,167707,437903,4729,103227,4.056309978139242,0.19076192412174522
2023,0.2023,2,97,2,167804,437806,4731,103225,4.055411463929749,0.1907931338500012
2024,0.2024,5,111,5,167915,437695,4736,103220,4.05438326725703,0.19082480611556343
2025,0.2025,1,108,1,168023,437587,4737,103219,4.053382859683575,0.190861417957641
2026,0.2026,5,108,5,168131,437479,4742,103214,4.052382452110119,0.19089205889478872
2027,0.2027,3,99,3,168230,437380,4745,103211,4.051465411834451,0.19092252738206889
2028,0.2028,12,95,12,168325,437285,4757,103199,4.050585423691134,0.19093812212757455
2029,0.2029,8,94,8,168419,437191,4765,103191,4.049714698580903,0.1909593583798128
2030,0.203,2,106,2,168525,437085,4767,103189,4.048732817073622,0.19099382905710807
2031,0.2031,3,98,3,168623,436987,4770,103186,4.047825039831042,0.19102398675979732
2032,0.2032,6,107,6,168730,436880,4776,103180,4.046833895290674,0.1910528459800763
2033,0.2033,4,88,4,168818,436792,4780,103176,4.04601874837897,0.19107798980680338
2034,0.2034,6,99,6,168917,436693,4786,103170,4.045101708103301,0.19110403935813344
2035,0.2035,5,97,5,169014,436596,4791,103165,4.044203193893809,0.19113088941216574
2036,0.2036,6,91,6,169105,436505,4797,103159,4.043360257882841,0.1911541255299594
2037,0.2037,8,92,8,169197,436413,4805,103151,4.042508058838786,0.19117472626046214
2038,0.2038,3,107,3,169304,436306,4808,103148,4.041516914298418,0.1912081474972843
2039,0.2039,5,95,5,169399,436211,4813,103143,4.0406369261551,0.19123432847443422
2040,0.204,8,106,8,169505,436105,4821,103135,4.039655044647819,0.19125992137081818
2041,0.2041,9,85,9,169590,436020,4830,103126,4.038867686835378,0.19127657443438326
2042,0.2042,1,96,1,169686,435924,4831,103125,4.037978435658972,0.1913091388723474
2043,0.2043,5,107,5,169793,435817,4836,103120,4.036987291118604,0.19133961854539586
2044,0.2044,3,88,3,169881,435729,4839,103117,4.036172144206899,0.19136636441580712
2045,0.2045,9,93,9,169974,435636,4848,103108,4.035310682129756,0.1913858901444842
2046,0.2046,3,112,3,170086,435524,4851,103105,4.03427322242395,0.1914211822980196
2047,0.2047,5,91,5,170177,435433,4856,103100,4.033430286412983,0.1914460209495054
2048,0.2048,6,86,6,170263,435347,4862,103094,4.032633665567453,0.19146758883517415
2049,0.2049,5,93,5,170356,435254,4867,103089,4.031772203490311,0.19149315585045223
2050,0.205,4,102,4,170458,435152,4871,103085,4.03082737411538,0.19152343670167601
2051,0.2051,4,86,4,170544,435066,4875,103081,4.030030753269851,0.19154803427316328
2052,0.2052,3,99,3,170643,434967,4878,103078,4.0291137129941825,0.19157877129236403
2053,0.2053,4,98,4,170741,434869,4882,103074,4.028205935751602,0.1916076610347193
2054,0.2054,2,86,2,170827,434783,4884,103072,4.027409314906073,0.1916352920396761
2055,0.2055,7,104,7,170931,434679,4891,103065,4.026445959464967,0.19166183165223602
2056,0.2056,3,96,3,171027,434583,4894,103062,4.025556708288562,0.19169154367658958
2057,0.2057,3,100,3,171127,434483,4897,103059,4.024630404979806,0.1917226932965238
2058,0.2058,5,90,5,171217,434393,4902,103054,4.023796732001927,0.19174727926660676
2059,0.2059,8,108,8,171325,434285,4910,103046,4.022796324428471,0.19177378561817576
2060,0.206,7,87,7,171412,434198,4917,103039,4.021990440549853,0.19179431051844903
2061,0.2061,5,110,5,171522,434088,4922,103034,4.0209715069102225,0.19182606558658927
2062,0.2062,8,93,8,171615,433995,4930,103026,4.02011004483308,0.1918472461970761
2063,0.2063,4,84,4,171699,433911,4934,103022,4.019331950053726,0.1918712390558971
2064,0.2064,6,114,6,171813,433797,4940,103016,4.018275964281744,0.19190295316991204
2065,0.2065,9,85,9,171898,433712,4949,103007,4.0174886064693025,0.1919197941567189
2066,0.2066,3,110,3,172008,433602,4952,103004,4.016469672829671,0.19195461847239875
2067,0.2067,6,85,6,172093,433517,4958,102998,4.015682315017229,0.19197599321547393
2068,0.2068,5,101,5,172194,433416,4963,102993,4.014746748675386,0.19200460842379602
2069,0.2069,7,105,7,172299,433311,4970,102986,4.013774130201193,0.19203165410211134
2070,0.207,7,103,7,172402,433208,4977,102979,4.012820037793175,0.19205799469215032
2071,0.2071,6,76,6,172478,433132,4983,102973,4.0121160472785204,0.19207617910670485
2072,0.2072,2,96,2,172574,433036,4985,102971,4.0112267961021155,0.19210756575940238
2073,0.2073,1,120,1,172694,432916,4986,102970,4.010115232131609,0.19214907648268476
2074,0.2074,9,86,9,172780,432830,4995,102961,4.00931861128608,0.19216634844556926
2075,0.2075,5,105,5,172885,432725,5000,102956,4.008345992811886,0.19219647514098875
2076,0.2076,4,107,4,172992,432618,5004,102952,4.007354848271518,0.19222884030098772
2077,0.2077,2,111,2,173103,432507,5006,102950,4.006326651598799,0.1922656721268001
2078,0.2078,4,99,4,173202,432408,5010,102946,4.005409611323132,0.19229519159285258
2079,0.2079,6,100,6,173302,432308,5016,102940,4.004483308014376,0.19232206379099034
2080,0.208,3,101,3,173403,432207,5019,102937,4.003547741672533,0.19235383373447146
2081,0.2081,5,90,5,173493,432117,5024,102932,4.002714068694654,0.19237864195615728
2082,0.2082,3,93,3,173586,432024,5027,102929,4.00185260661751,0.1924075572994263
2083,0.2083,5,104,5,173690,431920,5032,102924,4.000889251176405,0.19243742100500333
2084,0.2084,4,103,4,173793,431817,5036,102920,3.999935158768387,0.1924684471057735
2085,0.2085,6,97,6,173890,431720,5042,102914,3.9990366445588945,0.19249430451486438
2086,0.2086,1,111,1,174001,431609,5043,102913,3.9980084478861757,0.19253276759422439
2087,0.2087,6,101,6,174102,431508,5049,102907,3.997072881544333,0.1925600890693562
2088,0.2088,4,96,4,174198,431412,5053,102903,3.9961836303679275,0.19258864153168076
2089,0.2089,6,95,6,174293,431317,5059,102897,3.99530364222461,0.19261382142736805
2090,0.209,9,81,9,174374,431236,5068,102888,3.9945533365445183,0.1926294268746583
2091,0.2091,4,103,4,174477,431133,5072,102884,3.9935992441365,0.19266053327890312
2092,0.2092,5,64,5,174541,431069,5077,102879,3.9930064100188964,0.19267606583412616
2093,0.2093,2,123,2,174664,430946,5079,102877,3.9918670569491272,0.1927174363037936
2094,0.2094,6,100,6,174764,430846,5085,102871,3.990940753640372,0.19274446944729134
2095,0.2095,8,110,8,174874,430736,5093,102863,3.989921820000741,0.1927721003974895
2096,0.2096,7,97,7,174971,430639,5100,102856,3.9890233057912483,0.19279655854319158
2097,0.2097,7,95,7,175066,430544,5107,102849,3.9881433176479306,0.1928203032285763
2098,0.2098,12,110,12,175176,430434,5119,102837,3.9871243840082995,0.19284191339862847
2099,0.2099,7,80,7,175256,430354,5126,102830,3.9863833413612952,0.19286025087024367
2100,0.21,9,118,9,175374,430236,5135,102821,3.985290303456964,0.19288931577673682
2101,0.2101,7,94,7,175468,430142,5142,102814,3.984419578346734,0.1929127357605506
2102,0.2102,4,98,4,175566,430044,5146,102810,3.9835118011041537,0.1929421567633911
2103,0.2103,8,106,8,175672,429938,5154,102802,3.982529919596873,0.1929684273754552
2104,0.2104,6,97,6,175769,429841,5160,102796,3.9816314053873803,0.19299447841588174
2105,0.2105,3,100,3,175869,429741,5163,102793,3.9807051020786246,0.1930261729767489
2106,0.2106,4,102,4,175971,429639,5167,102789,3.979760272703694,0.19305708940927224
2107,0.2107,2,97,2,176068,429542,5169,102787,3.9788617584942014,0.19308923616785859
2108,0.2108,10,97,10,176165,429445,5179,102777,3.9779632442847084,0.1931092664339317
2109,0.2109,3,93,3,176258,429352,5182,102774,3.977101782207566,0.19313846720513564
2110,0.211,3,102,3,176360,429250,5185,102771,3.9761569528326355,0.19317094625964012
2111,0.2111,6,103,6,176463,429147,5191,102765,3.9752028604246172,0.19319925100392546
2112,0.2112,7,94,7,176557,429053,5198,102758,3.9743321353143872,0.193222780273443
2113,0.2113,3,110,3,176667,428943,5201,102755,3.9733132016747565,0.19325820296484095
2114,0.2114,3,93,3,176760,428850,5204,102752,3.9724517395976138,0.19328745941512634
2115,0.2115,2,89,2,176849,428761,5206,102750,3.9716273296528217,0.19331678930445464
2116,0.2116,2,102,2,176951,428659,5208,102748,3.970682500277891,0.19335085913433583
2117,0.2117,2,91,2,177042,428568,5210,102746,3.9698395642669237,0.19338093857869357
2118,0.2118,5,99,5,177141,428469,5215,102741,3.968922523991256,0.1934093861184842
2119,0.2119,5,109,5,177250,428360,5220,102736,3.9679128533847123,0.19344148703812494
2120,0.212,6,94,6,177344,428266,5226,102730,3.9670421282744823,0.19346661745097893
2121,0.2121,3,98,3,177442,428168,5229,102727,3.966134351031902,0.1934977726292393
2122,0.2122,4,88,4,177530,428080,5233,102723,3.9653192041201972,0.19352377435696483
2123,0.2123,2,108,2,177638,427972,5235,102721,3.9643187965467415,0.1935601185619558
2124,0.2124,4,100,4,177738,427872,5239,102717,3.963392493237986,0.19359051921543793
2125,0.2125,2,98,2,177836,427774,5241,102715,3.9624847159954055,0.1936232419522365
2126,0.2126,4,85,4,177921,427689,5245,102711,3.9616973581829633,0.19364819004524886
2127,0.2127,3,94,3,178015,427595,5248,102708,3.9608266330727333,0.1936779539244545
2128,0.2128,9,85,9,178100,427510,5257,102699,3.960039275260291,0.1936953163752407
2129,0.2129,2,87,2,178187,427423,5259,102697,3.959233391381674,0.19372406247642043
2130,0.213,5,85,5,178272,427338,5264,102692,3.9584460335692317,0.19374752372507217
2131,0.2131,5,96,5,178368,427242,5269,102687,3.957556782392827,0.1937750151435381
2132,0.2132,5,95,5,178463,427147,5274,102682,3.956676794249509,0.19380215126012354
2133,0.2133,2,88,2,178551,427059,5276,102680,3.9558616473378043,0.193831301829769
2134,0.2134,6,104,6,178655,426955,5282,102674,3.954898291896699,0.19386023046321105
2135,0.2135,6,125,6,178780,426830,5288,102668,3.9537404127607543,0.19389686080022966
2136,0.2136,3,91,3,178871,426739,5291,102665,3.952897476749787,0.19392562202023408
2137,0.2137,4,99,4,178970,426640,5295,102661,3.951980436474119,0.19395580208614757
2138,0.2138,6,95,6,179065,426545,5301,102655,3.9511004483308017,0.19398148148148148
2139,0.2139,8,95,8,179160,426450,5309,102647,3.950220460187484,0.19400412400750713
2140,0.214,6,102,6,179262,426348,5315,102641,3.9492756308125534,0.19403239008750656
2141,0.2141,9,104,9,179366,426244,5324,102632,3.9483122753714475,0.19405682995636028
2142,0.2142,4,107,4,179473,426137,5328,102628,3.9473211308310794,0.1940900021748792
2143,0.2143,3,89,3,179562,426048,5331,102625,3.946496720886287,0.19411810325096987
2144,0.2144,6,87,6,179649,425961,5337,102619,3.9456908370076698,0.1941409058231488
2145,0.2145,5,99,5,179748,425862,5342,102614,3.944773796732002,0.19416965008817808
2146,0.2146,5,117,5,179865,425745,5347,102609,3.9436900218607582,0.19420502163322317
2147,0.2147,4,97,4,179962,425648,5351,102605,3.942791507651265,0.19423458077852848
2148,0.2148,5,101,5,180063,425547,5356,102600,3.9418559413094223,0.19426409692755994
2149,0.2149,6,113,6,180176,425434,5362,102594,3.9408092185705286,0.19429651457877234
2150,0.215,6,90,6,180266,425344,5368,102588,3.939975545592649,0.1943204806679648
2151,0.2151,3,93,3,180359,425251,5371,102585,3.9391140835155065,0.1943501390583439
2152,0.2152,6,100,6,180459,425151,5377,102579,3.938187780206751,0.19437780683303962
2153,0.2153,4,100,4,180559,425051,5381,102575,3.9372614768979957,0.1944085393820623
2154,0.2154,7,111,7,180670,424940,5388,102568,3.936233280225277,0.1944387573269031
2155,0.2155,7,81,7,180751,424859,5395,102561,3.935482974545185,0.19445792726859049
2156,0.2156,4,106,4,180857,424753,5399,102557,3.9345010930379045,0.1944909066772866
2157,0.2157,7,99,7,180956,424654,5406,102550,3.9335840527622365,0.19451673356044338
2158,0.2158,5,95,5,181051,424559,5411,102545,3.932704064618919,0.1945441506799417
2159,0.2159,6,98,6,181149,424461,5417,102539,3.9317962873763386,0.19457115749525616
2160,0.216,4,90,4,181239,424371,5421,102535,3.930962614398459,0.1945982774916209
2161,0.2161,7,87,7,181326,424284,5428,102528,3.9301567305198413,0.19461971253502197
2162,0.2162,3,83,3,181409,424201,5431,102525,3.9293878987735744,0.1946457930688821
2163,0.2163,3,104,3,181513,424097,5434,102522,3.928424543332469,0.19467964505648297
2164,0.2164,5,99,5,181612,423998,5439,102517,3.927507503056801,0.19470860279384253
2165,0.2165,7,99,7,181711,423899,5446,102510,3.926590462781133,0.19473451251783308
2166,0.2166,1,111,1,181822,423788,5447,102509,3.9255622661084146,0.19477405343370757
2167,0.2167,3,102,3,181924,423686,5450,102506,3.924617436733484,0.19480721865782832
2168,0.2168,6,98,6,182022,423588,5456,102500,3.923709659490904,0.1948343242955551
2169,0.2169,5,103,5,182125,423485,5461,102495,3.9227555670828855,0.19486482375755731
2170,0.217,8,98,8,182223,423387,5469,102487,3.9218477898403052,0.19488888973404275
2171,0.2171,7,96,7,182319,423291,5476,102480,3.9209585386639003,0.19491375522803653
2172,0.2172,3,109,3,182428,423182,5479,102477,3.919948868057357,0.1949495775778594
2173,0.2173,7,99,7,182527,423083,5486,102470,3.919031827781689,0.19497557810534807
2174,0.2174,6,98,6,182625,422985,5492,102464,3.9181240505391086,0.1950027500290228
2175,0.2175,8,103,8,182728,422882,5500,102456,3.9171699581310904,0.19502872436412366
2176,0.2176,5,93,5,182821,422789,5505,102451,3.916308496053948,0.19505559363338665
2177,0.2177,7,97,7,182918,422692,5512,102444,3.915409981844455,0.1950808933304896
2178,0.2178,7,86,7,183004,422606,5519,102437,3.9146133609989255,0.19510211544578254
2179,0.2179,3,115,3,183119,422491,5522,102434,3.913548112193857,0.1951402581321141
2180,0.218,6,91,6,183210,422400,5528,102428,3.9127051761828895,0.19516489211703644
2181,0.2181,2,83,2,183293,422317,5530,102426,3.911936344436622,0.19519269432846173
2182,0.2182,10,97,10,183390,422220,5540,102416,3.9110378302271296,0.1952134432253982
2183,0.2183,6,85,6,183475,422135,5546,102410,3.9102504724146874,0.1952358710882765
2184,0.2184,7,86,7,183561,422049,5553,102403,3.909453851569158,0.19525714460045915
2185,0.2185,10,97,10,183658,421952,5563,102393,3.908555337359665,0.19527791816456722
2186,0.2186,4,106,4,183764,421846,5567,102389,3.9075734558523845,0.19531126307858118
2187,0.2187,6,108,6,183872,421738,5573,102383,3.9065730482789283,0.19534229691235422
2188,0.2188,3,82,3,183954,421656,5576,102380,3.905813479565749,0.19536825714263906
2189,0.2189,3,107,3,184061,421549,5579,102377,3.9048223350253806,0.1954035493562068
2190,0.219,9,86,9,184147,421463,5588,102368,3.904025714179851,0.19542180588777677
2191,0.2191,4,89,4,184236,421374,5592,102364,3.9032013042350586,0.19544886947290438
2192,0.2192,12,100,12,184336,421274,5604,102352,3.9022750009263034,0.19546775752158985
2193,0.2193,2,106,2,184442,421168,5606,102350,3.9012931194190226,0.19550426155356646
2194,0.2194,3,97,3,184539,421071,5609,102347,3.90039460520953,0.1955358814561211
2195,0.2195,4,87,4,184626,420984,5613,102343,3.8995887213309124,0.19556223928824618
2196,0.2196,6,96,6,184722,420888,5619,102337,3.8986994701545075,0.19558889579052988
2197,0.2197,5,96,5,184818,420792,5624,102332,3.897810218978102,0.19561710034332205
2198,0.2198,4,106,4,184924,420686,5628,102328,3.8968283374708212,0.19565059443915458
2199,0.2199,6,96,6,185020,420590,5634,102322,3.8959390862944163,0.19567728413193808
2200,0.22,7,91,7,185111,420499,5641,102315,3.895096150283449,0.19570057420038484
2201,0.2201,6,97,6,185208,420402,5647,102309,3.894197636073956,0.19572765830449332
2202,0.2202,7,97,7,185305,420305,5654,102302,3.8932991218644633,0.1957532141743222
2203,0.2203,4,106,4,185411,420199,5658,102298,3.8923172403571824,0.19578677006757933
2204,0.2204,6,103,6,185514,420096,5664,102292,3.8913631479491646,0.19581613666470132
2205,0.2205,6,90,6,185604,420006,5670,102286,3.8905294749712844,0.19584064086756067
2206,0.2206,5,88,5,185692,419918,5675,102281,3.8897143280595796,0.1958659438260127
2207,0.2207,9,99,9,185791,419819,5684,102272,3.888797287783912,0.19588922237694195
2208,0.2208,6,95,6,185886,419724,5690,102266,3.8879172996405944,0.1959156305676354
2209,0.2209,3,105,3,185991,419619,5693,102263,3.8869446811664012,0.19595042557513
2210,0.221,3,82,3,186073,419537,5696,102260,3.8861851124532216,0.19597659626253122
2211,0.2211,6,93,6,186166,419444,5702,102254,3.8853236503760793,0.19600228484678875
2212,0.2212,6,103,6,186269,419341,5708,102248,3.884369557968061,0.19603174146694044
2213,0.2213,7,109,7,186378,419232,5715,102241,3.8833598873615176,0.1960619245866996
2214,0.2214,6,86,6,186464,419146,5721,102235,3.882563266515988,0.19608501268745887
2215,0.2215,7,85,7,186549,419061,5728,102228,3.881775908703546,0.1961061906159539
2216,0.2216,4,107,4,186656,418954,5732,102224,3.8807847641631774,0.1961402822068468
2217,0.2217,7,97,7,186753,418857,5739,102217,3.879886249953685,0.19616599561674541
2218,0.2218,8,102,8,186855,418755,5747,102209,3.8789414205787542,0.19619205933615375
2219,0.2219,4,91,4,186946,418664,5751,102205,3.878098484567787,0.1962201628432485
2220,0.222,8,86,8,187032,418578,5759,102197,3.8773018637222574,0.19624021890451732
2221,0.2221,5,107,5,187139,418471,5764,102192,3.876310719181889,0.19627282906601776
2222,0.2222,3,91,3,187230,418380,5767,102189,3.8754677831709214,0.1963025074485803
2223,0.2223,5,87,5,187317,418293,5772,102184,3.8746618992923043,0.1963275994904674
2224,0.2224,9,96,9,187413,418197,5781,102175,3.873772648115899,0.19634991890416856
2225,0.2225,5,123,5,187536,418074,5786,102170,3.8726332950461297,0.1963886176486418
2226,0.2226,4,92,4,187628,417982,5790,102166,3.871781096002075,0.1964171735736752
2227,0.2227,6,88,6,187716,417894,5796,102160,3.8709659490903703,0.19644113880481642
2228,0.2228,5,97,5,187813,417797,5801,102155,3.8700674348808772,0.19647005877465612
2229,0.2229,4,99,4,187912,417698,5805,102151,3.8691503946052097,0.19650129172124983
2230,0.223,6,87,6,187999,417611,5811,102145,3.868344510726592,0.19652490784137172
2231,0.2231,9,86,9,188085,417525,5820,102136,3.8675478898810627,0.1965435158689992
2232,0.2232,5,97,5,188182,417428,5825,102131,3.86664937567157,0.19657247781291443
2233,0.2233,7,105,7,188287,417323,5832,102124,3.865676757197377,0.19660138570441257
2234,0.2234,6,90,6,188377,417233,5838,102118,3.8648430842194967,0.19662617382078787
2235,0.2235,7,89,7,188466,417144,5845,102111,3.8640186742747047,0.19664904526677643
2236,0.2236,1,87,1,188553,417057,5846,102110,3.863212790396087,0.1966804515695335
2237,0.2237,1,88,1,188641,416969,5847,102109,3.8623976434843827,0.19671224748496371
2238,0.2238,3,111,3,188752,416858,5850,102106,3.861369446811664,0.19674967820503927
2239,0.2239,11,96,11,188848,416762,5861,102095,3.860480195635259,0.1967690519738579
2240,0.224,5,109,5,188957,416653,5866,102090,3.8594705250287156,0.19680265565029312
2241,0.2241,3,102,3,189059,416551,5869,102087,3.858525695653785,0.19683671462561556
2242,0.2242,3,82,3,189141,416469,5872,102084,3.8577661269406054,0.19686319431186397
2243,0.2243,4,86,4,189227,416383,5876,102080,3.856969506095076,0.19688965268495534
2244,0.2244,5,85,5,189312,416298,5881,102075,3.8561821482826337,0.19691419113264
2245,0.2245,3,111,3,189423,416187,5884,102072,3.8551539516099154,0.19695171719159726
2246,0.2246,4,104,4,189527,416083,5888,102068,3.8541905961688094,0.19698504875991749
2247,0.2247,9,107,9,189634,415976,5897,102059,3.8531994516284414,0.19701178491800747
2248,0.2248,8,82,8,189716,415894,5905,102051,3.8524398829152617,0.1970305727442103
2249,0.2249,5,94,5,189810,415800,5910,102046,3.8515691578050317,0.1970585849847252
2250,0.225,5,92,5,189902,415708,5915,102041,3.8507169587609766,0.19708584661679696
2251,0.2251,7,81,7,189983,415627,5922,102034,3.8499666530808847,0.19710582794531556
2252,0.2252,5,109,5,190092,415518,5927,102029,3.8489569824743413,0.19713958345812072
2253,0.2253,3,107,3,190199,415411,5930,102026,3.847965837933973,0.19717569481888617
2254,0.2254,5,101,5,190300,415310,5935,102021,3.8470302715921303,0.19720643069910754
2255,0.2255,4,90,4,190390,415220,5939,102017,3.84619659861425,0.19723453658574308
2256,0.2256,1,93,1,190483,415127,5940,102016,3.845335136537108,0.1972684537932448
2257,0.2257,5,88,5,190571,415039,5945,102011,3.844519989625403,0.19729426554491827
2258,0.2258,1,86,1,190657,414953,5946,102010,3.843723368779873,0.19732553393569752
2259,0.2259,5,96,5,190753,414857,5951,102005,3.842834117603468,0.19735441955492955
2260,0.226,6,93,6,190846,414764,5957,101999,3.8419726555263254,0.19738061742036483
2261,0.2261,8,100,8,190946,414664,5965,101991,3.84104635221757,0.19740639304758495
2262,0.2262,11,111,11,191057,414553,5976,101980,3.840018155544852,0.19743172265857167
2263,0.2263,5,97,5,191154,414456,5981,101975,3.8391196413353588,0.1974610354529453
2264,0.2264,6,97,6,191251,414359,5987,101969,3.838221127125866,0.1974888055654545
2265,0.2265,5,103,5,191354,414256,5992,101964,3.837267034717848,0.1975204370229747
2266,0.2266,2,107,2,191461,414149,5994,101962,3.83627589017748,0.1975582771923094
2267,0.2267,8,79,8,191540,414070,6002,101954,3.835544110563563,0.19757608173263258
2268,0.2268,3,95,3,191635,413975,6005,101951,3.834664122420245,0.1976077964669352
2269,0.2269,8,97,8,191732,413878,6013,101943,3.8337656082107525,0.1976325120536
2270,0.227,7,90,7,191822,413788,6020,101936,3.832931935232873,0.1976561106328191
2271,0.2271,3,100,3,191922,413688,6023,101933,3.832005631924117,0.1976897760176564
2272,0.2272,6,111,6,192033,413577,6029,101927,3.8309774352513988,0.1977230050591266
2273,0.2273,5,98,5,192131,413479,6034,101922,3.8300696580088185,0.19775281770892955
2274,0.2274,4,85,4,192216,413394,6038,101918,3.8292823001963763,0.1977792094886205
2275,0.2275,6,84,6,192300,413310,6044,101912,3.8285042054170217,0.1978021124874326
2276,0.2276,5,94,5,192394,413216,6049,101907,3.8276334803067917,0.19783042108389648
2277,0.2277,8,108,8,192502,413108,6057,101899,3.826633072733336,0.19785944657062915
2278,0.2278,4,101,4,192603,413007,6061,101895,3.8256975063914926,0.19789202605544357
2279,0.2279,5,102,5,192705,412905,6066,101890,3.8247526770165625,0.1979234452549073
2280,0.228,6,113,6,192818,412792,6072,101884,3.823705954277669,0.19795754999261672
2281,0.2281,3,99,3,192917,412693,6075,101881,3.822788914002001,0.19799095951214013
2282,0.2282,3,102,3,193019,412591,6078,101878,3.8218440846270703,0.1980255370100045
2283,0.2283,8,98,8,193117,412493,6086,101870,3.82093630738449,0.19805079292250805
2284,0.2284,2,92,2,193209,412401,6088,101868,3.820084108340435,0.1980831043675586
2285,0.2285,6,90,6,193299,412311,6094,101862,3.819250435362555,0.19810841876177862
2286,0.2286,5,97,5,193396,412214,6099,101857,3.8183519211530625,0.19813800039294183
2287,0.2287,5,100,5,193496,412114,6104,101852,3.817425617844307,0.1981687504620928
2288,0.2288,7,76,7,193572,412038,6111,101845,3.816721627329653,0.19818713598231505
2289,0.2289,7,123,7,193695,411915,6118,101838,3.8155822742598837,0.19822366000782476
2290,0.229,9,92,9,193787,411823,6127,101829,3.8147300752158286,0.1982451153699392
2291,0.2291,1,88,1,193875,411735,6128,101828,3.813914928304124,0.19827752388704015
2292,0.2292,4,91,4,193966,411644,6132,101824,3.8130719922931564,0.1983064183162339
2293,0.2293,6,108,6,194074,411536,6138,101818,3.8120715847197006,0.19833876817946292
2294,0.2294,7,98,7,194172,411438,6145,101811,3.8111638074771204,0.19836570553474045
2295,0.2295,10,82,10,194254,411356,6155,101801,3.8104042387639407,0.19838178179387594
2296,0.2296,4,100,4,194354,411256,6159,101797,3.8094779354551855,0.19841419892291828
2297,0.2297,5,85,5,194439,411171,6164,101792,3.8086905776427433,0.1984392636505947
2298,0.2298,9,111,9,194550,411060,6173,101783,3.807662380970025,0.19846814717174652
2299,0.2299,10,92,10,194642,410968,6183,101773,3.80681018192597,0.19848812558387177
2300,0.23,11,99,11,194741,410869,6194,101762,3.805893141650302,0.1985092590966992
2301,0.2301,7,96,7,194837,410773,6201,101755,3.805003890473897,0.19853549464614617
2302,0.2302,9,102,9,194939,410671,6210,101746,3.8040590610989664,0.19856093767380864
2303,0.2303,3,90,3,195029,410581,6213,101743,3.8032253881210862,0.1985911259281236
2304,0.2304,6,85,6,195114,410496,6219,101737,3.8024380303086445,0.19861469292294717
2305,0.2305,8,83,8,195197,410413,6227,101729,3.801669198562377,0.1986343631258518
2306,0.2306,2,82,2,195279,410331,6229,101727,3.800909629849198,0.19866304207726468
2307,0.2307,6,102,6,195381,410229,6235,101721,3.7999648004742674,0.19869323176091416
2308,0.2308,8,92,8,195473,410137,6243,101713,3.7991126014302123,0.198716420826414
2309,0.2309,4,109,4,195582,410028,6247,101709,3.798102930823669,0.19875248418621283
2310,0.231,4,98,4,195680,409930,6251,101705,3.7971951535810886,0.1987842895814399
2311,0.2311,6,79,6,195759,409851,6257,101699,3.7964633739671716,0.19880559085133417
2312,0.2312,2,109,2,195868,409742,6259,101697,3.7954537033606286,0.1988448280244565
2313,0.2313,6,83,6,195951,409659,6265,101691,3.7946848716143613,0.19886770313875038
2314,0.2314,13,111,13,196062,409548,6278,101678,3.793656674941643,0.1988905102635625
2315,0.2315,5,88,5,196150,409460,6283,101673,3.792841528029938,0.19891691594946911
2316,0.2316,9,89,9,196239,409371,6292,101664,3.7920171180851456,0.19893745046816755
2317,0.2317,3,88,3,196327,409283,6295,101661,3.791201971173441,0.19896701008329679
2318,0.2318,4,91,4,196418,409192,6299,101657,3.7903590351624734,0.1989961808675362
2319,0.2319,5,101,5,196519,409091,6304,101652,3.7894234688206305,0.1990276910305183
2320,0.232,6,101,6,196620,408990,6310,101646,3.7884879024787876,0.1990576457594059
2321,0.2321,7,100,7,196720,408890,6317,101639,3.7875615991700324,0.19908565429192074
2322,0.2322,8,83,8,196803,408807,6325,101631,3.786792767423765,0.19910547412222443
2323,0.2323,6,98,6,196901,408709,6331,101625,3.785884990181185,0.19913429244377212
2324,0.2324,4,101,4,197002,408608,6335,101621,3.784949423839342,0.19916743266258877
2325,0.2325,12,97,12,197099,408511,6347,101609,3.7840509096298494,0.1991864659295852
2326,0.2326,8,110,8,197209,408401,6355,101601,3.7830319759902182,0.19921686581621248
2327,0.2327,10,113,10,197322,408288,6365,101591,3.7819852532513245,0.19924531114244753
2328,0.2328,2,75,2,197397,408213,6367,101589,3.781290525769758,0.19927148186943167
2329,0.2329,5,105,5,197502,408108,6372,101584,3.780317907295565,0.1993046781193348
2330,0.233,6,97,6,197599,408011,6378,101578,3.779419393086072,0.19933318811826786
2331,0.2331,2,92,2,197691,407919,6380,101576,3.778567194042017,0.19936603892089225
2332,0.2332,6,95,6,197786,407824,6386,101570,3.7776872058986997,0.19939378948318984
2333,0.2333,6,86,6,197872,407738,6392,101564,3.7768905850531698,0.19941802702522277
2334,0.2334,7,105,7,197977,407633,6399,101557,3.7759179665789766,0.19944814312928377
2335,0.2335,5,100,5,198077,407533,6404,101552,3.7749916632702214,0.19947945824371174
2336,0.2336,5,63,5,198140,407470,6409,101547,3.7744080921857055,0.1994962840140899
2337,0.2337,5,93,5,198233,407377,6414,101542,3.7735466301085627,0.19952487527484727
2338,0.2338,5,90,5,198323,407287,6419,101537,3.772712957130683,0.19955230099209156
2339,0.2339,6,94,6,198417,407193,6425,101531,3.771842232020453,0.1995797328217265
2340,0.234,7,101,7,198518,407092,6432,101524,3.7709066656786097,0.19960834893121726
2341,0.2341,5,92,5,198610,407000,6437,101519,3.770054466634555,0.19963659174976747
2342,0.2342,3,119,3,198729,406881,6440,101516,3.768952165697136,0.19967859763137863
2343,0.2343,8,101,8,198830,406780,6448,101508,3.7680165993552928,0.1997056786703601
2344,0.2344,5,99,5,198929,406681,6453,101503,3.7670995590796252,0.19973670953827746
2345,0.2345,2,109,2,199038,406572,6455,101501,3.766089888473082,0.19977641008280306
2346,0.2346,3,93,3,199131,406479,6458,101498,3.765228426395939,0.19980825903535002
2347,0.2347,5,97,5,199228,406382,6463,101493,3.7643299121864464,0.19983854294856018
2348,0.2348,7,91,7,199319,406291,6470,101486,3.763486976175479,0.19986332583003957
2349,0.2349,4,91,4,199410,406200,6474,101482,3.7626440401645116,0.19989284630930385
2350,0.235,2,96,2,199506,406104,6476,101480,3.7617547889881062,0.19992749968478124
2351,0.2351,3,107,3,199613,405997,6479,101477,3.760763644447738,0.1999649243113933
2352,0.2352,3,115,3,199728,405882,6482,101474,3.759698395642669,0.2000055188073069
2353,0.2353,10,88,10,199816,405794,6492,101464,3.7588832487309647,0.20002444515414247
2354,0.2354,5,96,5,199912,405698,6497,101459,3.7579939975545593,0.20005442101755472
2355,0.2355,6,85,6,199997,405613,6503,101453,3.757206639742117,0.20007849076846013
2356,0.2356,5,97,5,200094,405516,6508,101448,3.7563081255326245,0.20010888347101569
2357,0.2357,5,115,5,200209,405401,6513,101443,3.755242876727556,0.20014639612977564
2358,0.2358,7,98,7,200307,405303,6520,101436,3.7543350994849756,0.20017405409885564
2359,0.2359,7,102,7,200409,405201,6527,101429,3.753390270110045,0.20020330418648719
2360,0.236,5,82,5,200491,405119,6532,101424,3.7526307013968654,0.20022781876365875
2361,0.2361,6,103,6,200594,405016,6538,101418,3.751676608988847,0.20025906633440882
2362,0.2362,6,77,6,200671,404939,6544,101412,3.7509633554411055,0.20028004289514587
2363,0.2363,7,88,7,200759,404851,6551,101405,3.7501482085294007,0.20030379886855662
2364,0.2364,9,82,9,200841,404769,6560,101396,3.7493886398162215,0.20032202937777208
2365,0.2365,8,105,8,200946,404664,6568,101388,3.7484160213420283,0.20035095207607123
2366,0.2366,10,89,10,201035,404575,6578,101378,3.747591611397236,0.20037039013505206
2367,0.2367,5,102,5,201137,404473,6583,101373,3.7466467820223053,0.20040288941693718
2368,0.2368,8,88,8,201225,404385,6591,101365,3.7458316351106005,0.20042511122095896
2369,0.2369,6,90,6,201315,404295,6597,101359,3.7449979621327207,0.2004512967365036
2370,0.237,4,92,4,201407,404203,6601,101355,3.7441457630886656,0.20048144822156905
2371,0.2371,4,95,4,201502,404108,6605,101351,3.743265774945348,0.2005128012361042
2372,0.2372,5,106,5,201608,404002,6610,101346,3.7422838934380676,0.20054694982467527
2373,0.2373,4,94,4,201702,403908,6614,101342,3.741413168327837,0.2005779317169718
2374,0.2374,10,98,10,201800,403810,6624,101332,3.740505391085257,0.20060101911937633
2375,0.2375,7,108,7,201908,403702,6631,101325,3.739504983511801,0.20063283745225502
2376,0.2376,4,92,4,202000,403610,6635,101321,3.738652784467746,0.2006630608934686
2377,0.2377,8,99,8,202099,403511,6643,101313,3.7377357441920784,0.20068974533698875
2378,0.2378,5,92,5,202191,403419,6648,101308,3.7368835451480233,0.20071840816916867
2379,0.2379,5,93,5,202284,403326,6653,101303,3.7360220830708806,0.20074747983171795
2380,0.238,6,91,6,202375,403235,6659,101297,3.735179147059913,0.20077418280703702
2381,0.2381,5,89,5,202464,403146,6664,101292,3.734354737115121,0.20080168425059175
2382,0.2382,3,104,3,202568,403042,6667,101289,3.733391381674015,0.2008383383135282
2383,0.2383,10,100,10,202668,402942,6677,101279,3.73246507836526,0.20086232029209414
2384,0.2384,3,101,3,202769,402841,6680,101276,3.731529512023417,0.20089780745342847
2385,0.2385,1,86,1,202855,402755,6681,101275,3.730732891177887,0.20093050016864075
2386,0.2386,5,92,5,202947,402663,6686,101270,3.729880692133832,0.20095925450407098
2387,0.2387,5,94,5,203041,402569,6691,101265,3.729009967023602,0.2009888177455273
2388,0.2388,8,90,8,203131,402479,6699,101257,3.7281762940457224,0.20101203805167786
2389,0.2389,9,106,9,203237,402373,6708,101248,3.7271944125384415,0.20104006782878395
2390,0.239,5,110,5,203347,402263,6713,101243,3.726175478898811,0.20107605470441267
2391,0.2391,9,98,9,203445,402165,6722,101234,3.72526770165623,0.20110091597321408
2392,0.2392,4,97,4,203542,402068,6726,101230,3.7243691874467375,0.20113332459099778
2393,0.2393,5,107,5,203649,401961,6731,101225,3.7233780429063694,0.20116815650673905
2394,0.2394,7,97,7,203746,401864,6738,101218,3.7224795286968764,0.2011958289105951
2395,0.2395,6,90,6,203836,401774,6744,101212,3.7216458557189966,0.20122230042188052
2396,0.2396,5,103,5,203939,401671,6749,101207,3.7206917633109784,0.20125557292225948
2397,0.2397,8,98,8,204037,401573,6757,101199,3.719783986068398,0.20128209208150016
2398,0.2398,4,92,4,204129,401481,6761,101195,3.7189317870243435,0.2013125750980751
2399,0.2399,11,84,11,204213,401397,6772,101184,3.7181536922449885,0.20132874103875792
2400,0.24,5,106,5,204319,401291,6777,101179,3.717171810737708,0.20136326546858518
2401,0.2401,7,90,7,204409,401201,6784,101172,3.716338137759828,0.20138821154799322
2402,0.2402,6,95,6,204504,401106,6790,101166,3.71545814961651,0.2014167622324159
2403,0.2403,7,91,7,204595,401015,6797,101159,3.714615213605543,0.20144212962041044
2404,0.2404,8,90,8,204685,400925,6805,101151,3.713781540627663,0.2014655151809686
2405,0.2405,9,103,9,204788,400822,6814,101142,3.712827448219645,0.20149253731343283
2406,0.2406,6,99,6,204887,400723,6820,101136,3.7119104079439773,0.20152273845841162
2407,0.2407,7,94,7,204981,400629,6827,101129,3.7110396828337473,0.20154935247669195
2408,0.2408,9,101,9,205082,400528,6836,101120,3.710104116491904,0.20157560679998723
2409,0.2409,7,90,7,205172,400438,6843,101113,3.7092704435140242,0.201600634830755
2410,0.241,6,100,6,205272,400338,6849,101107,3.708344140205269,0.20163128558466034
2411,0.2411,6,106,6,205378,400232,6855,101101,3.707362258697988,0.20166436280875186
2412,0.2412,2,95,2,205473,400137,6857,101099,3.7064822705546705,0.20169939908546075
2413,0.2413,3,101,3,205574,400036,6860,101096,3.7055467042128276,0.2017352713456734
2414,0.2414,6,97,6,205671,399939,6866,101090,3.7046481900033346,0.20176476810723531
2415,0.2415,6,89,6,205760,399850,6872,101084,3.7038237800585425,0.2017910543105479
2416,0.2416,6,122,6,205882,399728,6878,101078,3.7026936900218606,0.20183064899382197
2417,0.2417,8,89,8,205971,399639,6886,101070,3.7018692800770685,0.20185377135222254
2418,0.2418,8,107,8,206078,399532,6894,101062,3.7008781355367,0.2018841616160002
2419,0.2419,11,86,11,206164,399446,6905,101051,3.7000815146911705,0.20190131009776283
2420,0.242,4,98,4,206262,399348,6909,101047,3.6991737374485902,0.20193447176730384
2421,0.2421,6,99,6,206361,399249,6915,101041,3.6982566971729223,0.20196486038097902
2422,0.2422,5,101,5,206462,399148,6920,101036,3.6973211308310794,0.20199766485933177
2423,0.2423,7,98,7,206560,399050,6927,101029,3.696413353588499,0.20202607987937907
2424,0.2424,4,94,4,206654,398956,6931,101025,3.695542628478269,0.20205767819177128
2425,0.2425,4,95,4,206749,398861,6935,101021,3.6946626403349514,0.20208969316758754
2426,0.2426,5,100,5,206849,398761,6940,101016,3.6937363370261957,0.2021221464773289
2427,0.2427,1,101,1,206950,398660,6941,101015,3.692800770684353,0.20216140491319357
2428,0.2428,7,107,7,207057,398553,6948,101008,3.691809626143985,0.20219352591575404
2429,0.2429,8,104,8,207161,398449,6956,101000,3.690846270702879,0.20222284958023742
2430,0.243,8,98,8,207259,398351,6964,100992,3.6899384934602986,0.20224975617962002
2431,0.2431,3,96,3,207355,398255,6967,100989,3.6890492422838936,0.20228385318601727
2432,0.2432,5,98,5,207453,398157,6972,100984,3.6881414650413133,0.20231557816328452
2433,0.2433,5,82,5,207535,398075,6977,100979,3.6873818963281337,0.20234082884818075
2434,0.2434,11,111,11,207646,397964,6988,100968,3.6863536996554154,0.2023682586003704
2435,0.2435,5,77,5,207723,397887,6993,100963,3.6856404461076737,0.20239150045103738
2436,0.2436,7,94,7,207817,397793,7000,100956,3.6847697209974433,0.2024184509643127
2437,0.2437,1,103,1,207920,397690,7001,100955,3.6838156285894255,0.20245866297666676
2438,0.2438,7,119,7,208039,397571,7008,100948,3.6827133276520065,0.20249579253749606
2439,0.2439,4,105,4,208144,397466,7012,100944,3.6817407091778134,0.2025320519251219
2440,0.244,6,87,6,208231,397379,7018,100938,3.680934825299196,0.20255780958707006
2441,0.2441,5,85,5,208316,397294,7023,100933,3.680147467486754,0.20258436415529468
2442,0.2442,6,102,6,208418,397192,7029,100927,3.6792026381118235,0.20261624230354594
2443,0.2443,3,95,3,208513,397097,7032,100924,3.6783226499685058,0.20265008905246967
2444,0.2444,5,98,5,208611,396999,7037,100919,3.6774148727259255,0.20268196771355926
2445,0.2445,7,93,7,208704,396906,7044,100912,3.6765534106487827,0.20270862041951074
2446,0.2446,6,86,6,208790,396820,7050,100906,3.6757567898032533,0.20273403438839843
2447,0.2447,4,95,4,208885,396725,7054,100902,3.6748768016599356,0.20276632899742175
2448,0.2448,8,74,8,208959,396651,7062,100894,3.6741913372114565,0.20278366780894191
2449,0.2449,11,85,11,209044,396566,7073,100883,3.6734039793990143,0.20280068911586915
2450,0.245,9,89,9,209133,396477,7082,100874,3.6725795694542223,0.20282255389051193
2451,0.2451,2,85,2,209218,396392,7084,100872,3.67179221164178,0.20285401718202
2452,0.2452,10,90,10,209308,396302,7094,100862,3.6709585386639003,0.20287470532862395
2453,0.2453,7,72,7,209380,396230,7101,100855,3.670291600281596,0.20289286540531298
2454,0.2454,5,109,5,209489,396121,7106,100850,3.6692819296750527,0.20292934597793433
2455,0.2455,8,72,8,209561,396049,7114,100842,3.668614991292749,0.20294591771636034
2456,0.2456,8,108,8,209669,395941,7122,100834,3.667614583719293,0.2029772029590861
2457,0.2457,6,92,6,209761,395849,7128,100828,3.666762384675238,0.2030051723756083
2458,0.2458,5,98,5,209859,395751,7133,100823,3.665854607432658,0.20303721096956345
2459,0.2459,7,79,7,209938,395672,7140,100816,3.665122827818741,0.20305828136833115
2460,0.246,10,123,10,210061,395549,7150,100806,3.6639834747489717,0.20309254465050217
2461,0.2461,8,90,8,210151,395459,7158,100798,3.663149801771092,0.20311653034617144
2462,0.2462,5,91,5,210242,395368,7163,100793,3.6623068657601245,0.20314575309224223
2463,0.2463,5,98,5,210340,395270,7168,100788,3.6613990885175443,0.20317785420253276
2464,0.2464,4,84,4,210424,395186,7172,100784,3.6606209937381897,0.20320583906284653
2465,0.2465,2,98,2,210522,395088,7174,100782,3.6597132164956094,0.20324278540746565
2466,0.2466,3,89,3,210611,394999,7177,100779,3.658888806550817,0.20327444945116566
2467,0.2467,12,94,12,210705,394905,7189,100767,3.658018081440587,0.20329371035684887
2468,0.2468,13,112,13,210817,394793,7202,100754,3.656980621734781,0.20331875684849268
2469,0.2469,4,105,4,210922,394688,7206,100750,3.6560080032605877,0.2033554148046779
2470,0.247,5,81,5,211003,394607,7211,100745,3.655257697580496,0.20338062630210435
2471,0.2471,5,88,5,211091,394519,7216,100740,3.654442550668791,0.2034087214972368
2472,0.2472,1,91,1,211182,394428,7217,100739,3.6535996146578236,0.20344449448367924
2473,0.2473,3,79,3,211261,394349,7220,100736,3.652867835043907,0.20347213104820383
2474,0.2474,7,89,7,211350,394260,7227,100729,3.6520434250991145,0.20349745145851725
2475,0.2475,5,71,5,211421,394189,7232,100724,3.651385749749898,0.2035185982182727
2476,0.2476,2,123,2,211544,394066,7234,100722,3.650246396680129,0.20356597168888493
2477,0.2477,6,85,6,211629,393981,7240,100716,3.6494590388676866,0.20359128921339728
2478,0.2478,3,106,3,211735,393875,7243,100713,3.6484771573604062,0.20363009211707522
2479,0.2479,5,109,5,211844,393766,7248,100708,3.647467486753863,0.20366692687583168
2480,0.248,9,91,9,211935,393675,7257,100699,3.6466245507428954,0.20368991896823052
2481,0.2481,7,109,7,212044,393566,7264,100692,3.645614880136352,0.203723561378875
2482,0.2482,4,92,4,212136,393474,7268,100688,3.644762681092297,0.2037550438924887
2483,0.2483,8,77,8,212213,393397,7276,100680,3.644049427544555,0.20377390568676543
2484,0.2484,7,93,7,212306,393304,7283,100673,3.643187965467413,0.20380098668561492
2485,0.2485,4,88,4,212394,393216,7287,100669,3.642372818555708,0.20383085131154013
2486,0.2486,8,111,8,212505,393105,7295,100661,3.6413446218829892,0.2038637735283515
2487,0.2487,6,86,6,212591,393019,7301,100655,3.64054800103746,0.2038896113629642
2488,0.2488,6,97,6,212688,392922,7307,100649,3.6396494868279667,0.20392000340376562
2489,0.2489,4,100,4,212788,392822,7311,100645,3.6387231835192115,0.20395487438876359
2490,0.249,5,86,5,212874,392736,7316,100640,3.637926562673682,0.20398235828252692
2491,0.2491,10,88,10,212962,392648,7326,100630,3.6371114157619773,0.20400261110367784
2492,0.2492,5,102,5,213064,392546,7331,100625,3.6361665863870467,0.2040367337089975
2493,0.2493,1,105,1,213169,392441,7332,100624,3.6351939679128535,0.20407856976260735
2494,0.2494,6,99,6,213268,392342,7338,100618,3.6342769276371856,0.20410986692632263
2495,0.2495,8,87,8,213355,392255,7346,100610,3.6334710437585684,0.20413297759021232
2496,0.2496,7,87,7,213442,392168,7353,100603,3.6326651598799513,0.20415771220303142
2497,0.2497,6,95,6,213537,392073,7359,100597,3.6317851717366336,0.2041873870948099
2498,0.2498,6,88,6,213625,391985,7365,100591,3.630970024824929,0.2042141720262457
2499,0.2499,3,119,3,213744,391866,7368,100588,3.62986772388751,0.20425867187595187
2500,0.25,11,95,11,213839,391771,7379,100577,3.628987735744192,0.20428030579996262
2501,0.2501,6,88,6,213927,391683,7385,100571,3.6281725888324874,0.20430712599592893
2502,0.2502,6,88,6,214015,391595,7391,100565,3.6273574419207826,0.20433395643693109
2503,0.2503,6,102,6,214117,391493,7397,100559,3.626412612545852,0.20436661165893036
2504,0.2504,8,102,8,214219,391391,7405,100551,3.6254677831709214,0.20439604668843075
2505,0.2505,2,88,2,214307,391303,7407,100549,3.6246526362592166,0.2044293811959695
2506,0.2506,7,94,7,214401,391209,7414,100542,3.6237819111489866,0.20445713379332223
2507,0.2507,6,90,6,214491,391119,7420,100536,3.622948238171107,0.20448485218293316
2508,0.2508,12,85,12,214576,391034,7432,100524,3.6221608803586647,0.20450079136134494
2509,0.2509,8,101,8,214677,390933,7440,100516,3.621225314016822,0.20452986983389934
2510,0.251,9,88,9,214765,390845,7449,100507,3.620410167105117,0.2045519301844706
2511,0.2511,8,126,8,214891,390719,7457,100499,3.619243024936085,0.20459144412460456
2512,0.2512,1,110,1,215001,390609,7458,100498,3.618224091296454,0.20463564966494063
2513,0.2513,8,99,8,215100,390510,7466,100490,3.617307051020786,0.20466395112016295
2514,0.2514,4,95,4,215195,390415,7470,100486,3.6164270628774684,0.20469707741479443
2515,0.2515,9,94,9,215289,390321,7479,100477,3.6155563377672384,0.20472169813242921
2516,0.2516,3,104,3,215393,390217,7482,100474,3.614592982326133,0.20476022588553694
2517,0.2517,10,77,10,215470,390140,7492,100464,3.6138797287783913,0.2047761534761233
2518,0.2518,6,99,6,215569,390041,7498,100458,3.6129626885027233,0.20480775699848522
2519,0.2519,6,92,6,215661,389949,7504,100452,3.612110489458668,0.20483645017037078
2520,0.252,7,100,7,215761,389849,7511,100445,3.611184186149913,0.20486687579289162
2521,0.2521,6,85,6,215846,389764,7517,100439,3.6103968283374708,0.20489266691554314
2522,0.2522,8,90,8,215936,389674,7525,100431,3.609563155359591,0.20491731363687374
2523,0.2523,12,95,12,216031,389579,7537,100419,3.6086831672162734,0.20493757117375988
2524,0.2524,5,110,5,216141,389469,7542,100414,3.6076642335766422,0.20497547373556543
2525,0.2525,9,97,9,216238,389372,7551,100405,3.6067657193671496,0.2050014598480533
2526,0.2526,4,88,4,216326,389284,7555,100401,3.605950572455445,0.20503180616110356
2527,0.2527,4,93,4,216419,389191,7559,100397,3.6050891103783025,0.2050642581109014
2528,0.2528,8,94,8,216513,389097,7567,100389,3.604218385268072,0.20509064610632377
2529,0.2529,9,88,9,216601,389009,7576,100380,3.603403238356367,0.20511290609310795
2530,0.253,5,87,5,216688,388922,7581,100375,3.60259735447775,0.20514125367619257
2531,0.2531,7,94,7,216782,388828,7588,100368,3.60172662936752,0.20516929819540633
2532,0.2532,7,84,7,216866,388744,7595,100361,3.6009485345881656,0.2051931589331534
2533,0.2533,4,97,4,216963,388647,7599,100357,3.600050020378673,0.20522736010339385
2534,0.2534,5,78,5,217041,388569,7604,100352,3.5993275037978436,0.2052519732226679
2535,0.2535,11,109,11,217150,388460,7615,100341,3.5983178331913,0.20527985826542908
2536,0.2536,5,93,5,217243,388367,7620,100336,3.597456371114158,0.2053107920352443
2537,0.2537,5,81,5,217324,388286,7625,100331,3.596706065434066,0.2053366952029913
2538,0.2538,8,108,8,217432,388178,7633,100323,3.5957056578606097,0.20536907805715854
2539,0.2539,10,101,10,217533,388077,7643,100313,3.594770091518767,0.20539527836360286
2540,0.254,4,88,4,217621,387989,7647,100309,3.593954944607062,0.20542578507386883
2541,0.2541,9,99,9,217720,387890,7656,100300,3.5930379043313945,0.20545279501833302
2542,0.2542,11,115,11,217835,387775,7667,100289,3.5919726555263254,0.20548329727248885
2543,0.2543,5,101,5,217936,387674,7672,100284,3.5910370891844825,0.2055176879977375
2544,0.2544,6,128,6,218064,387546,7678,100278,3.589851420949276,0.20556184197579455
2545,0.2545,5,101,5,218165,387445,7683,100273,3.5889158546074325,0.2055962666950984
2546,0.2546,6,111,6,218276,387334,7689,100267,3.587887657934714,0.2056332944354093
2547,0.2547,6,100,6,218376,387234,7695,100261,3.586961354625959,0.20566569913537575
2548,0.2548,8,104,8,218480,387130,7703,100253,3.585997999184853,0.2056965466583775
2549,0.2549,5,95,5,218575,387035,7708,100248,3.5851180110415353,0.20572849863426387
2550,0.255,6,86,6,218661,386949,7714,100242,3.584321390196006,0.20575503242054963
2551,0.2551,6,96,6,218757,386853,7720,100236,3.5834321390196004,0.20578580095218738
2552,0.2552,6,98,6,218855,386755,7726,100230,3.58252436177702,0.20581742764150845
2553,0.2553,10,112,10,218967,386643,7736,100220,3.581486902071214,0.20584846250382552
2554,0.2554,2,101,2,219068,386542,7738,100218,3.5805513357293712,0.20588791190730546
2555,0.2555,7,87,7,219155,386455,7745,100211,3.579745451850754,0.20591329577163806
2556,0.2556,9,83,9,219238,386372,7754,100202,3.578976620104487,0.20593373258743788
2557,0.2557,5,85,5,219323,386287,7759,100197,3.578189262292045,0.20596155269238042
2558,0.2558,5,84,5,219407,386203,7764,100192,3.5774111675126905,0.20598895959045632
2559,0.2559,8,96,8,219503,386107,7772,100184,3.576521916336285,0.20601656209964817
2560,0.256,6,82,6,219585,386025,7778,100178,3.5757623476231055,0.20604150941067825
2561,0.2561,4,85,4,219670,385940,7782,100174,3.5749749898106638,0.20607100392089098
2562,0.2562,10,102,10,219772,385838,7792,100164,3.574030160435733,0.20609791729252144
2563,0.2563,5,115,5,219887,385723,7797,100159,3.5729649116306645,0.2061385274614001
2564,0.2564,5,91,5,219978,385632,7802,100154,3.572121975619697,0.20616897152243993
2565,0.2565,2,82,2,220060,385550,7804,100152,3.5713624069065175,0.20620050977760027
2566,0.2566,2,110,2,220170,385440,7806,100150,3.5703434732668864,0.20624395065796247
2567,0.2567,6,90,6,220260,385350,7812,100144,3.5695098002890067,0.20627237411790877
2568,0.2568,8,92,8,220352,385258,7820,100136,3.5686576012449516,0.2062983885256101
2569,0.2569,2,92,2,220444,385166,7822,100134,3.5678054022008965,0.206334226251803
2570,0.257,6,110,6,220554,385056,7828,100128,3.566786468561266,0.20637119113573407
2571,0.2571,9,93,9,220647,384963,7837,100119,3.565925006484123,0.20639603201108267
2572,0.2572,4,94,4,220741,384869,7841,100115,3.565054281373893,0.20642949045741715
2573,0.2573,5,94,5,220835,384775,7846,100110,3.564183556263663,0.20646132588139457
2574,0.2574,8,97,8,220932,384678,7854,100102,3.5632850420541704,0.20648954164775774
2575,0.2575,3,84,3,221016,384594,7857,100099,3.562506947274816,0.2065204160159111
2576,0.2576,3,89,3,221105,384505,7860,100096,3.5616825373300234,0.20655343261776182
2577,0.2577,4,100,4,221205,384405,7864,100092,3.5607562340212677,0.2065895144861578
2578,0.2578,8,105,8,221310,384300,7872,100084,3.5597836155470746,0.20662119310299268
2579,0.2579,5,97,5,221407,384203,7877,100079,3.558885101337582,0.20665438731978475
2580,0.258,4,93,4,221500,384110,7881,100075,3.5580236392604396,0.20668752646199284
2581,0.2581,7,99,7,221599,384011,7888,100068,3.5571065989847717,0.206718324901514
2582,0.2582,4,96,4,221695,383915,7892,100064,3.5562173478083663,0.2067527723310309
2583,0.2583,4,109,4,221804,383806,7896,100060,3.555207677201823,0.20679278973930798
2584,0.2584,13,91,13,221895,383715,7909,100047,3.5543647411908554,0.20681037369615637
2585,0.2585,9,107,9,222002,383608,7918,100038,3.5533735966504874,0.2068413674464381
2586,0.2586,6,91,6,222093,383517,7924,100032,3.55253066063952,0.20687045159849363
2587,0.2587,8,116,8,222209,383401,7932,100024,3.5514561488013636,0.2069069659202565
2588,0.2588,5,83,5,222292,383318,7937,100019,3.5506873170550963,0.20693429222261073
2589,0.2589,6,92,6,222384,383226,7943,100013,3.5498351180110417,0.20696384190845524
2590,0.259,7,108,7,222492,383118,7950,100006,3.5488347104375855,0.2069986173321963
2591,0.2591,7,84,7,222576,383034,7957,99999,3.548056615658231,0.20702312264379452
2592,0.2592,6,81,6,222657,382953,7963,99993,3.5473063099781394,0.20704799294331044
2593,0.2593,2,96,2,222753,382857,7965,99991,3.546417058801734,0.2070858738153622
2594,0.2594,5,95,5,222848,382762,7970,99986,3.5455370706584164,0.20711841374795958
2595,0.2595,6,106,6,222954,382656,7976,99980,3.5445551891511355,0.20715404569903612
2596,0.2596,8,120,8,223074,382536,7984,99972,3.543443625180629,0.20719241960755055
2597,0.2597,6,96,6,223170,382440,7990,99966,3.542554374004224,0.2072237907488713
2598,0.2598,5,86,5,223256,382354,7995,99961,3.541757753158694,0.20725252169225505
2599,0.2599,4,98,4,223354,382256,7999,99957,3.540849975916114,0.20728806564733843
2600,0.26,4,93,4,223447,382163,8003,99953,3.5399885138389715,0.2073214744999129
2601,0.2601,6,98,6,223545,382065,8009,99947,3.539080736596391,0.20735375882758106
2602,0.2602,3,104,3,223649,381961,8012,99944,3.5381173811552853,0.2073935734221475
2603,0.2603,7,106,7,223755,381855,8019,99937,3.537135499648005,0.20742768663655686
2604,0.2604,7,90,7,223845,381765,8026,99930,3.5363018266701247,0.20745492479681127
2605,0.2605,7,88,7,223933,381677,8033,99923,3.53548667975842,0.2074813122923588
2606,0.2606,7,94,7,224027,381583,8040,99916,3.53461595464819,0.2075102959715389
2607,0.2607,9,100,9,224127,381483,8049,99907,3.5336896513394347,0.20753858617752757
2608,0.2608,6,97,6,224224,381386,8055,99901,3.5327911371299416,0.20757053483680216
2609,0.2609,10,80,10,224304,381306,8065,99891,3.5320500944829374,0.20758857598862837
2610,0.261,9,90,9,224394,381216,8074,99882,3.5312164215050577,0.2076125862090468
2611,0.2611,10,90,10,224484,381126,8084,99872,3.530382748527178,0.20763495898111842
2612,0.2612,9,97,9,224581,381029,8093,99863,3.529484234317685,0.20766201142876156
2613,0.2613,4,92,4,224673,380937,8097,99859,3.52863203527363,0.20769515553373988
2614,0.2614,7,92,7,224765,380845,8104,99852,3.527779836229575,0.20772336835886224
2615,0.2615,8,103,8,224868,380742,8112,99844,3.526825743821557,0.2077546994710624
2616,0.2616,9,97,9,224965,380645,8121,99835,3.5259272296120643,0.20778180153180154
2617,0.2617,8,97,8,225062,380548,8129,99827,3.5250287154025712,0.20781056466302367
2618,0.2618,8,96,8,225158,380452,8137,99819,3.5241394642261663,0.20783890761674137
2619,0.2619,5,83,5,225241,380369,8142,99814,3.523370632479899,0.2078665841981078
2620,0.262,5,91,5,225332,380278,8147,99809,3.5225276964689316,0.2078977352021613
2621,0.2621,3,93,3,225425,380185,8150,99806,3.5216662343917893,0.20793306541164314
2622,0.2622,7,101,7,225526,380084,8157,99799,3.5207306680499464,0.20796527486908267
2623,0.2623,4,95,4,225621,379989,8161,99795,3.5198506799066287,0.20799984993246962
2624,0.2624,11,84,11,225705,379905,8172,99784,3.519072585127274,0.2080181117348949
2625,0.2625,10,94,10,225799,379811,8182,99774,3.518201860017044,0.2080423699656995
2626,0.2626,13,88,13,225887,379723,8195,99761,3.5173867131053393,0.20805908017785787
2627,0.2627,6,104,6,225991,379619,8201,99755,3.5164233576642334,0.2080943063244982
2628,0.2628,8,94,8,226085,379525,8209,99747,3.5155526325540034,0.20812190155068522
2629,0.2629,6,111,6,226196,379414,8215,99741,3.514524435881285,0.20816019868309837
2630,0.263,6,96,6,226292,379318,8221,99735,3.5136351847048797,0.2081919954577051
2631,0.2631,8,87,8,226379,379231,8229,99727,3.5128293008262625,0.2082165868405998
2632,0.2632,4,93,4,226472,379138,8233,99723,3.51196783874912,0.2082504108707955
2633,0.2633,10,99,10,226571,379039,8243,99713,3.5110507984734523,0.2082769367020921
2634,0.2634,7,90,7,226661,378949,8250,99706,3.510217125495572,0.20830451995696275
2635,0.2635,11,112,11,226773,378837,8261,99695,3.509179665789766,0.2083350747703393
2636,0.2636,8,109,8,226882,378728,8269,99687,3.5081699951832226,0.20836930280196064
2637,0.2637,5,98,5,226980,378630,8274,99682,3.5072622179406423,0.2084037197477797
2638,0.2638,10,101,10,227081,378529,8284,99672,3.5063266515987994,0.20843118270350752
2639,0.2639,8,79,8,227160,378450,8292,99664,3.505594871984883,0.20845237746646197
2640,0.264,7,105,7,227265,378345,8299,99657,3.5046222535106897,0.20848657536997753
2641,0.2641,8,94,8,227359,378251,8307,99649,3.5037515284004592,0.20851433354258214
2642,0.2642,4,86,4,227445,378165,8311,99645,3.5029549075549298,0.20854523764676336
2643,0.2643,4,107,4,227552,378058,8315,99641,3.5019637630145617,0.20858532255667273
2644,0.2644,11,77,11,227629,377981,8326,99630,3.5012505094668196,0.20860072318267375
2645,0.2645,8,103,8,227732,377878,8334,99622,3.500296417058802,0.2086324607329843
2646,0.2646,11,71,11,227803,377807,8345,99611,3.4996387417095853,0.2086452542635594
2647,0.2647,5,95,5,227898,377712,8350,99606,3.4987587535662676,0.20867849106884717
2648,0.2648,12,83,12,227981,377629,8362,99594,3.497989921820001,0.20869488687678506
2649,0.2649,5,87,5,228068,377542,8367,99589,3.4971840379413837,0.20872464794783824
2650,0.265,9,81,9,228149,377461,8376,99580,3.4964337322612917,0.2087451602692431
2651,0.2651,7,108,7,228257,377353,8383,99573,3.495433324687836,0.20878081714983038
2652,0.2652,8,85,8,228342,377268,8391,99565,3.4946459668753937,0.20880475973768595
2653,0.2653,4,111,4,228453,377157,8395,99561,3.493617770202675,0.20884673958189118
2654,0.2654,4,85,4,228538,377072,8399,99557,3.492830412390233,0.20887734485312476
2655,0.2655,3,122,3,228660,376950,8402,99554,3.4917003223535517,0.20892584322482077
2656,0.2656,6,83,6,228743,376867,8408,99548,3.4909314906072844,0.2089522790004513
2657,0.2657,3,92,3,228835,376775,8411,99545,3.4900792915632293,0.2089876553577427
2658,0.2658,5,107,5,228942,376668,8416,99540,3.489088147022861,0.2090263078318718
2659,0.2659,4,97,4,229039,376571,8420,99536,3.4881896328133686,0.20906224861218173
2660,0.266,5,99,5,229138,376472,8425,99531,3.4872725925377006,0.20909742165490552
2661,0.2661,3,100,3,229238,376372,8428,99528,3.486346289228945,0.20913637318764447
2662,0.2662,4,105,4,229343,376267,8432,99524,3.485373670754752,0.20917587764375534
2663,0.2663,11,91,11,229434,376176,8443,99513,3.4845307347437844,0.2091976059988774
2664,0.2664,8,89,8,229523,376087,8451,99505,3.4837063247989923,0.20922345203451698
2665,0.2665,7,103,7,229626,375984,8458,99498,3.482752232390974,0.2092571327621235
2666,0.2666,6,87,6,229713,375897,8464,99492,3.481946348512357,0.20928544833809784
2667,0.2667,10,83,10,229796,375814,8474,99482,3.48117751676609,0.2093053591866963
2668,0.2668,4,99,4,229895,375715,8478,99478,3.480260476490422,0.2093423093353648
2669,0.2669,10,75,10,229970,375640,8488,99468,3.4795657490088554,0.20935871422918578
2670,0.267,3,90,3,230060,375550,8491,99465,3.4787320760309757,0.2093933875772344
2671,0.2671,7,91,7,230151,375459,8498,99458,3.4778891400200083,0.20942185687183235
2672,0.2672,3,86,3,230237,375373,8501,99455,3.4770925191744784,0.20945479205101636
2673,0.2673,5,105,5,230342,375268,8506,99450,3.476119900700285,0.2094927936164207
2674,0.2674,8,115,8,230457,375153,8514,99442,3.4750546518952166,0.2095302310390965
2675,0.2675,7,98,7,230555,375055,8521,99435,3.4741468746526363,0.20956184534974392
2676,0.2676,8,110,8,230665,374945,8529,99427,3.473127941013005,0.20959710944153534
2677,0.2677,3,100,3,230765,374845,8532,99424,3.47220163770425,0.2096363034480432
2678,0.2678,9,95,9,230860,374750,8541,99415,3.4713216495609323,0.20966330285870952
2679,0.2679,6,71,6,230931,374679,8547,99409,3.470663974211716,0.20968469988694083
2680,0.268,7,104,7,231035,374575,8554,99402,3.4697006187706103,0.20971903699968564
2681,0.2681,11,110,11,231145,374465,8565,99391,3.468681685130979,0.2097493753376553
2682,0.2682,6,86,6,231231,374379,8571,99385,3.4678850642854497,0.20977744193311437
2683,0.2683,8,81,8,231312,374298,8579,99377,3.467134758605358,0.20979996833271758
2684,0.2684,3,101,3,231413,374197,8582,99374,3.466199192263515,0.20983970724558726
2685,0.2685,6,101,6,231514,374096,8588,99368,3.4652636259216716,0.20987445719209907
2686,0.2686,10,77,10,231591,374019,8598,99358,3.46455037237393,0.20989190433840257
2687,0.2687,6,97,6,231688,373922,8604,99352,3.4636518581644373,0.2099249060797762
2688,0.2688,7,83,7,231771,373839,8611,99345,3.4628830264181705,0.20995004057618177
2689,0.2689,8,102,8,231873,373737,8619,99337,3.46193819704324,0.20998194785593796
2690,0.269,5,95,5,231968,373642,8624,99332,3.461058208899922,0.21001577253717962
2691,0.2691,6,107,6,232075,373535,8630,99326,3.4600670643595537,0.21005327146878258
2692,0.2692,8,88,8,232163,373447,8638,99318,3.4592519174478493,0.21007900331031273
2693,0.2693,12,100,12,232263,373347,8650,99306,3.4583256141390937,0.21010339509111337
2694,0.2694,4,89,4,232352,373258,8654,99302,3.457501204194301,0.2101362789910276
2695,0.2695,11,105,11,232457,373153,8665,99291,3.456528585720108,0.2101645909356453
2696,0.2696,10,93,10,232550,373060,8675,99281,3.4556671236429657,0.21018924886893156
2697,0.2697,7,100,7,232650,372960,8682,99274,3.45474082033421,0.21022205093237675
2698,0.2698,6,93,6,232743,372867,8688,99268,3.4538793582570677,0.21025342327935867
2699,0.2699,5,80,5,232823,372787,8693,99263,3.4531383156100635,0.2102806906048088
2700,0.27,3,99,3,232922,372688,8696,99260,3.4522212753343955,0.21031978099282125
2701,0.2701,9,87,9,233009,372601,8705,99251,3.4514153914557784,0.21034349753736342
2702,0.2702,5,81,5,233090,372520,8710,99246,3.4506650857756864,0.2103712433706541
2703,0.2703,5,96,5,233186,372424,8715,99241,3.449775834599281,0.21040569047947166
2704,0.2704,10,96,10,233282,372328,8725,99231,3.448886583422876,0.21043178054071707
2705,0.2705,12,102,12,233384,372226,8737,99219,3.4479417540479456,0.21045721133960482
2706,0.2706,8,117,8,233501,372109,8745,99211,3.4468579791767016,0.2104960536365951
2707,0.2707,9,67,9,233568,372042,8754,99202,3.4462373559598354,0.21051090305659065
2708,0.2708,7,88,7,233656,371954,8761,99195,3.4454222090481306,0.21053849206938782
2709,0.2709,11,78,11,233734,371876,8772,99184,3.4446996924673017,0.21055491869400925
2710,0.271,10,80,10,233814,371796,8782,99174,3.443958649820297,0.2105739219058539
2711,0.2711,11,87,11,233901,371709,8793,99163,3.44315276594168,0.2105943865848893
2712,0.2712,6,119,6,234020,371590,8799,99157,3.442050465004261,0.21063756115280607
2713,0.2713,5,100,5,234120,371490,8804,99152,3.4411241616955057,0.21067393050344
2714,0.2714,6,106,6,234226,371384,8810,99146,3.440142280188225,0.2107113255265339
2715,0.2715,6,99,6,234325,371285,8816,99140,3.439225239912557,0.21074560238082585
2716,0.2716,5,97,5,234422,371188,8821,99135,3.4383267257030643,0.2107806762586563
2717,0.2717,5,90,5,234512,371098,8826,99130,3.437493052725184,0.21081262706601903
2718,0.2718,9,82,9,234594,371016,8835,99121,3.436733484012005,0.21083428872860463
2719,0.2719,7,97,7,234691,370919,8842,99114,3.4358349698025124,0.2108660455755234
2720,0.272,5,97,5,234788,370822,8847,99109,3.4349364555930193,0.21090117485332954
2721,0.2721,1,101,1,234889,370721,8848,99108,3.4340008892511764,0.2109448331201352
2722,0.2722,8,86,8,234975,370635,8856,99100,3.433204268405647,0.21097001500846221
2723,0.2723,7,97,7,235072,370538,8863,99093,3.432305754196154,0.2110018290956091
2724,0.2724,6,108,6,235180,370430,8869,99087,3.431305346622698,0.21104028182153148
2725,0.2725,3,112,3,235292,370318,8872,99084,3.430267886916892,0.2110855940111035
2726,0.2726,6,95,6,235387,370223,8878,99078,3.4293878987735744,0.2111182375490357
2727,0.2727,3,104,3,235491,370119,8881,99075,3.428424543332469,0.21115998925817467
2728,0.2728,4,93,4,235584,370026,8885,99071,3.427563081255326,0.2111951259547599
2729,0.2729,10,100,10,235684,369926,8895,99061,3.426636777946571,0.21122333881322936
2730,0.273,4,100,4,235784,369826,8899,99057,3.4257104746378153,0.21126165802556288
2731,0.2731,5,93,5,235877,369733,8904,99052,3.424849012560673,0.2112951566283051
2732,0.2732,9,110,9,235987,369623,8913,99043,3.423830078921042,0.21132960359829814
2733,0.2733,6,85,6,236072,369538,8919,99037,3.4230427211085996,0.21135784026036386
2734,0.2734,3,108,3,236180,369430,8922,99034,3.422042313535144,0.21140151644523378
2735,0.2735,6,105,6,236285,369325,8928,99028,3.4210696950609507,0.21143880790771064
2736,0.2736,7,91,7,236376,369234,8935,99021,3.4202267590499833,0.21146811032450266
2737,0.2737,5,92,5,236468,369142,8940,99016,3.419374560005928,0.2115012453060719
2738,0.2738,10,87,10,236555,369055,8950,99006,3.418568676127311,0.21152371165296832
2739,0.2739,7,87,7,236642,368968,8957,98999,3.417762792248694,0.2115512418610714
2740,0.274,7,95,7,236737,368873,8964,98992,3.4168828041053763,0.21158240090624433
2741,0.2741,4,85,4,236822,368788,8968,98988,3.416095446292934,0.21161410589683952
2742,0.2742,9,97,9,236919,368691,8977,98979,3.4151969320834414,0.21164282506895887
2743,0.2743,8,118,8,237037,368573,8985,98971,3.41410389417911,0.21168275071437126
2744,0.2744,10,107,10,237144,368466,8995,98961,3.4131127496387417,0.21171434256044258
2745,0.2745,5,100,5,237244,368366,9000,98956,3.4121864463299865,0.21175121222625942
2746,0.2746,9,79,9,237323,368287,9009,98947,3.4114546667160695,0.2117718316732087
2747,0.2747,4,99,4,237422,368188,9013,98943,3.4105376264404015,0.211809963372159
2748,0.2748,6,107,6,237529,368081,9019,98937,3.4095464819000334,0.21184836558762188
2749,0.2749,6,88,6,237617,367993,9025,98931,3.4087313349883286,0.2118781643265285
2750,0.275,6,101,6,237718,367892,9031,98925,3.4077957686464857,0.21191387631555836
2751,0.2751,3,67,3,237785,367825,9034,98922,3.4071751454296195,0.21193923046104207
2752,0.2752,5,110,5,237895,367715,9039,98917,3.4061562117899884,0.2119807471412162
2753,0.2753,8,98,8,237993,367617,9047,98909,3.405248434547408,0.21201176354586881
2754,0.2754,4,88,4,238081,367529,9051,98905,3.4044332876357033,0.21204500529549733
2755,0.2755,6,80,6,238161,367449,9057,98899,3.403692244988699,0.21207124293446097
2756,0.2756,8,99,8,238260,367350,9065,98891,3.402775204713031,0.2121027537260773
2757,0.2757,6,98,6,238358,367252,9071,98885,3.401867427470451,0.21213720429830715
2758,0.2758,5,109,5,238467,367143,9076,98880,3.4008577568639073,0.21217836887878924
2759,0.2759,5,91,5,238558,367052,9081,98875,3.40001482085294,0.2122113549976713
2760,0.276,4,83,4,238641,366969,9085,98871,3.399245989106673,0.21224240082431736
2761,0.2761,8,103,8,238744,366866,9093,98863,3.398291896698655,0.21227580846372032
2762,0.2762,5,80,5,238824,366786,9098,98858,3.3975508540516506,0.21230382008573073
2763,0.2763,7,98,7,238922,366688,9105,98851,3.3966430768090703,0.2123366678194523
2764,0.2764,11,118,11,239040,366570,9116,98840,3.395550038904739,0.21237188715326272
2765,0.2765,9,107,9,239147,366463,9125,98831,3.3945588943643705,0.2124054898623236
2766,0.2766,7,81,7,239228,366382,9132,98824,3.3938085886842786,0.21243062213299055
2767,0.2767,4,103,4,239331,366279,9136,98820,3.392854496276261,0.21247089329368585
2768,0.2768,9,86,9,239417,366193,9145,98811,3.392057875430731,0.212494946280032
2769,0.2769,9,94,9,239511,366099,9154,98802,3.391187150320501,0.21252266611601178
2770,0.277,8,98,8,239609,366001,9162,98794,3.3902793730779206,0.21255392162135994
2771,0.2771,8,89,8,239698,365912,9170,98786,3.389454963133128,0.21258107415999208
2772,0.2772,7,87,7,239785,365825,9177,98779,3.388649079254511,0.21260901757195375
2773,0.2773,9,95,9,239880,365730,9186,98770,3.3877690911111933,0.2126372443487621
2774,0.2774,5,89,5,239969,365641,9191,98765,3.3869446811664012,0.21266951762035805
2775,0.2775,8,89,8,240058,365552,9199,98757,3.3861202712216087,0.21269671705695992
2776,0.2776,10,101,10,240159,365451,9209,98747,3.385184704879766,0.21272603501092208
2777,0.2777,8,94,8,240253,365357,9217,98739,3.384313979769536,0.21275555057574294
2778,0.2778,3,89,3,240342,365268,9220,98736,3.3834895698247434,0.21279126904078413
2779,0.2779,9,94,9,240436,365174,9229,98727,3.3826188447145134,0.21281911442312046
2780,0.278,9,123,9,240559,365051,9238,98718,3.381479491644744,0.21286028173508795
2781,0.2781,7,112,7,240671,364939,9245,98711,3.380442031938938,0.21289981667205868
2782,0.2782,8,97,8,240768,364842,9253,98703,3.3795435177294455,0.21293078341908553
2783,0.2783,6,80,6,240848,364762,9259,98697,3.378802475082441,0.212957348978011
2784,0.2784,9,77,9,240925,364685,9268,98688,3.378089221534699,0.21297745013196712
2785,0.2785,5,90,5,241015,364595,9273,98683,3.3772555485568194,0.21301033073014475
2786,0.2786,13,83,13,241098,364512,9286,98670,3.3764867168105526,0.21302641294350816
2787,0.2787,7,98,7,241196,364414,9293,98663,3.3755789395679723,0.213059599159535
2788,0.2788,11,110,11,241306,364304,9304,98652,3.374560005928341,0.21309152489653443
2789,0.2789,5,101,5,241407,364203,9309,98647,3.3736244395864983,0.2131295236037593
2790,0.279,9,74,9,241481,364129,9318,98638,3.372938975138019,0.2131483014130221
2791,0.2791,4,96,4,241577,364033,9322,98634,3.372049723961614,0.21318572537051486
2792,0.2792,8,109,8,241686,363924,9330,98626,3.3710400533550704,0.21322235434007134
2793,0.2793,6,81,6,241767,363843,9336,98620,3.370289747674979,0.21324949239182378
2794,0.2794,6,82,6,241849,363761,9342,98614,3.3695301789617993,0.2132771019194377
2795,0.2795,8,96,8,241945,363665,9350,98606,3.368640927785394,0.21330777833781484
2796,0.2796,5,89,5,242034,363576,9355,98601,3.367816517840602,0.21334034363458157
2797,0.2797,8,107,8,242141,363469,9363,98593,3.3668253733002333,0.21337612701325795
2798,0.2798,4,95,4,242236,363374,9367,98589,3.3659453851569157,0.21341319542907117
2799,0.2799,6,88,6,242324,363286,9373,98583,3.365130238245211,0.21344363878069322
2800,0.28,5,106,5,242430,363180,9378,98578,3.3641483567379304,0.21348411938721149
2801,0.2801,8,103,8,242533,363077,9386,98570,3.363194264329912,0.21351812098854753
2802,0.2802,9,90,9,242623,362987,9395,98561,3.3623605913520325,0.21354442008198496
2803,0.2803,9,82,9,242705,362905,9404,98552,3.361601022638853,0.21356702791376012
2804,0.2804,10,100,10,242805,362805,9414,98542,3.3606747193300976,0.21359627352079888
2805,0.2805,14,103,14,242908,362702,9428,98528,3.3597206269220794,0.21362010276868373
2806,0.2806,8,117,8,243025,362585,9436,98520,3.3586368520508354,0.2136606629726418
2807,0.2807,10,91,10,243116,362494,9446,98510,3.357793916039868,0.2136857814682736
2808,0.2808,7,100,7,243216,362394,9453,98503,3.356867612731113,0.21372020212759033
2809,0.2809,10,95,10,243311,362299,9463,98493,3.355987624587795,0.21374720047223042
2810,0.281,6,102,6,243413,362197,9469,98487,3.3550427952128645,0.21378428597476795
2811,0.2811,12,105,12,243518,362092,9481,98475,3.3540701767386714,0.21381253976077313
2812,0.2812,8,86,8,243604,362006,9489,98467,3.3532735558931415,0.21383881356778792
2813,0.2813,6,96,6,243700,361910,9495,98461,3.3523843047167365,0.2138731588219067
2814,0.2814,6,98,6,243798,361812,9501,98455,3.3514765274741563,0.2139084487916796
2815,0.2815,7,94,7,243892,361718,9508,98448,3.3506058023639262,0.21394018680215401
2816,0.2816,0,87,0,243979,361631,9508,98448,3.3497999184853087,0.21398064245488274
2817,0.2817,6,100,6,244079,361531,9514,98442,3.3488736151765535,0.21401690968817735
2818,0.2818,11,91,11,244170,361440,9525,98431,3.348030679165586,0.21404045917224612
2819,0.2819,5,92,5,244262,361348,9530,98426,3.347178480121531,0.21407474106843796
2820,0.282,9,85,9,244347,361263,9539,98417,3.3463911223090888,0.21409893839192481
2821,0.2821,10,96,10,244443,361167,9549,98407,3.345501871132684,0.21412656068445995
2822,0.2822,9,88,9,244531,361079,9558,98398,3.344686724220979,0.2141521773668758
2823,0.2823,9,82,9,244613,360997,9567,98389,3.3439271555077994,0.21417500751002425
2824,0.2824,6,70,6,244683,360927,9573,98383,3.3432787431916706,0.21419738303106833
2825,0.2825,10,91,10,244774,360836,9583,98373,3.342435807180703,0.21422271776032265
2826,0.2826,5,100,5,244874,360736,9588,98368,3.341509503871948,0.21426082107757718
2827,0.2827,7,91,7,244965,360645,9595,98361,3.3406665678609806,0.2142913164533797
2828,0.2828,7,109,7,245074,360536,9602,98354,3.339656897254437,0.2143302316459282
2829,0.2829,8,88,8,245162,360448,9610,98346,3.3388417503427323,0.21435764199183074
2830,0.283,8,88,8,245250,360360,9618,98338,3.3380266034310275,0.2143850638110478
2831,0.2831,8,89,8,245339,360271,9626,98330,3.337202193486235,0.21441296464682807
2832,0.2832,8,87,8,245426,360184,9634,98322,3.336396309607618,0.21443994189825216
2833,0.2833,5,93,5,245519,360091,9639,98317,3.3355348475304756,0.21447487827437567
2834,0.2834,7,91,7,245610,360000,9646,98310,3.334691911519508,0.21450546573280094
2835,0.2835,6,91,6,245701,359909,9652,98304,3.3338489755085403,0.21453778046454378
2836,0.2836,4,98,4,245799,359811,9656,98300,3.33294119826596,0.21457681653573044
2837,0.2837,7,102,7,245901,359709,9663,98293,3.3319963688910295,0.21461259994497842
2838,0.2838,8,98,8,245999,359611,9671,98285,3.331088591648449,0.2146448101752363
2839,0.2839,4,91,4,246090,359520,9675,98281,3.3302456556374818,0.21468061450280798
2840,0.284,8,95,8,246185,359425,9683,98273,3.329365667494164,0.2147114472862018
2841,0.2841,7,111,7,246296,359314,9690,98266,3.3283374708214457,0.21475151886009003
2842,0.2842,4,101,4,246397,359213,9694,98262,3.327401904479603,0.2147920651401716
2843,0.2843,1,85,1,246482,359128,9695,98261,3.3266145466671606,0.21483026482928097
2844,0.2844,5,100,5,246582,359028,9700,98256,3.3256882433584054,0.21486865930144067
2845,0.2845,10,106,10,246688,358922,9710,98246,3.3247063618511246,0.21490130542820146
2846,0.2846,8,81,8,246769,358841,9718,98238,3.3239560561710326,0.21492564742637488
2847,0.2847,7,89,7,246858,358752,9725,98231,3.32313164622624,0.21495547974432308
2848,0.2848,5,96,5,246954,358656,9730,98226,3.322242395049835,0.2149920548412938
2849,0.2849,7,105,7,247059,358551,9737,98219,3.321269776575642,0.2150294458918055
2850,0.285,4,97,4,247156,358454,9741,98215,3.320371262366149,0.21506824417685458
2851,0.2851,9,98,9,247254,358356,9750,98206,3.3194634851235687,0.2150989350843916
2852,0.2852,8,93,8,247347,358263,9758,98198,3.3186020230464264,0.2151290033540653
2853,0.2853,10,82,10,247429,358181,9768,98188,3.3178424543332468,0.21515045938703112
2854,0.2854,10,85,10,247514,358096,9778,98178,3.317055096520805,0.21517333882710826
2855,0.2855,4,92,4,247606,358004,9782,98174,3.31620289747675,0.21520985229449907
2856,0.2856,10,96,10,247702,357908,9792,98164,3.3153136463003445,0.2152379448858952
2857,0.2857,7,99,7,247801,357809,9799,98157,3.3143966060246766,0.21527262997679653
2858,0.2858,4,85,4,247886,357724,9803,98153,3.313609248212235,0.21530588294649652
2859,0.2859,13,81,13,247967,357643,9816,98140,3.312858942532143,0.21532176496271252
2860,0.286,10,92,10,248059,357551,9826,98130,3.3120067434880878,0.21534801758247546
2861,0.2861,8,102,8,248161,357449,9834,98122,3.311061914113157,0.21538245410704368
2862,0.2862,5,95,5,248256,357354,9839,98117,3.3101819259698395,0.21541876431210769
2863,0.2863,4,90,4,248346,357264,9843,98113,3.30934825299196,0.21545444763349927
2864,0.2864,7,89,7,248435,357175,9850,98106,3.3085238430471673,0.21548450297728217
2865,0.2865,2,100,2,248535,357075,9852,98104,3.307597539738412,0.21552839652092912
2866,0.2866,6,94,6,248629,356981,9858,98098,3.3067268146281816,0.2155625726522208
2867,0.2867,7,94,7,248723,356887,9865,98091,3.3058560895179516,0.21559503976016423
2868,0.2868,4,93,4,248816,356794,9869,98087,3.3049946274408093,0.21563222029497825
2869,0.2869,6,84,6,248900,356710,9875,98081,3.3042165326614548,0.21566169954990314
2870,0.287,4,92,4,248992,356618,9879,98077,3.3033643336173997,0.21569843521481433
2871,0.2871,6,101,6,249093,356517,9885,98071,3.302428767275557,0.21573600710973453
2872,0.2872,3,108,3,249201,356409,9888,98068,3.301428359702101,0.21578209678377563
2873,0.2873,5,77,5,249278,356332,9893,98063,3.3007151061543594,0.21581003312096303
2874,0.2874,10,99,10,249377,356233,9903,98053,3.2997980658786914,0.2158398013586155
2875,0.2875,11,103,11,249480,356130,9914,98042,3.298843973470673,0.21586975859366056
2876,0.2876,8,82,8,249562,356048,9922,98034,3.298084404757494,0.21589492646702577
2877,0.2877,8,94,8,249656,355954,9930,98026,3.2972136796472635,0.21592581170976696
2878,0.2878,8,108,8,249764,355846,9938,98018,3.2962132720738078,0.21596337228773377
2879,0.2879,12,79,12,249843,355767,9950,98006,3.295481492459891,0.21598023681444245
2880,0.288,7,109,7,249952,355658,9957,97999,3.2944718218533477,0.21602003275602494
2881,0.2881,11,108,11,250060,355550,9968,97988,3.293471414279892,0.21605245866939485
2882,0.2882,8,96,8,250156,355454,9976,97980,3.2925821631034866,0.21608436950030213
2883,0.2883,4,92,4,250248,355362,9980,97976,3.2917299640594315,0.21612130463362877
2884,0.2884,14,98,14,250346,355264,9994,97962,3.2908221868168512,0.21614382228733567
2885,0.2885,4,88,4,250434,355176,9998,97958,3.2900070399051464,0.21617887865399638
2886,0.2886,3,83,3,250517,355093,10001,97955,3.2892382081588796,0.2162132930726987
2887,0.2887,11,101,11,250618,354992,10012,97944,3.2883026418170367,0.21624247134252964
2888,0.2888,16,97,16,250715,354895,10028,97928,3.2874041276075436,0.21626109981162617
2889,0.2889,6,84,6,250799,354811,10034,97922,3.286626032828189,0.21629083808779126
2890,0.289,7,81,7,250880,354730,10041,97915,3.285875727148097,0.21631742314617416
2891,0.2891,15,86,15,250966,354644,10056,97900,3.2850791063025677,0.21633255550841465
2892,0.2892,8,96,8,251062,354548,10064,97892,3.2841898551261623,0.21636460083104941
2893,0.2893,6,87,6,251149,354461,10070,97886,3.283383971247545,0.21639582002312385
2894,0.2894,7,86,7,251235,354375,10077,97879,3.2825873504020158,0.21642484090798533
2895,0.2895,3,60,3,251295,354315,10080,97876,3.2820315684167625,0.21644835921104136
2896,0.2896,6,93,6,251388,354222,10086,97870,3.2811701063396197,0.21648248586570876
2897,0.2897,9,96,9,251484,354126,10095,97861,3.2802808551632148,0.21651286430804426
2898,0.2898,6,97,6,251581,354029,10101,97855,3.2793823409537217,0.21654893733790087
2899,0.2899,7,87,7,251668,353942,10108,97848,3.2785764570751046,0.21657849886008987
2900,0.29,12,98,12,251766,353844,10120,97836,3.2776686798325243,0.21660467587672688
2901,0.2901,5,105,5,251871,353739,10125,97831,3.276696061358331,0.21664636711916205
2902,0.2902,9,88,9,251959,353651,10134,97822,3.2758809144466263,0.21667297933652732
2903,0.2903,9,97,9,252056,353554,10143,97813,3.2749824002371337,0.21670392385796924
2904,0.2904,6,99,6,252155,353455,10149,97807,3.2740653599614657,0.21674105065350063
2905,0.2905,9,100,9,252255,353355,10158,97798,3.2731390566527105,0.2167734670943117
2906,0.2906,8,100,8,252355,353255,10166,97790,3.272212753343955,0.21680763560176922
2907,0.2907,5,95,5,252450,353160,10171,97785,3.271332765200637,0.21684462628480192
2908,0.2908,4,96,4,252546,353064,10175,97781,3.2704435140242323,0.21688385143452849
2909,0.2909,8,93,8,252639,352971,10183,97773,3.2695820519470895,0.2169147010276343
2910,0.291,9,92,9,252731,352879,10192,97764,3.2687298529030344,0.21694334539757634
2911,0.2911,11,96,11,252827,352783,10203,97753,3.2678406017266295,0.21697045297157164
2912,0.2912,13,95,13,252922,352688,10216,97740,3.266960613583312,0.2169936149617697
2913,0.2913,6,92,6,253014,352596,10222,97734,3.2661084145392567,0.21702751315701818
2914,0.2914,9,107,9,253121,352489,10231,97725,3.2651172699988886,0.21706344094141897
2915,0.2915,9,100,9,253221,352389,10240,97716,3.264190966690133,0.21709601093078282
2916,0.2916,12,83,12,253304,352306,10252,97704,3.263422134943866,0.2171151752183285
2917,0.2917,8,98,8,253402,352208,10260,97696,3.262514357701286,0.21714854724563462
2918,0.2918,10,94,10,253496,352114,10270,97686,3.261643632591056,0.21717652289906625
2919,0.2919,7,94,7,253590,352020,10277,97679,3.2607729074808254,0.2172097336218226
2920,0.292,8,90,8,253680,351930,10285,97671,3.2599392345029456,0.21723928549980984
2921,0.2921,9,102,9,253782,351828,10294,97662,3.258994405128015,0.2172729092972035
2922,0.2922,6,101,6,253883,351727,10300,97656,3.258058838786172,0.21731129125934892
2923,0.2923,6,96,6,253979,351631,10306,97650,3.257169587609767,0.21734727264228845
2924,0.2924,6,90,6,254069,351541,10312,97644,3.256335914631887,0.21738036666406937
2925,0.2925,7,95,7,254164,351446,10319,97637,3.2554559264885694,0.21741415284034354
2926,0.2926,5,83,5,254247,351363,10324,97632,3.2546870947423026,0.21744562857047406
2927,0.2927,6,78,6,254325,351285,10330,97626,3.253964578161473,0.21747295120859145
2928,0.2928,2,94,2,254419,351191,10332,97624,3.253093853051243,0.21751501175317225
2929,0.2929,7,102,7,254521,351089,10339,97617,3.2521490236763126,0.21755225024849234
2930,0.293,7,82,7,254603,351007,10346,97610,3.251389454963133,0.21757980638272736
2931,0.2931,8,105,8,254708,350902,10354,97602,3.25041683648894,0.21761678825606906
2932,0.2932,6,90,6,254798,350812,10360,97596,3.24958316351106,0.21764999732386575
2933,0.2933,12,90,12,254888,350722,10372,97584,3.2487494905331804,0.21767275030894076
2934,0.2934,6,78,6,254966,350644,10378,97578,3.248026973952351,0.21770015751123328
2935,0.2935,4,86,4,255052,350558,10382,97574,3.247230353106821,0.21773495309417762
2936,0.2936,5,99,5,255151,350459,10387,97569,3.2463133128311537,0.21777433553260064
2937,0.2937,7,92,7,255243,350367,10394,97562,3.2454611137870986,0.21780683992329142
2938,0.2938,11,102,11,255345,350265,10405,97551,3.244516284412168,0.21783723672222519
2939,0.2939,9,95,9,255440,350170,10414,97542,3.2436362962688503,0.21786773640197268
2940,0.294,7,109,7,255549,350061,10421,97535,3.242626625662307,0.21790856039821624
2941,0.2941,3,91,3,255640,349970,10424,97532,3.2417836896513395,0.2179476292843384
2942,0.2942,5,105,5,255745,349865,10429,97527,3.2408110711771463,0.21799004005435949
2943,0.2943,6,89,6,255834,349776,10435,97521,3.239986661232354,0.2180229243656899
2944,0.2944,6,91,6,255925,349685,10441,97515,3.2391437252213864,0.21805679785330948
2945,0.2945,7,93,7,256018,349592,10448,97508,3.238282263144244,0.21808991277119213
2946,0.2946,8,85,8,256103,349507,10456,97500,3.237494905331802,0.2181173896605646
2947,0.2947,3,110,3,256213,349397,10459,97497,3.2364759716921707,0.21816582903328305
2948,0.2948,9,83,9,256296,349314,10468,97488,3.235707139945904,0.21819060792028683
2949,0.2949,9,81,9,256377,349233,10477,97479,3.234956834265812,0.21821442002901198
2950,0.295,3,73,3,256450,349160,10480,97476,3.2342806328504206,0.2182448347199957
2951,0.2951,10,106,10,256556,349054,10490,97466,3.2332987513431397,0.21827913643285854
2952,0.2952,8,78,8,256634,348976,10498,97458,3.2325762347623104,0.21830326543229234
2953,0.2953,13,95,13,256729,348881,10511,97445,3.231696246618993,0.21832696280297362
2954,0.2954,7,108,7,256837,348773,10518,97438,3.230695839045537,0.21836754360605184
2955,0.2955,12,75,12,256912,348698,10530,97426,3.2300011115639706,0.21838322977468147
2956,0.2956,6,92,6,257004,348606,10536,97420,3.2291489125199155,0.21841776039961797
2957,0.2957,6,94,6,257098,348512,10542,97414,3.2282781874096855,0.21845328597121497
2958,0.2958,6,98,6,257196,348414,10548,97408,3.2273704101671052,0.21849078780320397
2959,0.2959,9,120,9,257316,348294,10557,97399,3.2262588461965986,0.2185338338273206
2960,0.296,8,90,8,257406,348204,10565,97391,3.225425173218719,0.21856394259361078
2961,0.2961,4,107,4,257513,348097,10569,97387,3.2244340286783504,0.21860942256063068
2962,0.2962,12,80,12,257593,348017,10581,97375,3.223692986031346,0.2186276358803032
2963,0.2963,14,81,14,257674,347936,10595,97361,3.222942680351254,0.2186428383752866
2964,0.2964,9,95,9,257769,347841,10604,97352,3.2220626922079365,0.21867369882275778
2965,0.2965,5,103,5,257872,347738,10609,97347,3.2211085997999187,0.21871552624779536
2966,0.2966,9,99,9,257971,347639,10618,97338,3.2201915595242507,0.21874838474797573
2967,0.2967,9,100,9,258071,347539,10627,97329,3.219265256215495,0.21878175099130528
2968,0.2968,10,78,10,258149,347461,10637,97319,3.218542739634666,0.2188025540716759
2969,0.2969,10,90,10,258239,347371,10647,97309,3.217709066656786,0.21882927048664208
2970,0.297,10,113,10,258352,347258,10657,97299,3.2166623439178923,0.2188673218507413
2971,0.2971,7,103,7,258455,347155,10664,97292,3.2157082515098745,0.21890574129198756
2972,0.2972,5,85,5,258540,347070,10669,97287,3.2149208936974323,0.2189388262140576
2973,0.2973,8,87,8,258627,346983,10677,97279,3.214115009818815,0.2189676362146661
2974,0.2974,6,101,6,258728,346882,10683,97273,3.2131794434769723,0.21900687822944692
2975,0.2975,10,75,10,258803,346807,10693,97263,3.2124847159954055,0.2190262796405972
2976,0.2976,8,91,8,258894,346716,10701,97255,3.211641779984438,0.219057100576389
2977,0.2977,5,89,5,258983,346627,10706,97250,3.2108173700396456,0.21909222599954492
2978,0.2978,6,89,6,259072,346538,10712,97244,3.2099929600948536,0.21912560671681142
2979,0.2979,6,97,6,259169,346441,10718,97238,3.2090944458853605,0.2191629533964871
2980,0.298,9,103,9,259272,346338,10727,97229,3.2081403534773427,0.2191980016547669
2981,0.2981,7,97,7,259369,346241,10734,97222,3.2072418392678497,0.2192336226472107
2982,0.2982,8,101,8,259470,346140,10742,97214,3.206306272926007,0.21926947766344726
2983,0.2983,13,89,13,259559,346051,10755,97201,3.2054818629812147,0.21929060669777012
2984,0.2984,6,92,6,259651,345959,10761,97195,3.2046296639371596,0.2193255617685951
2985,0.2985,5,88,5,259739,345871,10766,97190,3.203814517025455,0.21936031381683335
2986,0.2986,5,92,5,259831,345779,10771,97185,3.2029623179813997,0.21939706161223033
2987,0.2987,8,96,8,259927,345683,10779,97177,3.202073066804995,0.21943051980309805
2988,0.2988,4,98,4,260025,345585,10783,97173,3.2011652895624145,0.21947203664304202
2989,0.2989,10,83,10,260108,345502,10793,97163,3.2003964578161472,0.2194955553296511
2990,0.299,7,100,7,260208,345402,10800,97156,3.199470154507392,0.21953280699930858
2991,0.2991,4,93,4,260301,345309,10804,97152,3.1986086924302493,0.21957189447205516
2992,0.2992,7,97,7,260398,345212,10811,97145,3.1977101782207566,0.21960769242941786
2993,0.2993,8,94,8,260492,345118,10819,97137,3.1968394531105266,0.219640252795333
2994,0.2994,11,90,11,260582,345028,10830,97126,3.1960057801326465,0.21966554639333807
2995,0.2995,10,116,10,260698,344912,10840,97116,3.19493126829449,0.21970553901562798
2996,0.2996,8,102,8,260800,344810,10848,97108,3.19398643891956,0.21974212410447186
2997,0.2997,7,102,7,260902,344708,10855,97101,3.1930416095446295,0.21978049338062375
2998,0.2998,12,90,12,260992,344618,10867,97089,3.1922079365667493,0.21980407826907883
2999,0.2999,10,107,10,261099,344511,10877,97079,3.191216792026381,0.21983967028238863
3000,0.3,9,87,9,261186,344424,10886,97070,3.190410908147764,0.21986708766144047
3001,0.3001,12,65,12,261251,344359,10898,97058,3.189808810997073,0.21987825570832115
3002,0.3002,6,90,6,261341,344269,10904,97052,3.188975138019193,0.2199124900016088
3003,0.3003,11,99,11,261440,344170,10915,97041,3.188058097743525,0.2199423858426014
3004,0.3004,6,94,6,261534,344076,10921,97035,3.187187372633295,0.2199786448308929
3005,0.3005,12,104,12,261638,343972,10933,97023,3.1862240171921896,0.22000929715756415
3006,0.3006,10,83,10,261721,343889,10943,97013,3.1854551854459223,0.2200330232115073
3007,0.3007,10,86,10,261807,343803,10953,97003,3.184658564600393,0.22005825692027786
3008,0.3008,3,90,3,261897,343713,10956,97000,3.1838248916225127,0.22009788683338136
3009,0.3009,4,82,4,261979,343631,10960,96996,3.1830653229093335,0.2201317667777962
3010,0.301,4,87,4,262066,343544,10964,96992,3.1822594390307164,0.22016815878838505
3011,0.3011,8,107,8,262173,343437,10972,96984,3.181268294490348,0.22020748329439332
3012,0.3012,7,85,7,262258,343352,10979,96977,3.1804809366779057,0.2202375950709583
3013,0.3013,13,85,13,262343,343267,10992,96964,3.179693578865464,0.22025709229927015
3014,0.3014,8,82,8,262425,343185,11000,96956,3.1789340101522843,0.22028395446004803
3015,0.3015,6,101,6,262526,343084,11006,96950,3.1779984438104414,0.22032388406350417
3016,0.3016,10,90,10,262616,342994,11016,96940,3.177164770832561,0.22035123450335733
3017,0.3017,3,105,3,262721,342889,11019,96937,3.176192152358368,0.22039852123339684
3018,0.3018,3,87,3,262808,342802,11022,96934,3.175386268479751,0.22043680753906889
3019,0.3019,4,104,4,262912,342698,11026,96930,3.1744229130386454,0.22048186193782016
3020,0.302,7,80,7,262992,342618,11033,96923,3.173681870391641,0.22050957703604443
3021,0.3021,7,80,7,263072,342538,11040,96916,3.1729408277446365,0.22053730310794759
3022,0.3022,9,109,9,263181,342429,11049,96907,3.1719311571380935,0.22057605113170786
3023,0.3023,9,86,9,263267,342343,11058,96898,3.1711345362925636,0.2206032679098718
3024,0.3024,7,100,7,263367,342243,11065,96891,3.1702082329838084,0.22064107994370738
3025,0.3025,4,109,4,263476,342134,11069,96887,3.169198562377265,0.2206887597632004
3026,0.3026,8,94,8,263570,342040,11077,96879,3.168327837267035,0.22072181883217631
3027,0.3027,8,91,8,263661,341949,11085,96871,3.167484901256067,0.22075338407547515
3028,0.3028,7,96,7,263757,341853,11092,96864,3.166595650079662,0.2207892559440368
3029,0.3029,4,92,4,263849,341761,11096,96860,3.165743451035607,0.2208284601056493
3030,0.303,5,89,5,263938,341672,11101,96855,3.1649190410908146,0.22086439375454647
3031,0.3031,10,96,10,264034,341576,11111,96845,3.1640297899144096,0.22089498450119863
3032,0.3032,7,94,7,264128,341482,11118,96838,3.1631590648041796,0.220929914217923
3033,0.3033,5,106,5,264234,341376,11123,96833,3.162177183296899,0.22097446652168257
3034,0.3034,6,89,6,264323,341287,11129,96827,3.1613527733521063,0.2210086872366553
3035,0.3035,10,79,10,264402,341208,11139,96817,3.1606209937381897,0.22103076308429884
3036,0.3036,8,97,8,264499,341111,11147,96809,3.1597224795286967,0.2210654914139569
3037,0.3037,6,75,6,264574,341036,11153,96803,3.1590277520471304,0.2210926847539849
3038,0.3038,0,87,0,264661,340949,11153,96803,3.1582218681685132,0.221136625303825
3039,0.3039,5,95,5,264756,340854,11158,96798,3.1573418800251956,0.22117572866112803
3040,0.304,4,87,4,264843,340767,11162,96794,3.1565359961465784,0.2212125852166898
3041,0.3041,5,100,5,264943,340667,11167,96789,3.1556096928378228,0.2212542518561867
3042,0.3042,4,88,4,265031,340579,11171,96785,3.154794545926118,0.22129164723205386
3043,0.3043,9,87,9,265118,340492,11180,96776,3.153988662047501,0.22131964836210288
3044,0.3044,7,95,7,265213,340397,11187,96769,3.153108673904183,0.22135527465539406
3045,0.3045,7,98,7,265311,340299,11194,96762,3.152200896661603,0.2213924372112817
3046,0.3046,5,95,5,265406,340204,11199,96757,3.151320908518285,0.22143166094914649
3047,0.3047,6,90,6,265496,340114,11205,96751,3.1504872355404054,0.22146658578737138
3048,0.3048,5,100,5,265596,340014,11210,96746,3.14956093223165,0.22150837988826816
3049,0.3049,5,107,5,265703,339907,11215,96741,3.1485697876912817,0.22155374580898116
3050,0.305,10,85,10,265788,339822,11225,96731,3.1477824298788395,0.22157905225711425
3051,0.3051,9,96,9,265884,339726,11234,96722,3.146893178702434,0.2216117383972432
3052,0.3052,2,96,2,265980,339630,11236,96720,3.146003927526029,0.22165692677896184
3053,0.3053,11,93,11,266073,339537,11247,96709,3.1451424654488864,0.22168455412771693
3054,0.3054,10,85,10,266158,339452,11257,96699,3.1443551076364447,0.22170991239272636
3055,0.3055,16,68,16,266226,339384,11273,96683,3.143725221386491,0.22171592897421727
3056,0.3056,9,93,9,266319,339291,11282,96674,3.1428637593093485,0.22174715860218136
3057,0.3057,9,99,9,266418,339192,11291,96665,3.1419467190336805,0.22178145584446274
3058,0.3058,10,99,10,266517,339093,11301,96655,3.1410296787580125,0.221813984229417
3059,0.3059,2,91,2,266608,339002,11303,96653,3.140186742747045,0.22185674444227657
3060,0.306,12,95,12,266703,338907,11315,96641,3.1393067546037274,0.2218836959416643
3061,0.3061,10,103,10,266806,338804,11325,96631,3.138352662195709,0.221918311573484
3062,0.3062,5,83,5,266889,338721,11330,96626,3.1375838304494423,0.22195168451832675
3063,0.3063,7,101,7,266990,338620,11337,96619,3.1366482641075994,0.22199067638699657
3064,0.3064,14,81,14,267071,338539,11351,96605,3.1358979584275075,0.22200696780835769
3065,0.3065,9,108,9,267179,338431,11360,96596,3.1348975508540518,0.22204598795017322
3066,0.3066,10,88,10,267267,338343,11370,96586,3.134082403942347,0.22207302801146853
3067,0.3067,7,104,7,267371,338239,11377,96579,3.1331190485012415,0.22211361995133597
3068,0.3068,9,82,9,267453,338157,11386,96570,3.132359479788062,0.22213941163074757
3069,0.3069,5,88,5,267541,338069,11391,96565,3.131544332876357,0.2221754395652434
3070,0.307,10,95,10,267636,337974,11401,96555,3.1306643447330393,0.22220611282561117
3071,0.3071,7,74,7,267710,337900,11408,96548,3.1299788802845603,0.22223142930799544
3072,0.3072,8,92,8,267802,337808,11416,96540,3.129126681240505,0.2222641752695995
3073,0.3073,10,89,10,267891,337719,11426,96530,3.128302271295713,0.22229181874915083
3074,0.3074,11,85,11,267976,337634,11437,96519,3.127514913483271,0.22231563527143658
3075,0.3075,7,95,7,268071,337539,11444,96512,3.1266349253399532,0.22235175129189888
3076,0.3076,7,102,7,268173,337437,11451,96505,3.1256900959650227,0.22239147167132936
3077,0.3077,6,91,6,268264,337346,11457,96499,3.1248471599540553,0.2224273646117853
3078,0.3078,9,102,9,268366,337244,11466,96490,3.1239023305791247,0.22246353755988693
3079,0.3079,9,72,9,268438,337172,11475,96481,3.123235392196821,0.22248433655480304
3080,0.308,6,84,6,268522,337088,11481,96475,3.1224572974174665,0.22251668154339738
3081,0.3081,8,86,8,268608,337002,11489,96467,3.1216606765719366,0.22254647967905433
3082,0.3082,7,76,7,268684,336926,11496,96460,3.1209566860572826,0.22257294882621959
3083,0.3083,11,109,11,268793,336817,11507,96449,3.119947015450739,0.22260920543038226
3084,0.3084,6,87,6,268880,336730,11513,96443,3.119141131572122,0.22264314719523146
3085,0.3085,5,85,5,268965,336645,11518,96438,3.11835377375968,0.22267787006185882
3086,0.3086,6,87,6,269052,336558,11524,96432,3.1175478898810627,0.22271184092011362
3087,0.3087,8,84,8,269136,336474,11532,96424,3.116769795101708,0.22274069180268793
3088,0.3088,7,103,7,269239,336371,11539,96417,3.11581570269369,0.22278113071526937
3089,0.3089,3,104,3,269343,336267,11542,96414,3.1148523472525844,0.22282928993877707
3090,0.309,5,96,5,269439,336171,11547,96409,3.113963096076179,0.22286975819501595
3091,0.3091,9,80,9,269519,336091,11556,96400,3.113222053429175,0.22289481168394257
3092,0.3092,6,106,6,269625,335985,11562,96394,3.112240171921894,0.22293867185964167
3093,0.3093,5,79,5,269704,335906,11567,96389,3.1115083923079774,0.22297042528828692
3094,0.3094,5,96,5,269800,335810,11572,96384,3.110619141131572,0.22301096266954193
3095,0.3095,2,84,2,269884,335726,11574,96382,3.1098410463522175,0.22305071880178104
3096,0.3096,10,95,10,269979,335631,11584,96372,3.1089610582089,0.2230817841542767
3097,0.3097,2,90,2,270069,335541,11586,96370,3.10812738523102,0.22312467151797477
3098,0.3098,11,87,11,270156,335454,11597,96359,3.107321501352403,0.22314983569276514
3099,0.3099,5,103,5,270259,335351,11602,96354,3.1063674089443847,0.2231940792902561
3100,0.31,9,96,9,270355,335255,11611,96345,3.1054781577679798,0.22322752548656163
3101,0.3101,12,79,12,270434,335176,11623,96333,3.1047463781540627,0.22324679207154427
3102,0.3102,6,112,6,270546,335064,11629,96327,3.1037089184482567,0.22329394910881312
3103,0.3103,7,98,7,270644,334966,11636,96320,3.1028011412056764,0.22333208126394086
3104,0.3104,9,88,9,270732,334878,11645,96311,3.1019859942939716,0.22336144938762353
3105,0.3105,5,105,5,270837,334773,11650,96306,3.1010133758197784,0.22340684654088927
3106,0.3106,6,82,6,270919,334691,11656,96300,3.100253807106599,0.22343854047996362
3107,0.3107,5,92,5,271011,334599,11661,96295,3.099401608062544,0.22347723570065955
3108,0.3108,9,96,9,271107,334503,11670,96286,3.098512356886139,0.2235108138787202
3109,0.3109,6,92,6,271199,334411,11676,96280,3.0976601578420837,0.22354774072362785
3110,0.311,10,91,10,271290,334320,11686,96270,3.0968172218311163,0.22357695255347315
3111,0.3111,11,100,11,271390,334220,11697,96259,3.095890918522361,0.22360904945421264
3112,0.3112,8,83,8,271473,334137,11705,96251,3.095122086776094,0.22363774082920526
3113,0.3113,15,97,15,271570,334040,11720,96236,3.094223572566601,0.22366109195028308
3114,0.3114,6,105,6,271675,333935,11726,96230,3.093250954092408,0.2237048574384248
3115,0.3115,7,100,7,271775,333835,11733,96223,3.092324650783653,0.22374423914913802
3116,0.3116,10,86,10,271861,333749,11743,96213,3.091528029938123,0.22377093789683739
3117,0.3117,6,101,6,271962,333648,11749,96207,3.09059246359628,0.22381268102034407
3118,0.3118,6,86,6,272048,333562,11755,96201,3.08979584275075,0.2238466317481961
3119,0.3119,10,101,10,272149,333461,11765,96191,3.0888602764089073,0.2238811875657509
3120,0.312,15,110,15,272259,333351,11780,96176,3.0878413427692766,0.22391141883979354
3121,0.3121,8,107,8,272366,333244,11788,96168,3.086850198228908,0.22395275399849096
3122,0.3122,10,88,10,272454,333156,11798,96158,3.0860350513172032,0.22398058297656262
3123,0.3123,5,84,5,272538,333072,11803,96153,3.0852569565378487,0.2240153765507601
3124,0.3124,6,102,6,272640,332970,11809,96147,3.084312127162918,0.22405777445312117
3125,0.3125,11,100,11,272740,332870,11820,96136,3.083385823854163,0.22409010596588394
3126,0.3126,5,102,5,272842,332768,11825,96131,3.0824409944792324,0.22413435330928727
3127,0.3127,3,86,3,272928,332682,11828,96128,3.0816443736337025,0.22417387654205825
3128,0.3128,14,103,14,273031,332579,11842,96114,3.0806902812256847,0.22420240125217814
3129,0.3129,13,90,13,273121,332489,11855,96101,3.0798566082478045,0.22422595020882427
3130,0.313,3,94,3,273215,332395,11858,96098,3.0789858831375745,0.22426970802323493
3131,0.3131,6,104,6,273319,332291,11864,96092,3.078022527696469,0.22431328974305703
3132,0.3132,5,88,5,273407,332203,11869,96087,3.077207380784764,0.2243503233790189
3133,0.3133,10,80,10,273487,332123,11879,96077,3.07646633813776,0.2243741242410089
3134,0.3134,6,96,6,273583,332027,11885,96071,3.0755770869613546,0.2244135688557293
3135,0.3135,10,93,10,273676,331934,11895,96061,3.0747156248842122,0.22444421079685511
3136,0.3136,4,90,4,273766,331844,11899,96057,3.073881951906332,0.22448416806691268
3137,0.3137,11,80,11,273846,331764,11910,96046,3.073140909259328,0.2245062060260396
3138,0.3138,4,88,4,273934,331676,11914,96042,3.072325762347623,0.22454514423054442
3139,0.3139,7,88,7,274022,331588,11921,96035,3.071510615435918,0.22457865923956383
3140,0.314,7,95,7,274117,331493,11928,96028,3.0706306272926005,0.2246158668229163
3141,0.3141,6,76,6,274193,331417,11934,96022,3.0699266367779465,0.22464492009386133
3142,0.3142,8,103,8,274296,331314,11942,96014,3.0689725443699283,0.22468455144525984
3143,0.3143,14,92,14,274388,331222,11956,96000,3.0681203453258736,0.22470752910664712
3144,0.3144,10,75,10,274463,331147,11966,95990,3.067425617844307,0.2247288340743134
3145,0.3145,9,86,9,274549,331061,11975,95981,3.0666289969987774,0.22475775216489244
3146,0.3146,10,97,10,274646,330964,11985,95971,3.0657304827892844,0.22479065899961354
3147,0.3147,10,83,10,274729,330881,11995,95961,3.0649616510430175,0.22481620833938554
3148,0.3148,6,83,6,274812,330798,12001,95955,3.0641928192967507,0.22484903445318485
3149,0.3149,7,89,7,274901,330709,12008,95948,3.063368409351958,0.22488322001045336
3150,0.315,9,75,9,274976,330634,12017,95939,3.0626736818703915,0.22490640523427408
3151,0.3151,9,87,9,275063,330547,12026,95930,3.0618677979917743,0.22493592854948802
3152,0.3152,3,96,3,275159,330451,12029,95927,3.0609785468153694,0.2249811200390264
3153,0.3153,9,81,9,275240,330370,12038,95918,3.0602282411352775,0.22500750666216268
3154,0.3154,10,100,10,275340,330270,12048,95908,3.059301937826522,0.2250421185514034
3155,0.3155,6,93,6,275433,330177,12054,95902,3.0584404757493795,0.22508032547954723
3156,0.3156,8,75,8,275508,330102,12062,95894,3.0577457482678128,0.2251054000507047
3157,0.3157,8,84,8,275592,330018,12070,95886,3.0569676534884582,0.22513524174461852
3158,0.3158,7,93,7,275685,329925,12077,95879,3.056106191411316,0.22517167523085738
3159,0.3159,12,92,12,275777,329833,12089,95867,3.055253992367261,0.22519849659384544
3160,0.316,10,89,10,275866,329744,12099,95857,3.0544295824224683,0.22522738433415335
3161,0.3161,7,91,7,275957,329653,12106,95850,3.053586646411501,0.225262806607709
3162,0.3162,8,93,8,276050,329560,12114,95842,3.0527251843343586,0.2252974833216581
3163,0.3163,10,90,10,276140,329470,12124,95832,3.0518915113564784,0.22532694414792312
3164,0.3164,7,88,7,276228,329382,12131,95825,3.0510763644447736,0.2253608242573617
3165,0.3165,10,87,10,276315,329295,12141,95815,3.0502704805661565,0.22538872291877396
3166,0.3166,5,95,5,276410,329200,12146,95810,3.0493904924228388,0.225429989882591
3167,0.3167,11,78,11,276488,329122,12157,95799,3.04866797584201,0.22545131918638994
3168,0.3168,10,79,10,276567,329043,12167,95789,3.047936196228093,0.2254750112985839
3169,0.3169,7,76,7,276643,328967,12174,95782,3.047232205713439,0.22550259094194453
3170,0.317,8,96,8,276739,328871,12182,95774,3.0463429545370335,0.22553897961826938
3171,0.3171,6,90,6,276829,328781,12188,95768,3.045509281559154,0.22557584636873482
3172,0.3172,10,91,10,276920,328690,12198,95758,3.0446663455481864,0.2256059635102533
3173,0.3173,9,91,9,277011,328599,12207,95749,3.043823409537219,0.22563791982052467
3174,0.3174,8,83,8,277094,328516,12215,95741,3.0430545777909517,0.22566746099651863
3175,0.3175,15,88,15,277182,328428,12230,95726,3.0422394308792473,0.22568689674033487
3176,0.3176,10,89,10,277271,328339,12240,95716,3.041415020934455,0.22571600382025916
3177,0.3177,13,85,13,277356,328254,12253,95703,3.0406276631220126,0.22573751583297363
3178,0.3178,10,102,10,277458,328152,12263,95693,3.039682833747082,0.22577357288631458
3179,0.3179,8,79,8,277537,328073,12271,95685,3.0389510541331655,0.22580104682389476
3180,0.318,5,82,5,277619,327991,12276,95680,3.038191485419986,0.22583561301103922
3181,0.3181,13,94,13,277713,327897,12289,95667,3.037320760309756,0.22586197127234608
3182,0.3182,8,86,8,277799,327811,12297,95659,3.036524139464226,0.22589321557607386
3183,0.3183,13,78,13,277877,327733,12310,95646,3.035801622883397,0.22591106313728362
3184,0.3184,7,99,7,277976,327634,12317,95639,3.034884582607729,0.2259511001174183
3185,0.3185,11,100,11,278076,327534,12328,95628,3.0339582792989734,0.22598437477845365
3186,0.3186,6,103,6,278179,327431,12334,95622,3.0330041868909556,0.22602841724322958
3187,0.3187,10,76,10,278255,327355,12344,95612,3.0323001963763017,0.22605073209021034
3188,0.3188,9,85,9,278340,327270,12353,95603,3.0315128385638594,0.22607969768701242
3189,0.3189,8,94,8,278434,327176,12361,95595,3.0306421134536294,0.22611532011419894
3190,0.319,6,70,6,278504,327106,12367,95589,3.0299937011375007,0.22614178071659236
3191,0.3191,7,87,7,278591,327019,12374,95582,3.029187817258883,0.22617551780521106
3192,0.3192,9,81,9,278672,326938,12383,95573,3.028437511578791,0.2262023947305514
3193,0.3193,9,96,9,278768,326842,12392,95564,3.0275482604023862,0.22623731670478164
3194,0.3194,6,91,6,278859,326751,12398,95558,3.026705324391419,0.22627507346516412
3195,0.3195,5,91,5,278950,326660,12403,95553,3.0258623883804514,0.2263146800311691
3196,0.3196,9,91,9,279041,326569,12412,95544,3.025019452369484,0.22634697344076113
3197,0.3197,8,86,8,279127,326483,12420,95536,3.024222831523954,0.22637843319850529
3198,0.3198,4,94,4,279221,326389,12424,95532,3.023352106413724,0.22642153388904557
3199,0.3199,15,124,15,279345,326265,12439,95517,3.022203490310867,0.22646058864531915
3200,0.32,7,99,7,279444,326166,12446,95510,3.0212864500351997,0.22650091539475806
3201,0.3201,7,101,7,279545,326065,12453,95503,3.0203508836933564,0.22654233717929254
3202,0.3202,2,90,2,279635,325975,12455,95501,3.0195172107154766,0.22658704172954094
3203,0.3203,5,86,5,279721,325889,12460,95496,3.018720589869947,0.2266241085942784
3204,0.3204,5,102,5,279823,325787,12465,95491,3.0177757604950166,0.22666979998955558
3205,0.3205,7,101,7,279924,325686,12472,95484,3.0168401941531737,0.22671130422394759
3206,0.3206,8,97,8,280021,325589,12480,95476,3.0159416799436807,0.22674883925284695
3207,0.3207,7,92,7,280113,325497,12487,95469,3.0150894808996256,0.22678553612405752
3208,0.3208,12,90,12,280203,325407,12499,95457,3.014255807921746,0.226811986770073
3209,0.3209,9,112,9,280315,325295,12508,95448,3.01321834821594,0.22685582410164876
3210,0.321,8,75,8,280390,325220,12516,95440,3.012523620734373,0.22688156706128465
3211,0.3211,9,106,9,280496,325114,12525,95431,3.0115417392270927,0.22692220808712504
3212,0.3212,8,71,8,280567,325043,12533,95423,3.010884063877876,0.22694581725989735
3213,0.3213,11,89,11,280656,324954,12544,95412,3.0100596539330837,0.22697363725896005
3214,0.3214,6,82,6,280738,324872,12550,95406,3.0093000852199046,0.22700688591836832
3215,0.3215,11,102,11,280840,324770,12561,95395,3.008355255844974,0.22704175740482904
3216,0.3216,5,84,5,280924,324686,12566,95390,3.0075771610656195,0.2270779573220084
3217,0.3217,6,81,6,281005,324605,12572,95384,3.0068268553855275,0.22711071004240588
3218,0.3218,10,91,10,281096,324514,12582,95374,3.00598391937456,0.22714152345387342
3219,0.3219,9,81,9,281177,324433,12591,95365,3.005233613694468,0.22716878117570832
3220,0.322,14,72,14,281249,324361,12605,95351,3.004566675312164,0.227181972400122
3221,0.3221,7,87,7,281336,324274,12612,95344,3.003760791433547,0.22721618233726865
3222,0.3222,9,81,9,281417,324193,12621,95335,3.003010485753455,0.22724347361797068
3223,0.3223,7,88,7,281505,324105,12628,95328,3.00219533884175,0.2272782542146183
3224,0.3224,7,85,7,281590,324020,12635,95321,3.0014079810293084,0.22731142435392676
3225,0.3225,12,90,12,281680,323930,12647,95309,3.000574308051428,0.2273381054720577
3226,0.3226,11,95,11,281775,323835,12658,95298,2.9996943199081105,0.227369355312037
3227,0.3227,6,86,6,281861,323749,12664,95292,2.998897699062581,0.22740495560100324
3228,0.3228,4,85,4,281946,323664,12668,95288,2.998110341250139,0.22744371670262942
3229,0.3229,8,78,8,282024,323586,12676,95280,2.9973878246693095,0.22747131540874646
3230,0.323,11,89,11,282113,323497,12687,95269,2.9965634147245175,0.22749936718835817
3231,0.3231,12,91,12,282204,323406,12699,95257,2.99572047871355,0.22752667419857978
3232,0.3232,5,99,5,282303,323307,12704,95252,2.994803438437882,0.22757126235488903
3233,0.3233,5,108,5,282411,323199,12709,95247,2.9938030308644263,0.22762076827117478
3234,0.3234,5,90,5,282501,323109,12714,95242,2.992969357886546,0.22766050517388509
3235,0.3235,8,84,8,282585,323025,12722,95234,2.9921912631071916,0.2276914543381015
3236,0.3236,13,88,13,282673,322937,12735,95221,2.9913761161954873,0.22771536117926716
3237,0.3237,11,93,11,282766,322844,12746,95210,2.9905146541183445,0.2277456979241916
3238,0.3238,10,101,10,282867,322743,12756,95200,2.9895790877765016,0.22778225738916552
3239,0.3239,5,84,5,282951,322659,12761,95195,2.988800992997147,0.2278188075260737
3240,0.324,11,93,11,283044,322566,12772,95184,2.9879395309200043,0.2278491921005386
3241,0.3241,8,87,8,283131,322479,12780,95176,2.987133647041387,0.22788186421807471
3242,0.3242,2,94,2,283225,322385,12782,95174,2.986262921931157,0.22792946625506816
3243,0.3243,7,103,7,283328,322282,12789,95167,2.985308829523139,0.22797275834892405
3244,0.3244,14,92,14,283420,322190,12803,95153,2.9844566304790843,0.2279971150827976
3245,0.3245,2,81,2,283501,322109,12805,95151,2.9837063247989923,0.22803767435172315
3246,0.3246,6,92,6,283593,322017,12811,95145,2.9828541257549372,0.2280768622261855
3247,0.3247,11,91,11,283684,321926,12822,95134,2.98201118974397,0.22810626768330697
3248,0.3248,5,81,5,283765,321845,12827,95129,2.981260884063878,0.22814132296018458
3249,0.3249,8,110,8,283875,321735,12835,95121,2.9802419504242468,0.22818671195808624
3250,0.325,8,78,8,283953,321657,12843,95113,2.979519433843418,0.22821460277851094
3251,0.3251,6,100,6,284053,321557,12849,95107,2.9785931305346622,0.22825826085286946
3252,0.3252,6,76,6,284129,321481,12855,95101,2.9778891400200083,0.22828878828177887
3253,0.3253,8,87,8,284216,321394,12863,95093,2.977083256141391,0.22832165229647025
3254,0.3254,12,83,12,284299,321311,12875,95081,2.976314424395124,0.22834492497454323
3255,0.3255,5,100,5,284399,321211,12880,95076,2.9753881210863686,0.2283905094321946
3256,0.3256,6,102,6,284501,321109,12886,95070,2.974443291711438,0.22843536074621737
3257,0.3257,12,72,12,284573,321037,12898,95058,2.973776353329134,0.22845263701798868
3258,0.3258,11,84,11,284657,320953,12909,95047,2.9729982585497794,0.22847836538461538
3259,0.3259,7,109,7,284766,320844,12916,95040,2.971988587943236,0.22852526185186253
3260,0.326,6,108,6,284874,320736,12922,95034,2.97098818036978,0.22857349015080453
3261,0.3261,7,98,7,284972,320638,12929,95027,2.9700804031272,0.22861438899113468
3262,0.3262,9,104,9,285076,320534,12938,95018,2.9691170476860944,0.2286548975820114
3263,0.3263,10,86,10,285162,320448,12948,95008,2.9683204268405645,0.22868366325194486
3264,0.3264,7,109,7,285271,320339,12955,95001,2.967310756234021,0.22873067848028122
3265,0.3265,10,116,10,285387,320223,12965,94991,2.966236244395865,0.22877600466265588
3266,0.3266,10,89,10,285476,320134,12975,94981,2.9654118344510727,0.22880647531406959
3267,0.3267,9,85,9,285561,320049,12984,94972,2.9646244766386305,0.2288366130870486
3268,0.3268,9,108,9,285669,319941,12993,94963,2.9636240690651747,0.2288794516321848
3269,0.3269,11,99,11,285768,319842,13004,94952,2.9627070287895068,0.22891362941604748
3270,0.327,14,95,14,285863,319747,13018,94938,2.961827040646189,0.22894003882465003
3271,0.3271,9,85,9,285948,319662,13027,94929,2.9610396828337473,0.2289702381383098
3272,0.3272,16,90,16,286038,319572,13043,94913,2.960206009855867,0.22899019264870865
3273,0.3273,10,97,10,286135,319475,13053,94903,2.9593074956463745,0.2290251895612219
3274,0.3274,13,93,13,286228,319382,13066,94890,2.9584460335692317,0.22905241001081414
3275,0.3275,3,95,3,286323,319287,13069,94887,2.957566045425914,0.2290993640354054
3276,0.3276,5,102,5,286425,319185,13074,94882,2.956621216050984,0.2291464907853077
3277,0.3277,6,93,6,286518,319092,13080,94876,2.955759753973841,0.22918679704711475
3278,0.3278,14,93,14,286611,318999,13094,94862,2.954898291896699,0.22921222342767258
3279,0.3279,7,76,7,286687,318923,13101,94855,2.9541943013820444,0.2292412839735317
3280,0.328,8,90,8,286777,318833,13109,94847,2.9533606284041647,0.22927625217559466
3281,0.3281,9,107,9,286884,318726,13118,94838,2.952369483863796,0.2293187995086613
3282,0.3282,9,86,9,286970,318640,13127,94829,2.9515728630182667,0.22934972150270033
3283,0.3283,8,105,8,287075,318535,13135,94821,2.9506002445440735,0.22939306554156708
3284,0.3284,12,77,12,287152,318458,13147,94809,2.949886990996332,0.2294134300585336
3285,0.3285,16,88,16,287240,318370,13163,94793,2.949071844084627,0.22943245159900572
3286,0.3286,10,91,10,287331,318279,13173,94783,2.9482289080736597,0.22946434191477308
3287,0.3287,9,86,9,287417,318193,13182,94774,2.9474322872281298,0.22949533497833968
3288,0.3288,4,89,4,287506,318104,13186,94770,2.9466078772833377,0.2295373406898957
3289,0.3289,10,100,10,287606,318004,13196,94760,2.945681573974582,0.22957428457908152
3290,0.329,13,86,13,287692,317918,13209,94747,2.9448849531290526,0.22959785782656633
3291,0.3291,10,99,10,287791,317819,13219,94737,2.9439679128533847,0.22963427995229738
3292,0.3292,8,104,8,287895,317715,13227,94729,2.943004557412279,0.22967724103150974
3293,0.3293,10,78,10,287973,317637,13237,94719,2.94228204083145,0.22970200506358585
3294,0.3294,7,102,7,288075,317535,13244,94712,2.9413372114565193,0.22974575921716836
3295,0.3295,8,76,8,288151,317459,13252,94704,2.9406332209418653,0.22977317226437113
3296,0.3296,8,92,8,288243,317367,13260,94696,2.93978102189781,0.22980951941814723
3297,0.3297,1,80,1,288323,317287,13261,94695,2.939039979250806,0.22985227509939754
3298,0.3298,6,99,6,288422,317188,13267,94689,2.938122938975138,0.229896303993668
3299,0.3299,12,75,12,288497,317113,13279,94677,2.9374282114935713,0.22991573374778407
3300,0.33,9,101,9,288598,317012,13288,94668,2.9364926451517284,0.22995530509133308
3301,0.3301,9,93,9,288691,316919,13297,94659,2.935631183074586,0.2299904270879396
3302,0.3302,11,99,11,288790,316820,13308,94648,2.934714142798918,0.23002517814265022
3303,0.3303,6,72,6,288862,316748,13314,94642,2.9340472044166144,0.2300542064707455
3304,0.3304,11,95,11,288957,316653,13325,94631,2.9331672162732967,0.23008675270615925
3305,0.3305,4,95,4,289052,316558,13329,94627,2.932287228129979,0.23013242214574947
3306,0.3306,10,90,10,289142,316468,13339,94617,2.931453555152099,0.23016407798873711
3307,0.3307,5,94,5,289236,316374,13344,94612,2.930582830041869,0.23020735499506065
3308,0.3308,5,97,5,289333,316277,13349,94607,2.929684315832376,0.23025233399207562
3309,0.3309,10,90,10,289423,316187,13359,94597,2.9288506428544965,0.2302840422217029
3310,0.331,8,90,8,289513,316097,13367,94589,2.9280169698766163,0.2303195141787156
3311,0.3311,10,105,10,289618,315992,13377,94579,2.927044351402423,0.2303596698256818
3312,0.3312,12,91,12,289709,315901,13389,94567,2.9262014153914557,0.23038823976534104
3313,0.3313,12,104,12,289813,315797,13401,94555,2.9252380599503502,0.23042412367918275
3314,0.3314,11,83,11,289896,315714,13412,94544,2.924469228204083,0.23045010700583535
3315,0.3315,3,106,3,290002,315608,13415,94541,2.9234873466968025,0.23050403633801375
3316,0.3316,9,109,9,290111,315499,13424,94532,2.922477676090259,0.23054842194858438
3317,0.3317,11,82,11,290193,315417,13435,94521,2.9217181073770795,0.23057389166166592
3318,0.3318,11,76,11,290269,315341,13446,94510,2.9210141168624255,0.23059599708186634
3319,0.3319,7,93,7,290362,315248,13453,94503,2.9201526547852827,0.23063519064016927
3320,0.332,4,99,4,290461,315149,13457,94499,2.919235614509615,0.2306834160059368
3321,0.3321,8,86,8,290547,315063,13465,94491,2.9184389936640853,0.2307168285500813
3322,0.3322,4,80,4,290627,314983,13469,94487,2.917697951017081,0.23075438982098812
3323,0.3323,9,87,9,290714,314896,13478,94478,2.916892067138464,0.23078651795179958
3324,0.3324,8,82,8,290796,314814,13486,94470,2.9161324984252843,0.2308177207024951
3325,0.3325,5,84,5,290880,314730,13491,94465,2.91535440364593,0.2308557044929679
3326,0.3326,9,69,9,290949,314661,13500,94456,2.9147152543628887,0.23087771957655145
3327,0.3327,11,80,11,291029,314581,13511,94445,2.9139742117158844,0.23090219203669204
3328,0.3328,6,88,6,291117,314493,13517,94439,2.9131590648041796,0.23094059648058846
3329,0.3329,7,93,7,291210,314400,13524,94432,2.912297602727037,0.23097996242955543
3330,0.333,10,98,10,291308,314302,13534,94422,2.9113898254844566,0.2310165294917842
3331,0.3331,9,104,9,291412,314198,13543,94413,2.910426470043351,0.23105839049854263
3332,0.3332,5,112,5,291524,314086,13548,94408,2.909389010337545,0.2311123296792609
3333,0.3333,7,111,7,291635,313975,13555,94401,2.9083608136648262,0.23116196838207925
3334,0.3334,18,102,18,291737,313873,13573,94383,2.9074159842898957,0.23118582458065529
3335,0.3335,12,92,12,291829,313781,13585,94371,2.906563785245841,0.2312153315431506
3336,0.3336,9,98,9,291927,313683,13594,94362,2.9056560080032607,0.23125390581921113
3337,0.3337,12,85,12,292012,313598,13606,94350,2.9048686501908185,0.23127947679606226
3338,0.3338,11,77,11,292089,313521,13617,94339,2.904155396643077,0.23130240768891286
3339,0.3339,13,76,13,292165,313445,13630,94326,2.903451406128423,0.23132101105767697
3340,0.334,8,72,8,292237,313373,13638,94318,2.9027844677461188,0.23134677979155782
3341,0.3341,14,96,14,292333,313277,13652,94304,2.9018952165697134,0.23137486781768532
3342,0.3342,10,82,10,292415,313195,13662,94294,2.901135647856534,0.2314025654680249
3343,0.3343,6,91,6,292506,313104,13668,94288,2.900292711845567,0.2314429345691619
3344,0.3344,8,77,8,292583,313027,13676,94280,2.899579458297825,0.23147159268070522
3345,0.3345,6,107,6,292690,312920,13682,94274,2.8985883137574566,0.23152109313987926
3346,0.3346,3,111,3,292801,312809,13685,94271,2.8975601170847383,0.23157855949690478
3347,0.3347,18,92,18,292893,312717,13703,94253,2.896707918040683,0.23159692360616263
3348,0.3348,12,85,12,292978,312632,13715,94241,2.895920560228241,0.23162264392083035
3349,0.3349,6,97,6,293075,312535,13721,94235,2.8950220460187484,0.23166654374708065
3350,0.335,8,84,8,293159,312451,13729,94227,2.894243951239394,0.2316992805118546
3351,0.3351,13,94,13,293253,312357,13742,94214,2.893373226129164,0.231728283620819
3352,0.3352,10,82,10,293335,312275,13752,94204,2.892613657415984,0.2317561300829809
3353,0.3353,11,96,11,293431,312179,13763,94193,2.8917244062395793,0.23179008396247772
3354,0.3354,7,88,7,293519,312091,13770,94186,2.8909092593278745,0.23182705395579864
3355,0.3355,6,100,6,293619,311991,13776,94180,2.889982956019119,0.23187278264573297
3356,0.3356,9,79,9,293698,311912,13785,94171,2.8892511764052022,0.2319008675566325
3357,0.3357,8,84,8,293782,311828,13793,94163,2.8884730816258477,0.23193371281629396
3358,0.3358,9,87,9,293869,311741,13802,94154,2.8876671977472306,0.2319663952500031
3359,0.3359,8,94,8,293963,311647,13810,94146,2.886796472637,0.23200498776469777
3360,0.336,13,80,13,294043,311567,13823,94133,2.886055429989996,0.23202612768055214
3361,0.3361,10,84,10,294127,311483,13833,94123,2.8852773352106413,0.23205524573107894
3362,0.3362,6,90,6,294217,311393,13839,94117,2.8844436622327616,0.23209538605706395
3363,0.3363,3,83,3,294300,311310,13842,94114,2.8836748304864943,0.23213721930620781
3364,0.3364,7,74,7,294374,311236,13849,94107,2.8829893660380157,0.2321663381383174
3365,0.3365,11,66,11,294440,311170,13860,94096,2.8823780058542368,0.23218330676642007
3366,0.3366,9,108,9,294548,311062,13869,94087,2.881377598280781,0.2322281432263192
3367,0.3367,10,83,10,294631,310979,13879,94077,2.880608766534514,0.2322567743719387
3368,0.3368,9,80,9,294711,310899,13888,94068,2.87986772388751,0.23228559364096335
3369,0.3369,9,89,9,294800,310810,13897,94059,2.8790433139427174,0.23231958979324177
3370,0.337,12,100,12,294900,310710,13909,94047,2.878117010633962,0.23235422735122555
3371,0.3371,10,87,10,294987,310623,13919,94037,2.8773111267553446,0.23238521227697326
3372,0.3372,10,84,10,295071,310539,13929,94027,2.87653303197599,0.23241448861248845
3373,0.3373,7,88,7,295159,310451,13936,94020,2.8757178850642853,0.23245177033705755
3374,0.3374,8,91,8,295250,310360,13944,94012,2.874874949053318,0.23248889636275508
3375,0.3375,9,81,9,295331,310279,13953,94003,2.874124643373226,0.2325183906283238
3376,0.3376,6,86,6,295417,310193,13959,93997,2.8733280225276965,0.2325564709666246
3377,0.3377,14,82,14,295499,310111,13973,93983,2.872568453814517,0.23257707365118016
3378,0.3378,5,97,5,295596,310014,13978,93978,2.8716699396050243,0.2326234182855106
3379,0.3379,7,80,7,295676,309934,13985,93971,2.87092889695802,0.23265619390698308
3380,0.338,8,101,8,295777,309833,13993,93963,2.869993330616177,0.2326991847368473
3381,0.3381,9,97,9,295874,309736,14002,93954,2.869094816406684,0.23273799202358245
3382,0.3382,11,93,11,295967,309643,14013,93943,2.8682333543295417,0.2327707105796534
3383,0.3383,13,92,13,296059,309551,14026,93930,2.8673811552854866,0.23279906612702952
3384,0.3384,8,85,8,296144,309466,14034,93922,2.8665937974730444,0.23283290529217526
3385,0.3385,9,99,9,296243,309367,14043,93913,2.865676757197377,0.23287294187661178
3386,0.3386,7,67,7,296310,309300,14050,93906,2.8650561339805107,0.2328983199654767
3387,0.3387,11,87,11,296397,309213,14061,93895,2.864250250101893,0.23292765214285005
3388,0.3388,9,73,9,296470,309140,14070,93886,2.863574048686502,0.23295271272821108
3389,0.3389,9,85,9,296555,309055,14079,93877,2.86278669087406,0.2329847219878292
3390,0.339,5,85,5,296640,308970,14084,93872,2.861999333061618,0.23302436190863912
3391,0.3391,14,98,14,296738,308872,14098,93858,2.8610915558190375,0.2330544036947831
3392,0.3392,9,74,9,296812,308798,14107,93849,2.8604060913705585,0.2330800924879609
3393,0.3393,9,78,9,296890,308720,14116,93840,2.859683574789729,0.23310810810810811
3394,0.3394,9,79,9,296969,308641,14125,93831,2.8589517951758125,0.23313671510067782
3395,0.3395,8,85,8,297054,308556,14133,93823,2.8581644373633703,0.23317071715969273
3396,0.3396,9,94,9,297148,308462,14142,93814,2.8572937122531403,0.23320804621702512
3397,0.3397,7,92,7,297240,308370,14149,93807,2.8564415132090852,0.23324804750147324
3398,0.3398,12,84,12,297324,308286,14161,93795,2.8556634184297307,0.23327389257388437
3399,0.3399,10,85,10,297409,308201,14171,93785,2.8548760606172885,0.23330414492046986
3400,0.34,7,90,7,297499,308111,14178,93778,2.8540423876394088,0.23334303750538085
3401,0.3401,14,86,14,297585,308025,14192,93764,2.853245766793879,0.23336626936028612
3402,0.3402,6,102,6,297687,307923,14198,93758,2.8523009374189483,0.23341407733997874
3403,0.3403,6,87,6,297774,307836,14204,93752,2.851495053540331,0.23345319083239538
3404,0.3404,7,108,7,297882,307728,14211,93745,2.8504946459668754,0.23350262657762788
3405,0.3405,11,96,11,297978,307632,14222,93734,2.84960539479047,0.23353746954151572
3406,0.3406,6,88,6,298066,307544,14228,93728,2.8487902478787652,0.23357722442632428
3407,0.3407,6,97,6,298163,307447,14234,93722,2.8478917336692726,0.2336222390065035
3408,0.3408,9,94,9,298257,307353,14243,93713,2.8470210085590426,0.23365979664194922
3409,0.3409,3,101,3,298358,307252,14246,93710,2.8460854422171997,0.23371292042637457
3410,0.341,10,97,10,298455,307155,14256,93700,2.8451869280077067,0.23375035860847437
3411,0.3411,12,83,12,298538,307072,14268,93688,2.84441809626144,0.23377582593073162
3412,0.3412,9,76,9,298614,306996,14277,93679,2.843714105746786,0.2338029575092032
3413,0.3413,13,98,13,298712,306898,14290,93666,2.8428063285042056,0.2338352922379445
3414,0.3414,10,88,10,298800,306810,14300,93656,2.8419911815925007,0.23386754431087783
3415,0.3415,12,86,12,298886,306724,14312,93644,2.841194560746971,0.2338948167685729
3416,0.3416,11,84,11,298970,306640,14323,93633,2.8404164659676163,0.23392284765647445
3417,0.3417,7,101,7,299071,306539,14330,93626,2.8394808996257734,0.23396848799870054
3418,0.3418,9,83,9,299154,306456,14339,93617,2.8387120678795066,0.23399979503740567
3419,0.3419,10,85,10,299239,306371,14349,93607,2.8379247100670644,0.23403037167044188
3420,0.342,5,97,5,299336,306274,14354,93602,2.8370261958575718,0.23407756404485391
3421,0.3421,8,85,8,299421,306189,14362,93594,2.8362388380451296,0.2341120057631265
3422,0.3422,6,86,6,299507,306103,14368,93588,2.8354422171995997,0.234150881556002
3423,0.3423,9,87,9,299594,306016,14377,93579,2.8346363333209825,0.23418461191956857
3424,0.3424,12,105,12,299699,305911,14389,93567,2.8336637148467894,0.23422316122539916
3425,0.3425,8,101,8,299800,305810,14397,93559,2.8327281485049465,0.23426705628128372
3426,0.3426,10,96,10,299896,305714,14407,93549,2.831838897328541,0.23430420549863124
3427,0.3427,6,80,6,299976,305634,14413,93543,2.831097854681537,0.23433965383777122
3428,0.3428,13,71,13,300047,305563,14426,93530,2.8304401793323204,0.2343564031441293
3429,0.3429,3,101,3,300148,305462,14429,93527,2.8295046129904775,0.2344099712022136
3430,0.343,7,90,7,300238,305372,14436,93520,2.828670940012598,0.23444942490699236
3431,0.3431,10,101,10,300339,305271,14446,93510,2.827735373670755,0.23448960707756888
3432,0.3432,12,92,12,300431,305179,14458,93498,2.8268831746267,0.23452067713963937
3433,0.3433,6,99,6,300530,305080,14464,93492,2.825966134351032,0.2345674056381281
3434,0.3434,3,85,3,300615,304995,14467,93489,2.8251787765385896,0.2346116782606077
3435,0.3435,6,79,6,300694,304916,14473,93483,2.824446996924673,0.23464667330992298
3436,0.3436,17,101,17,300795,304815,14490,93466,2.82351143058283,0.2346735094066752
3437,0.3437,9,86,9,300881,304729,14499,93457,2.8227148097373003,0.2347068957723275
3438,0.3438,16,104,16,300985,304625,14515,93441,2.821751454296195,0.23473745559781545
3439,0.3439,12,101,12,301086,304524,14527,93429,2.820815887954352,0.23477395571838885
3440,0.344,6,77,6,301163,304447,14533,93423,2.8201026344066102,0.234807851810893
3441,0.3441,8,83,8,301246,304364,14541,93415,2.819333802660343,0.23484145719105332
3442,0.3442,12,104,12,301350,304260,14553,93403,2.8183704472192375,0.23487978514470795
3443,0.3443,14,85,14,301435,304175,14567,93389,2.8175830894067952,0.234903059633166
3444,0.3444,8,94,8,301529,304081,14575,93381,2.8167123642965652,0.23494321469725407
3445,0.3445,11,81,11,301610,304000,14586,93370,2.8159620586164733,0.23496992727181215
3446,0.3446,11,90,11,301700,303910,14597,93359,2.8151283856385936,0.23500197599107908
3447,0.3447,12,94,12,301794,303816,14609,93347,2.8142576605283636,0.2350344820640392
3448,0.3448,10,78,10,301872,303738,14619,93337,2.8135351439475342,0.23506138638796198
3449,0.3449,11,90,11,301962,303648,14630,93326,2.8127014709696545,0.23509348219278844
3450,0.345,9,77,9,302039,303571,14639,93317,2.811988217421913,0.2351217471931628
3451,0.3451,8,88,8,302127,303483,14647,93309,2.811173070510208,0.23515847093691405
3452,0.3452,8,96,8,302223,303387,14655,93301,2.8102838193338027,0.23519995563263824
3453,0.3453,9,104,9,302327,303283,14664,93292,2.809320463892697,0.23524427914013743
3454,0.3454,6,95,6,302422,303188,14670,93286,2.8084404757493795,0.23528907318008244
3455,0.3455,10,76,10,302498,303112,14680,93276,2.807736485234725,0.23531489348819842
3456,0.3456,6,91,6,302589,303021,14686,93270,2.8068935492237577,0.23535735103749517
3457,0.3457,2,79,2,302668,302942,14688,93268,2.806161769609841,0.23540041896973826
3458,0.3458,5,98,5,302766,302844,14693,93263,2.805253992367261,0.23544900746515462
3459,0.3459,6,77,6,302843,302767,14699,93257,2.804540738819519,0.2354832030381997
3460,0.346,15,86,15,302929,302681,14714,93242,2.8037441179739893,0.23550538867406037
3461,0.3461,12,84,12,303013,302597,14726,93230,2.8029660231946347,0.23553218956766467
3462,0.3462,10,94,10,303107,302503,14736,93220,2.8020952980844047,0.23556881960361162
3463,0.3463,8,78,8,303185,302425,14744,93212,2.8013727815035754,0.2355998048716374
3464,0.3464,13,94,13,303279,302331,14757,93199,2.8005020563933454,0.23563067276818447
3465,0.3465,5,82,5,303361,302249,14762,93194,2.799742487680166,0.2356698689823818
3466,0.3466,10,87,10,303448,302162,14772,93184,2.7989366038015486,0.2357023973936754
3467,0.3467,10,95,10,303543,302067,14782,93174,2.798056615658231,0.2357397132382521
3468,0.3468,5,85,5,303628,301982,14787,93169,2.797269257845789,0.2357807521681585
3469,0.3469,8,94,8,303722,301888,14795,93161,2.7963985327355587,0.23582137912005852
3470,0.347,6,82,6,303804,301806,14801,93155,2.7956389640223795,0.23585873035565535
3471,0.3471,11,89,11,303893,301717,14812,93144,2.794814554077587,0.23589060454185143
3472,0.3472,10,97,10,303990,301620,14822,93134,2.7939160398680944,0.23592921161026867
3473,0.3473,12,91,12,304081,301529,14834,93122,2.793073103857127,0.2359603801840107
3474,0.3474,8,87,8,304168,301442,14842,93114,2.79226721997851,0.2359969180547248
3475,0.3475,10,91,10,304259,301351,14852,93104,2.7914242839675425,0.23603199351003282
3476,0.3476,9,68,9,304327,301283,14861,93095,2.7907943977175886,0.23605525663196222
3477,0.3477,9,78,9,304405,301205,14870,93086,2.7900718811367593,0.23608451625829655
3478,0.3478,13,86,13,304491,301119,14883,93073,2.78927526029123,0.2361108292405731
3479,0.3479,7,85,7,304576,301034,14890,93066,2.7884879024787876,0.23614818573965998
3480,0.348,5,101,5,304677,300933,14895,93061,2.7875523361369448,0.23619902841160018
3481,0.3481,10,80,10,304757,300853,14905,93051,2.7868112934899405,0.23622760875746374
3482,0.3482,12,94,12,304851,300759,14917,93039,2.78594056837971,0.2362607225023997
3483,0.3483,11,82,11,304933,300677,14928,93028,2.785180999666531,0.23628859171206867
3484,0.3484,8,89,8,305022,300588,14936,93020,2.7843565897217384,0.23632649742891404
3485,0.3485,9,73,9,305095,300515,14945,93011,2.783680388306347,0.23635287122070714
3486,0.3486,9,110,9,305205,300405,14954,93002,2.782661454666716,0.2364014875180157
3487,0.3487,3,98,3,305303,300307,14957,92999,2.7817536774241356,0.2364545671817872
3488,0.3488,6,82,6,305385,300225,14963,92993,2.7809941087109564,0.23649222568651487
3489,0.3489,6,74,6,305459,300151,14969,92987,2.7803086442624774,0.23652508788262647
3490,0.349,9,84,9,305543,300067,14978,92978,2.779530549483123,0.23655815491864798
3491,0.3491,12,74,12,305617,299993,14990,92966,2.778845085034644,0.23657938868940526
3492,0.3492,8,85,8,305702,299908,14998,92958,2.7780577272222016,0.23661502904298157
3493,0.3493,8,99,8,305801,299809,15006,92950,2.7771406869465336,0.23665912175150666
3494,0.3494,4,107,4,305908,299702,15010,92946,2.7761495424061655,0.23671583708563396
3495,0.3495,11,75,11,305983,299627,15021,92935,2.775454814924599,0.23673967424254003
3496,0.3496,7,88,7,306071,299539,15028,92928,2.774639668012894,0.23677914321458873
3497,0.3497,12,95,12,306166,299444,15040,92916,2.7737596798695763,0.2368131307982465
3498,0.3498,7,89,7,306255,299355,15047,92909,2.7729352699247842,0.2368532416943691
3499,0.3499,10,96,10,306351,299259,15057,92899,2.772046018748379,0.23689176301388726
3500,0.35,10,82,10,306433,299177,15067,92889,2.7712864500351997,0.23692184479143819
3501,0.3501,6,87,6,306520,299090,15073,92883,2.770480566156582,0.23696274998533062
3502,0.3502,6,74,6,306594,299016,15079,92877,2.7697951017081035,0.2369958126325298
3503,0.3503,14,98,14,306692,298918,15093,92863,2.7688873244655228,0.23702782932301464
3504,0.3504,16,89,16,306781,298829,15109,92847,2.7680629145207307,0.23705052134927848
3505,0.3505,12,97,12,306878,298732,15121,92835,2.767164400311238,0.2370858627003808
3506,0.3506,8,87,8,306965,298645,15129,92827,2.7663585164326205,0.2371229615400335
3507,0.3507,6,78,6,307043,298567,15135,92821,2.7656359998517916,0.2371585230001942
3508,0.3508,5,97,5,307140,298470,15140,92816,2.7647374856422986,0.2372075668436898
3509,0.3509,11,86,11,307226,298384,15151,92805,2.763940864796769,0.23723826590215982
3510,0.351,7,97,7,307323,298287,15158,92798,2.763042350587276,0.23728345500338802
3511,0.3511,9,85,9,307408,298202,15167,92789,2.7622549927748343,0.2373174830111179
3512,0.3512,13,94,13,307502,298108,15180,92776,2.7613842676646043,0.2373491879943922
3513,0.3513,12,94,12,307596,298014,15192,92764,2.760513542554374,0.23738286188065857
3514,0.3514,13,78,13,307674,297936,15205,92751,2.759791025973545,0.23740487909758964
3515,0.3515,9,88,9,307762,297848,15214,92742,2.75897587906184,0.23744079469520468
3516,0.3516,7,75,7,307837,297773,15221,92735,2.7582811515802734,0.23747272783144008
3517,0.3517,9,91,9,307928,297682,15230,92726,2.757438215569306,0.23751050183397882
3518,0.3518,15,90,15,308018,297592,15245,92711,2.7566045425914263,0.2375359656472023
3519,0.3519,10,98,10,308116,297494,15255,92701,2.755696765348846,0.2375760837529953
3520,0.352,8,84,8,308200,297410,15263,92693,2.7549186705694915,0.23761160514018093
3521,0.3521,7,86,7,308286,297324,15270,92686,2.7541220497239616,0.23765031665854722
3522,0.3522,14,82,14,308368,297242,15284,92672,2.753362481010782,0.2376729227470673
3523,0.3523,19,99,19,308467,297143,15303,92653,2.7524454407351144,0.23769612823117733
3524,0.3524,9,94,9,308561,297049,15312,92644,2.7515747156248844,0.23773585874008515
3525,0.3525,7,90,7,308651,296959,15319,92637,2.7507410426470043,0.23777708190022484
3526,0.3526,10,78,10,308729,296881,15329,92627,2.750018526066175,0.2378051285211087
3527,0.3527,13,87,13,308816,296794,15342,92614,2.749212642187558,0.2378328128852001
3528,0.3528,8,87,8,308903,296707,15350,92606,2.7484067583089407,0.23787029973311963
3529,0.3529,5,84,5,308987,296623,15355,92601,2.747628663529586,0.23791184510718763
3530,0.353,9,70,9,309057,296553,15364,92592,2.7469802512134573,0.2379370157653317
3531,0.3531,6,86,6,309143,296467,15370,92586,2.7461836303679275,0.23797785905776334
3532,0.3532,7,77,7,309220,296390,15377,92579,2.745470376820186,0.2380112553956742
3533,0.3533,12,85,12,309305,296305,15389,92567,2.744683019007744,0.2380397662984221
3534,0.3534,11,99,11,309404,296206,15400,92556,2.743765978732076,0.23807882457647608
3535,0.3535,10,94,10,309498,296112,15410,92546,2.742895253621846,0.23811680191839613
3536,0.3536,9,94,9,309592,296018,15419,92537,2.742024528511616,0.23815676030420405
3537,0.3537,6,83,6,309675,295935,15425,92531,2.7412556967653487,0.23819587814635002
3538,0.3538,11,83,11,309758,295852,15436,92520,2.740486865019082,0.23822520676052855
3539,0.3539,9,85,9,309843,295767,15445,92511,2.7396995072066397,0.23825970052385148
3540,0.354,11,85,11,309928,295682,15456,92500,2.7389121493941975,0.2382902865150883
3541,0.3541,13,89,13,310017,295593,15469,92487,2.7380877394494054,0.23831941867656153
3542,0.3542,9,92,9,310109,295501,15478,92478,2.7372355404053503,0.23835826165849183
3543,0.3543,10,99,10,310208,295402,15488,92468,2.7363185001296824,0.23839946373785031
3544,0.3544,6,92,6,310300,295310,15494,92462,2.7354663010856273,0.23844424042994336
3545,0.3545,7,89,7,310389,295221,15501,92455,2.7346418911408352,0.238485229934275
3546,0.3546,10,97,10,310486,295124,15511,92445,2.7337433769313426,0.23852526904886615
3547,0.3547,6,78,6,310564,295046,15517,92439,2.7330208603505133,0.23856149270294333
3548,0.3548,7,96,7,310660,294950,15524,92432,2.732131609174108,0.23860685318367916
3549,0.3549,10,94,10,310754,294856,15534,92422,2.731260884063878,0.2386451076487691
3550,0.355,8,71,8,310825,294785,15542,92414,2.7306032087146614,0.23867313706905235
3551,0.3551,11,90,11,310915,294695,15553,92403,2.7297695357367817,0.2387069940945187
3552,0.3552,15,80,15,310995,294615,15568,92388,2.7290284930897775,0.23872683157494903
3553,0.3553,8,73,8,311068,294542,15576,92380,2.7283522916743856,0.23875613172680799
3554,0.3554,9,95,9,311163,294447,15585,92371,2.7274723035310684,0.23879705701389284
3555,0.3555,8,82,8,311245,294365,15593,92363,2.726712734817889,0.23883194389855403
3556,0.3556,7,91,7,311336,294274,15600,92356,2.7258697988069214,0.23887437601841555
3557,0.3557,7,83,7,311419,294191,15607,92349,2.7251009670606545,0.23891188492782117
3558,0.3558,7,95,7,311514,294096,15614,92342,2.724220978917337,0.2389568313675156
3559,0.3559,9,83,9,311597,294013,15623,92333,2.7234521471710695,0.23899043862237476
3560,0.356,5,84,5,311681,293929,15628,92328,2.722674052391715,0.23903256122219144
3561,0.3561,7,86,7,311767,293843,15635,92321,2.7218774315461856,0.2390720004971981
3562,0.3562,10,89,10,311856,293754,15645,92311,2.721053021601393,0.23910740419359433
3563,0.3563,8,78,8,311934,293676,15653,92303,2.7203305050205637,0.23913995320988965
3564,0.3564,11,75,11,312009,293601,15664,92292,2.7196357775389974,0.23916474255817027
3565,0.3565,13,93,13,312102,293508,15677,92279,2.7187743154618547,0.23919675883324218
3566,0.3566,11,82,11,312184,293426,15688,92268,2.7180147467486755,0.23922591484441033
3567,0.3567,9,88,9,312272,293338,15697,92259,2.7171995998369707,0.23926275360026142
3568,0.3568,11,88,11,312360,293250,15708,92248,2.716384452925266,0.23929566430954247
3569,0.3569,9,78,9,312438,293172,15717,92239,2.7156619363444365,0.2393263295546832
3570,0.357,8,76,8,312514,293096,15725,92231,2.7149579458297826,0.23935774030888052
3571,0.3571,8,76,8,312590,293020,15733,92223,2.7142539553151286,0.2393891647609431
3572,0.3572,11,97,11,312687,292923,15744,92212,2.7133554411056355,0.23942773313253793
3573,0.3573,5,82,5,312769,292841,15749,92207,2.7125958723924564,0.2394688454426461
3574,0.3574,13,90,13,312859,292751,15762,92194,2.711762199414576,0.23949914922911064
3575,0.3575,5,83,5,312942,292668,15767,92189,2.7109933676683093,0.23954092039380862
3576,0.3576,14,80,14,313022,292588,15781,92175,2.710252325021305,0.23956305569922265
3577,0.3577,6,88,6,313110,292500,15787,92169,2.7094371781096003,0.23960599892375004
3578,0.3578,10,93,10,313203,292407,15797,92159,2.7085757160324575,0.23964417031146798
3579,0.3579,8,78,8,313281,292329,15805,92151,2.7078531994516286,0.23967696629213484
3580,0.358,13,103,13,313384,292226,15818,92138,2.7068991070436104,0.2397154780364446
3581,0.3581,5,84,5,313468,292142,15823,92133,2.706121012264256,0.23975798581744845
3582,0.3582,5,79,5,313547,292063,15828,92128,2.705389232650339,0.23979739244282142
3583,0.3583,10,77,10,313624,291986,15838,92118,2.704675979102597,0.23982567221377543
3584,0.3584,7,85,7,313709,291901,15845,92111,2.7038886212901554,0.2398649000552066
3585,0.3585,13,89,13,313798,291812,15858,92098,2.703064211345363,0.23989476700268292
3586,0.3586,10,72,10,313870,291740,15868,92088,2.702397272963059,0.23991996415060912
3587,0.3587,5,87,5,313957,291653,15873,92083,2.7015913890844416,0.23996445472929306
3588,0.3588,12,98,12,314055,291555,15885,92071,2.7006836118418613,0.2400019810961718
3589,0.3589,8,95,8,314150,291460,15893,92063,2.6998036236985437,0.24004557744907085
3590,0.359,9,90,9,314240,291370,15902,92054,2.698969950720664,0.24008408446002336
3591,0.3591,10,88,10,314328,291282,15912,92044,2.698154803808959,0.24011937619676202
3592,0.3592,14,97,14,314425,291185,15926,92030,2.6972562895994665,0.24015239486972065
3593,0.3593,8,78,8,314503,291107,15934,92022,2.696533773018637,0.2401854205763594
3594,0.3594,6,74,6,314577,291033,15940,92016,2.695848308570158,0.24021991964474518
3595,0.3595,10,76,10,314653,290957,15950,92006,2.695144318055504,0.2402477523938344
3596,0.3596,12,70,12,314723,290887,15962,91994,2.6944959057393754,0.24026786390549545
3597,0.3597,14,96,14,314819,290791,15976,91980,2.69360665456297,0.2403003362323687
3598,0.3598,10,103,10,314922,290688,15986,91970,2.692652562154952,0.24034516461174207
3599,0.3599,5,103,5,315025,290585,15991,91965,2.691698469746934,0.24039994771925238
3600,0.36,6,98,6,315123,290487,15997,91959,2.6907906925043537,0.24044963210492462
3601,0.3601,10,89,10,315212,290398,16007,91949,2.689966282559561,0.24048573677837148
3602,0.3602,11,76,11,315288,290322,16018,91938,2.689262292044907,0.24051169361167793
3603,0.3603,8,106,8,315394,290216,16026,91930,2.6882804105376263,0.2405625075233026
3604,0.3604,5,76,5,315470,290140,16031,91925,2.6875764200229724,0.24060042139426538
3605,0.3605,5,82,5,315552,290058,16036,91920,2.6868168513097928,0.24064213122221698
3606,0.3606,11,103,11,315655,289955,16047,91909,2.685862758901775,0.2406851653991997
3607,0.3607,6,98,6,315753,289857,16053,91903,2.6849549816591947,0.24073501676445935
3608,0.3608,5,95,5,315848,289762,16058,91898,2.684074993515877,0.24078499187758737
3609,0.3609,6,79,6,315927,289683,16064,91892,2.68334321390196,0.24082290506453516
3610,0.361,13,108,13,316035,289575,16077,91879,2.682342806328504,0.24086521572719122
3611,0.3611,8,113,8,316148,289462,16085,91871,2.6812960835896105,0.24092066514044155
3612,0.3612,13,101,13,316249,289361,16098,91858,2.6803605172477676,0.2409586090934607
3613,0.3613,14,78,14,316327,289283,16112,91844,2.6796380006669382,0.2409800407738103
3614,0.3614,12,84,12,316411,289199,16124,91832,2.6788599058875837,0.24100926171361386
3615,0.3615,7,84,7,316495,289115,16131,91825,2.678081811108229,0.24104845907491992
3616,0.3616,16,84,16,316579,289031,16147,91809,2.6773037163288746,0.24106974057346917
3617,0.3617,10,106,10,316685,288925,16157,91799,2.676321834821594,0.24111692459629547
3618,0.3618,15,78,15,316763,288847,16172,91784,2.675599318240765,0.24113642871967864
3619,0.3619,14,80,14,316843,288767,16186,91770,2.67485827559376,0.24115920396702553
3620,0.362,13,99,13,316942,288668,16199,91757,2.6739412353180927,0.24119603075507656
3621,0.3621,7,85,7,317027,288583,16206,91750,2.6731538775056505,0.24123596953196277
3622,0.3622,8,76,8,317103,288507,16214,91742,2.6724498869909965,0.2412682216126801
3623,0.3623,9,78,9,317181,288429,16223,91733,2.671727370410167,0.2412997616805467
3624,0.3624,7,98,7,317279,288331,16230,91726,2.670819593167587,0.24134800832506703
3625,0.3625,9,90,9,317369,288241,16239,91717,2.6699859201897067,0.24138720595434232
3626,0.3626,6,88,6,317457,288153,16245,91711,2.6691707732780023,0.2414311437777731
3627,0.3627,10,100,10,317557,288053,16255,91701,2.6682444699692467,0.2414747441764932
3628,0.3628,12,77,12,317634,287976,16267,91689,2.667531216421505,0.24149974319465844
3629,0.3629,7,83,7,317717,287893,16274,91682,2.666762384675238,0.2415385628663637
3630,0.363,7,102,7,317819,287791,16281,91675,2.6658175553003076,0.24158949681921438
3631,0.3631,11,97,11,317916,287694,16292,91664,2.6649190410908146,0.2416292789396823
3632,0.3632,9,81,9,317997,287613,16301,91655,2.664168735410723,0.24166288745689063
3633,0.3633,4,103,4,318100,287510,16305,91651,2.663214643002705,0.241720535603609
3634,0.3634,7,82,7,318182,287428,16312,91644,2.662455074289525,0.24175882154313694
3635,0.3635,7,84,7,318266,287344,16319,91637,2.6616769795101707,0.2417984015029777
3636,0.3636,8,93,8,318359,287251,16327,91629,2.6608155174330284,0.24184174408783785
3637,0.3637,13,85,13,318444,287166,16340,91616,2.660028159620586,0.24186999382230412
3638,0.3638,13,108,13,318552,287058,16353,91603,2.6590277520471304,0.24191295116212128
3639,0.3639,16,94,16,318646,286964,16369,91587,2.6581570269369004,0.241940980211385
3640,0.364,7,71,7,318717,286893,16376,91580,2.657499351587684,0.241972346772425
3641,0.3641,14,79,14,318796,286814,16390,91566,2.656767571973767,0.2419948200221999
3642,0.3642,6,98,6,318894,286716,16396,91560,2.6558597947311866,0.24204549059416933
3643,0.3643,11,91,11,318985,286625,16407,91549,2.655016858720219,0.24208168726565021
3644,0.3644,14,92,14,319077,286533,16421,91535,2.6541646596761646,0.2421125300210544
3645,0.3645,8,87,8,319164,286446,16429,91527,2.653358775797547,0.24215221722186506
3646,0.3646,6,94,6,319258,286352,16435,91521,2.652488050687317,0.24220042183484927
3647,0.3647,9,83,9,319341,286269,16444,91512,2.65171921894105,0.2422355809318097
3648,0.3648,13,87,13,319428,286182,16457,91499,2.650913335062433,0.24226529796309584
3649,0.3649,4,83,4,319511,286099,16461,91495,2.6501445033161657,0.24231052400197037
3650,0.365,14,90,14,319601,286009,16475,91481,2.649310830338286,0.24234019444223687
3651,0.3651,15,81,15,319682,285928,16490,91466,2.648560524658194,0.24236209372698028
3652,0.3652,13,65,13,319747,285863,16503,91453,2.647958427507503,0.2423777417337192
3653,0.3653,13,76,13,319823,285787,16516,91440,2.647254436992849,0.24240046444183475
3654,0.3654,14,90,14,319913,285697,16530,91426,2.646420764014969,0.24243018855917034
3655,0.3655,13,84,13,319997,285613,16543,91413,2.6456426692356145,0.24245807981412423
3656,0.3656,7,81,7,320078,285532,16550,91406,2.6448923635555226,0.242496113419183
3657,0.3657,13,86,13,320164,285446,16563,91393,2.644095742709993,0.24252532248519926
3658,0.3658,14,84,14,320248,285362,16577,91379,2.6433176479306386,0.24255124873586895
3659,0.3659,8,87,8,320335,285275,16585,91371,2.642511764052021,0.24259118641907787
3660,0.366,10,96,10,320431,285179,16595,91361,2.641622512875616,0.24263292080522653
3661,0.3661,16,96,16,320527,285083,16611,91345,2.6407332616992107,0.24266260745746862
3662,0.3662,8,93,8,320620,284990,16619,91337,2.6398717996220684,0.24270647601686832
3663,0.3663,7,84,7,320704,284906,16626,91330,2.639093704842714,0.24274657395889815
3664,0.3664,12,81,12,320785,284825,16638,91318,2.638343399162622,0.24277468941333483
3665,0.3665,7,104,7,320889,284721,16645,91311,2.637380043721516,0.24282773806484553
3666,0.3666,11,70,11,320959,284651,16656,91300,2.6367316314053872,0.24285079704535964
3667,0.3667,10,88,10,321047,284563,16666,91290,2.6359164844936824,0.2428875118729929
3668,0.3668,7,103,7,321150,284460,16673,91283,2.6349623920856646,0.24293998823664048
3669,0.3669,12,89,12,321239,284371,16685,91271,2.634137982140872,0.24297336293598693
3670,0.367,12,90,12,321329,284281,16697,91259,2.6333043091629924,0.24300740267348353
3671,0.3671,8,87,8,321416,284194,16705,91251,2.6324984252843753,0.24304758353420608
3672,0.3672,5,67,5,321483,284127,16710,91246,2.631877802067509,0.24308088221582266
3673,0.3673,7,82,7,321565,284045,16717,91239,2.6311182333543295,0.2431198772129907
3674,0.3674,9,79,9,321644,283966,16726,91230,2.630386453740413,0.24315291207795392
3675,0.3675,1,88,1,321732,283878,16727,91229,2.629571306828708,0.2432079380016902
3676,0.3676,14,74,14,321806,283804,16741,91215,2.628885842380229,0.24322767646439247
3677,0.3677,10,97,10,321903,283707,16751,91205,2.6279873281707364,0.2432704207920792
3678,0.3678,9,80,9,321983,283627,16760,91196,2.6272462855237317,0.2433041729029435
3679,0.3679,4,77,4,322060,283550,16764,91192,2.62653303197599,0.24334608877574437
3680,0.368,7,88,7,322148,283462,16771,91185,2.6257178850642853,0.24338911028247925
3681,0.3681,8,89,8,322237,283373,16779,91177,2.6248934751194932,0.24343078360699505
3682,0.3682,12,92,12,322329,283281,16791,91165,2.624041276075438,0.24346634761754699
3683,0.3683,10,80,10,322409,283201,16801,91155,2.623300233428434,0.24349816751968714
3684,0.3684,11,82,11,322491,283119,16812,91144,2.6225406647152543,0.24352928288396128
3685,0.3685,9,89,9,322580,283030,16821,91135,2.621716254770462,0.2435690136704395
3686,0.3686,8,71,8,322651,282959,16829,91127,2.6210585794212458,0.24359906545553697
3687,0.3687,9,68,9,322719,282891,16838,91118,2.620428693171292,0.24362515340539934
3688,0.3688,12,99,12,322818,282792,16850,91106,2.619511652895624,0.24366538467710444
3689,0.3689,9,74,9,322892,282718,16859,91097,2.6188261884471453,0.24369541083156107
3690,0.369,12,94,12,322986,282624,16871,91085,2.617955463336915,0.24373242282096497
3691,0.3691,5,80,5,323066,282544,16876,91080,2.6172144206899106,0.243774489861465
3692,0.3692,8,105,8,323171,282439,16884,91072,2.6162418022157174,0.24382682170003026
3693,0.3693,10,93,10,323264,282346,16894,91062,2.615380340138575,0.24386729796897763
3694,0.3694,11,77,11,323341,282269,16905,91051,2.6146670865908335,0.24389531768991748
3695,0.3695,11,75,11,323416,282194,16916,91040,2.6139723591092667,0.2439220435437286
3696,0.3696,14,89,14,323505,282105,16930,91026,2.6131479491644742,0.24395185605055597
3697,0.3697,12,103,12,323608,282002,16942,91014,2.6121938567564564,0.2439948956613121
3698,0.3698,10,85,10,323693,281917,16952,91004,2.611406498944014,0.24403023696707882
3699,0.3699,11,93,11,323786,281824,16963,90993,2.610545036866872,0.24406880587526855
3700,0.37,10,83,10,323869,281741,16973,90983,2.6097762051206046,0.24410287504963457
3701,0.3701,5,81,5,323950,281660,16978,90978,2.6090258994405127,0.24414579296797428
3702,0.3702,9,78,9,324028,281582,16987,90969,2.6083033828596838,0.24417864936612704
3703,0.3703,4,90,4,324118,281492,16991,90965,2.6074697098818036,0.2442295352215155
3704,0.3704,10,106,10,324224,281386,17001,90955,2.6064878283745228,0.24427876596990394
3705,0.3705,18,73,18,324297,281313,17019,90937,2.6058116269591314,0.24429012760241772
3706,0.3706,10,91,10,324388,281222,17029,90927,2.604968690948164,0.24432955617239333
3707,0.3707,10,87,10,324475,281135,17039,90917,2.604162807069547,0.24436637889327298
3708,0.3708,7,105,7,324580,281030,17046,90910,2.6031901885953537,0.244421143195139
3709,0.3709,14,103,14,324683,280927,17060,90896,2.6022360961873354,0.24446040185787324
3710,0.371,10,97,10,324780,280830,17070,90886,2.601337581977843,0.24450386854480302
3711,0.3711,13,88,13,324868,280742,17083,90873,2.600522435066138,0.24453533899331298
3712,0.3712,14,99,14,324967,280643,17097,90859,2.59960539479047,0.24457203460546645
3713,0.3713,7,102,7,325069,280541,17104,90852,2.5986605654155395,0.24462496600635983
3714,0.3714,7,93,7,325162,280448,17111,90845,2.597799103338397,0.2446719975868115
3715,0.3715,11,80,11,325242,280368,17122,90834,2.597058060691393,0.24470234535374272
3716,0.3716,7,88,7,325330,280280,17129,90827,2.596242913779688,0.24474612443311497
3717,0.3717,2,86,2,325416,280194,17131,90825,2.595446292934158,0.24479878388977383
3718,0.3718,7,81,7,325497,280113,17138,90818,2.5946959872540662,0.24483798873644963
3719,0.3719,11,91,11,325588,280022,17149,90807,2.593853051243099,0.24487567045727276
3720,0.372,12,79,12,325667,279943,17161,90795,2.5931212716291823,0.24490340887634934
3721,0.3721,5,105,5,325772,279838,17166,90790,2.592148653154989,0.2449626040126488
3722,0.3722,12,82,12,325854,279756,17178,90778,2.5913890844418095,0.24499236237430302
3723,0.3723,12,78,12,325932,279678,17190,90766,2.5906665678609806,0.2450194901253631
3724,0.3724,5,77,5,326009,279601,17195,90761,2.589953314313239,0.24506023836138696
3725,0.3725,12,74,12,326083,279527,17207,90749,2.58926784986476,0.24508474759368687
3726,0.3726,9,89,9,326172,279438,17216,90740,2.5884434399199674,0.24512531809021607
3727,0.3727,15,94,15,326266,279344,17231,90725,2.5875727148097374,0.24515698423807453
3728,0.3728,9,91,9,326357,279253,17240,90716,2.58672977879877,0.24519892207184926
3729,0.3729,15,78,15,326435,279175,17255,90701,2.5860072622179406,0.2452200196822719
3730,0.373,10,84,10,326519,279091,17265,90691,2.585229167438586,0.2452553125895798
3731,0.3731,15,84,15,326603,279007,17280,90676,2.5844510726592316,0.2452804159239132
3732,0.3732,11,77,11,326680,278930,17291,90665,2.58373781911149,0.2453090545056075
3733,0.3733,7,79,7,326759,278851,17298,90658,2.583006039497573,0.24534720399232496
3734,0.3734,9,84,9,326843,278767,17307,90649,2.5822279447182184,0.2453846070554605
3735,0.3735,9,85,9,326928,278682,17316,90640,2.5814405869057766,0.2454226934761536
3736,0.3736,8,104,8,327032,278578,17324,90632,2.5804772314646707,0.24547547466211642
3737,0.3737,10,63,10,327095,278515,17334,90622,2.5798936603801548,0.245496929324343
3738,0.3738,12,89,12,327184,278426,17346,90610,2.5790692504353627,0.24553160125299428
3739,0.3739,9,73,9,327257,278353,17355,90601,2.578393049019971,0.2455617773489378
3740,0.374,12,90,12,327347,278263,17367,90589,2.577559376042091,0.24559715007645344
3741,0.3741,16,98,16,327445,278165,17383,90573,2.576651598799511,0.24562968828816123
3742,0.3742,9,98,9,327543,278067,17392,90564,2.5757438215569306,0.24567657087982292
3743,0.3743,13,75,13,327618,277992,17405,90551,2.575049094075364,0.2456999590278475
3744,0.3744,7,91,7,327709,277901,17412,90544,2.5742061580643965,0.24574631220399246
3745,0.3745,6,88,6,327797,277813,17418,90538,2.5733910111526916,0.24579273573303723
3746,0.3746,6,81,6,327878,277732,17424,90532,2.5726407054726,0.24583451002541654
3747,0.3747,8,85,8,327963,277647,17432,90524,2.571853347660158,0.2458748787927349
3748,0.3748,9,99,9,328062,277548,17441,90515,2.57093630738449,0.245922573037768
3749,0.3749,7,70,7,328132,277478,17448,90508,2.570287895068361,0.2459550091579571
3750,0.375,7,88,7,328220,277390,17455,90501,2.5694727481566564,0.24599949441546545
3751,0.3751,4,89,4,328309,277301,17459,90497,2.568648338211864,0.24605082137477638
3752,0.3752,8,93,8,328402,277208,17467,90489,2.5677868761347216,0.2460966502310326
3753,0.3753,6,80,6,328482,277128,17473,90483,2.5670458334877173,0.24613790120535023
3754,0.3754,8,79,8,328561,277049,17481,90475,2.5663140538738003,0.24617439949499897
3755,0.3755,7,80,7,328641,276969,17488,90468,2.565573011226796,0.24621363662342116
3756,0.3756,6,97,6,328738,276872,17494,90462,2.5646744970173034,0.24626634071444517
3757,0.3757,8,97,8,328835,276775,17502,90454,2.5637759828078104,0.24631496967832062
3758,0.3758,8,83,8,328918,276692,17510,90446,2.5630071510615435,0.24635423192369083
3759,0.3759,8,87,8,329005,276605,17518,90438,2.5622012671829264,0.2463961988104936
3760,0.376,9,83,9,329088,276522,17527,90429,2.5614324354366595,0.24643344751751597
3761,0.3761,12,85,12,329173,276437,17539,90417,2.5606450776242173,0.24646589651468978
3762,0.3762,8,102,8,329275,276335,17547,90409,2.5597002482492868,0.24651800711122746
3763,0.3763,8,101,8,329376,276234,17555,90401,2.558764681907444,0.24656947645478472
3764,0.3764,13,94,13,329470,276140,17568,90388,2.557893956797214,0.24660598917408766
3765,0.3765,15,85,15,329555,276055,17583,90373,2.5571065989847717,0.24663235342277337
3766,0.3766,10,92,10,329647,275963,17593,90363,2.5562543999407166,0.24667372777253047
3767,0.3767,8,81,8,329728,275882,17601,90355,2.5555040942606246,0.2467118286792432
3768,0.3768,9,83,9,329811,275799,17610,90346,2.554735262514358,0.2467492386895902
3769,0.3769,17,103,17,329914,275696,17627,90329,2.5537811701063395,0.24678368963868588
3770,0.377,11,73,11,329987,275623,17638,90318,2.553104968690948,0.24681027815959403
3771,0.3771,13,78,13,330065,275545,17651,90305,2.552382452110119,0.24683613502801693
3772,0.3772,11,75,11,330140,275470,17662,90294,2.5516877246285525,0.24686409816165614
3773,0.3773,6,98,6,330238,275372,17668,90288,2.5507799473859722,0.24691790187605972
3774,0.3774,12,78,12,330316,275294,17680,90276,2.550057430805143,0.24694586536094318
3775,0.3775,11,77,11,330393,275217,17691,90265,2.5493441772574013,0.24697522723417295
3776,0.3776,12,82,12,330475,275135,17703,90253,2.5485846085442216,0.247005922471455
3777,0.3777,12,79,12,330554,275056,17715,90241,2.547852828930305,0.24703460471889996
3778,0.3778,7,75,7,330629,274981,17722,90234,2.5471581014487383,0.2470709034404392
3779,0.3779,14,93,14,330722,274888,17736,90220,2.546296639371596,0.24710496620178138
3780,0.378,12,95,12,330817,274793,17748,90208,2.5454166512282783,0.24714452837115514
3781,0.3781,8,114,8,330931,274679,17756,90200,2.544360665456297,0.24720523790078355
3782,0.3782,9,79,9,331010,274600,17765,90191,2.5436288858423803,0.24724020055319348
3783,0.3783,10,89,10,331099,274511,17775,90181,2.542804475897588,0.24727989646057494
3784,0.3784,10,81,10,331180,274430,17785,90171,2.542054170217496,0.24731418728966734
3785,0.3785,8,84,8,331264,274346,17793,90163,2.5412760754381414,0.24735466065309772
3786,0.3786,12,80,12,331344,274266,17805,90151,2.540535032791137,0.24738417801584447
3787,0.3787,7,96,7,331440,274170,17812,90144,2.5396457816147318,0.24743490505443108
3788,0.3788,10,75,10,331515,274095,17822,90134,2.5389510541331655,0.24746519360072922
3789,0.3789,9,87,9,331602,274008,17831,90125,2.5381451702545483,0.24750571906418808
3790,0.379,6,92,6,331694,273916,17837,90119,2.5372929712104932,0.24755586688093179
3791,0.3791,9,81,9,331775,273835,17846,90110,2.5365426655304013,0.2475923559878553
3792,0.3792,9,86,9,331861,273749,17855,90101,2.5357460446848714,0.24763226604369934
3793,0.3793,10,81,10,331942,273668,17865,90091,2.53499573900478,0.24766672439719706
3794,0.3794,9,80,9,332022,273588,17874,90082,2.5342546963577752,0.24770258751065527
3795,0.3795,5,98,5,332120,273490,17879,90077,2.533346919115195,0.24775901003116343
3796,0.3796,9,91,9,332211,273399,17888,90068,2.5325039831042275,0.24780241397430852
3797,0.3797,9,78,9,332289,273321,17897,90059,2.5317814665233986,0.24783697506742253
3798,0.3798,12,73,12,332362,273248,17909,90047,2.531105265108007,0.24786193038715093
3799,0.3799,9,86,9,332448,273162,17918,90038,2.5303086442624774,0.24790198237885464
3800,0.38,10,78,10,332526,273084,17928,90028,2.529586127681648,0.24793452158011853
3801,0.3801,10,94,10,332620,272990,17938,90018,2.528715402571418,0.24797800599435826
3802,0.3802,8,77,8,332697,272913,17946,90010,2.5280021490236764,0.24801404154600287
3803,0.3803,12,84,12,332781,272829,17958,89998,2.527224054244322,0.24804658969701815
3804,0.3804,12,80,12,332861,272749,17970,89986,2.5264830115973176,0.24807641942464884
3805,0.3805,12,91,12,332952,272658,17982,89974,2.52564007558635,0.2481137902887776
3806,0.3806,16,82,16,333034,272576,17998,89958,2.5248805068731706,0.24813672648634336
3807,0.3807,8,96,8,333130,272480,18006,89950,2.523991255696765,0.2481858565792015
3808,0.3808,4,83,4,333213,272397,18010,89946,2.5232224239504983,0.24823440772969257
3809,0.3809,10,92,10,333305,272305,18020,89936,2.5223702249064432,0.24827669976617778
3810,0.381,5,77,5,333382,272228,18025,89931,2.5216569713587016,0.2483191084578873
3811,0.3811,4,70,4,333452,272158,18029,89927,2.521008559042573,0.24835881077647515
3812,0.3812,6,85,6,333537,272073,18035,89921,2.5202212012301306,0.24840466969065786
3813,0.3813,13,91,13,333628,271982,18048,89908,2.519378265219163,0.24844013374229737
3814,0.3814,6,96,6,333724,271886,18054,89902,2.5184890140427583,0.24849359293287782
3815,0.3815,13,71,13,333795,271815,18067,89889,2.517831338693542,0.24851536062636853
3816,0.3816,15,79,15,333874,271736,18082,89874,2.5170995590796252,0.24853848068360943
3817,0.3817,10,84,10,333958,271652,18092,89864,2.5163214643002703,0.2485754434105268
3818,0.3818,6,83,6,334041,271569,18098,89858,2.5155526325540034,0.24862005328876924
3819,0.3819,12,94,12,334135,271475,18110,89846,2.5146819074437734,0.24865977897769573
3820,0.382,8,80,8,334215,271395,18118,89838,2.513940864796769,0.24869820863542366
3821,0.3821,12,71,12,334286,271324,18130,89826,2.5132831894475527,0.24872213761594905
3822,0.3822,11,92,11,334378,271232,18141,89815,2.5124309904034976,0.24876262647245373
3823,0.3823,9,88,9,334466,271144,18150,89806,2.511615843491793,0.2488045435655908
3824,0.3824,8,94,8,334560,271050,18158,89798,2.510745118381563,0.24885270252294595
3825,0.3825,10,79,10,334639,270971,18168,89788,2.510013338767646,0.24888637566907548
3826,0.3826,6,83,6,334722,270888,18174,89782,2.509244507021379,0.24893115590428924
3827,0.3827,18,85,18,334807,270803,18192,89764,2.508457149208937,0.24895234450185402
3828,0.3828,16,82,16,334889,270721,18208,89748,2.5076975804957575,0.24897564006891024
3829,0.3829,13,81,13,334970,270640,18221,89735,2.5069472748156656,0.24900450919181408
3830,0.383,12,77,12,335047,270563,18233,89723,2.506234021267924,0.24903271290030699
3831,0.3831,11,71,11,335118,270492,18244,89712,2.5055763459187075,0.24905886664223606
3832,0.3832,10,91,10,335209,270401,18254,89702,2.50473340990774,0.24910095167216045
3833,0.3833,10,90,10,335299,270311,18264,89692,2.5038997369298603,0.24914236825804228
3834,0.3834,12,97,12,335396,270214,18276,89680,2.5030012227203677,0.2491844820975065
3835,0.3835,10,71,10,335467,270143,18286,89670,2.5023435473711513,0.24921278553026155
3836,0.3836,13,86,13,335553,270057,18299,89657,2.5015469265256214,0.24924523371345014
3837,0.3837,8,83,8,335636,269974,18307,89649,2.5007780947793545,0.24928605789952255
3838,0.3838,15,87,15,335723,269887,18322,89634,2.4999722109007374,0.24931506087266112
3839,0.3839,11,92,11,335815,269795,18333,89623,2.4991200118566823,0.24935590315454428
3840,0.384,4,96,4,335911,269699,18337,89619,2.498230760680277,0.24941416795150814
3841,0.3841,12,73,12,335984,269626,18349,89607,2.4975545592648856,0.24943977863949024
3842,0.3842,4,80,4,336064,269546,18353,89603,2.4968135166178813,0.24948698172624734
3843,0.3843,12,73,12,336137,269473,18365,89591,2.49613731520249,0.24951262170532273
3844,0.3844,8,79,8,336216,269394,18373,89583,2.495405535588573,0.24955080687620657
3845,0.3845,10,82,10,336298,269312,18383,89573,2.4946459668753937,0.249586915028491
3846,0.3846,11,86,11,336384,269226,18394,89562,2.493849346029864,0.24962373323522527
3847,0.3847,8,93,8,336477,269133,18402,89554,2.4929878839527215,0.24967171935420018
3848,0.3848,7,86,7,336563,269047,18409,89547,2.4921912631071916,0.2497169500884008
3849,0.3849,13,95,13,336658,268952,18422,89534,2.4913112749638744,0.24975591794379698
3850,0.385,10,86,10,336744,268866,18432,89524,2.4905146541183445,0.24979491615279445
3851,0.3851,11,86,11,336830,268780,18443,89513,2.489718033272815,0.2498318415375126
3852,0.3852,13,103,13,336933,268677,18456,89500,2.488763940864797,0.2498764577289999
3853,0.3853,14,85,14,337018,268592,18470,89486,2.4879765830523546,0.24990644496450495
3854,0.3854,12,81,12,337099,268511,18482,89474,2.4872262773722627,0.24993784655781667
3855,0.3855,13,81,13,337180,268430,18495,89461,2.4864759716921707,0.24996716877485045
3856,0.3856,5,95,5,337275,268335,18500,89456,2.485595983548853,0.250023058154062
3857,0.3857,13,93,13,337368,268242,18513,89443,2.4847345214717107,0.25006080769392064
3858,0.3858,12,71,12,337439,268171,18525,89431,2.4840768461224942,0.25008529035072513
3859,0.3859,11,85,11,337524,268086,18536,89420,2.483289488310052,0.25012167627955895
3860,0.386,6,78,6,337602,268008,18542,89414,2.482566971729223,0.25016367207390705
3861,0.3861,9,87,9,337689,267921,18551,89405,2.481761087850606,0.2502056945198502
3862,0.3862,6,76,6,337765,267845,18557,89399,2.4810570973359516,0.2502463302392762
3863,0.3863,7,88,7,337853,267757,18564,89392,2.4802419504242468,0.25029329495532676
3864,0.3864,10,76,10,337929,267681,18574,89382,2.479537959909593,0.25032557279807766
3865,0.3865,15,95,15,338024,267586,18589,89367,2.478657971766275,0.250360691743731
3866,0.3866,8,89,8,338113,267497,18597,89359,2.4778335618214826,0.2504063263613334
3867,0.3867,10,101,10,338214,267396,18607,89349,2.4768979954796397,0.25045620821595255
3868,0.3868,9,69,9,338283,267327,18616,89340,2.4762588461965986,0.25048574720958205
3869,0.3869,10,81,10,338364,267246,18626,89330,2.4755085405165067,0.2505216279278471
3870,0.387,9,82,9,338446,267164,18635,89321,2.474748971803327,0.25056033213178674
3871,0.3871,5,103,5,338549,267061,18640,89316,2.4737948793953093,0.2506222343192743
3872,0.3872,15,104,15,338653,266957,18655,89301,2.4728315239542034,0.2506638447417321
3873,0.3873,8,74,8,338727,266883,18663,89293,2.4721460595057247,0.2506990925834419
3874,0.3874,11,76,11,338803,266807,18674,89282,2.4714420689910703,0.2507294524683436
3875,0.3875,13,82,13,338885,266725,18687,89269,2.470682500277891,0.25075984426703823
3876,0.3876,9,86,9,338971,266639,18696,89260,2.4698858794323613,0.25080149143436764
3877,0.3877,10,74,10,339045,266565,18706,89250,2.469200414983882,0.2508325955904051
3878,0.3878,12,65,12,339110,266500,18718,89238,2.4685983178331914,0.25085315597434066
3879,0.3879,7,79,7,339189,266421,18725,89231,2.4678665382192744,0.25089413246656844
3880,0.388,18,86,18,339275,266335,18743,89213,2.467069917373745,0.2509168944840078
3881,0.3881,10,85,10,339360,266250,18753,89203,2.4662825595613027,0.25095582257007254
3882,0.3882,8,104,8,339464,266146,18761,89195,2.4653192041201972,0.2510124077998317
3883,0.3883,15,80,15,339544,266066,18776,89180,2.464578161473193,0.2510373093574593
3884,0.3884,11,79,11,339623,265987,18787,89169,2.463846381859276,0.2510699523589634
3885,0.3885,12,90,12,339713,265897,18799,89157,2.4630127088813962,0.2511082821204662
3886,0.3886,10,85,10,339798,265812,18809,89147,2.462225351068954,0.25114731560546427
3887,0.3887,8,85,8,339883,265727,18817,89139,2.461437993256512,0.25119059025096796
3888,0.3888,10,97,10,339980,265630,18827,89129,2.460539479047019,0.2512381645004073
3889,0.3889,13,72,13,340052,265558,18840,89116,2.459872540664715,0.25126172203206326
3890,0.389,10,81,10,340133,265477,18850,89106,2.4591222349846236,0.2512980035703911
3891,0.3891,8,89,8,340222,265388,18858,89098,2.458297825039831,0.25134419977093597
3892,0.3892,14,87,14,340309,265301,18872,89084,2.457491941161214,0.2513763280048535
3893,0.3893,7,93,7,340402,265208,18879,89077,2.456630479084071,0.25142752303936095
3894,0.3894,9,92,9,340494,265116,18888,89068,2.455778280040016,0.25147381022293497
3895,0.3895,15,77,15,340571,265039,18903,89053,2.4550650264922744,0.25149678614597337
3896,0.3896,6,78,6,340649,264961,18909,89047,2.4543425099114455,0.2515395132313394
3897,0.3897,7,89,7,340738,264872,18916,89040,2.453518099966653,0.25158796536992245
3898,0.3898,6,91,6,340829,264781,18922,89034,2.4526751639556856,0.25163998134618376
3899,0.3899,13,103,13,340932,264678,18935,89021,2.4517210715476674,0.25168575540219223
3900,0.39,7,89,7,341021,264589,18942,89014,2.4508966616028753,0.25173428958464716
3901,0.3901,7,93,7,341114,264496,18949,89007,2.4500351995257326,0.2517856991312662
3902,0.3902,12,90,12,341204,264406,18961,88995,2.449201526547853,0.25182441475830575
3903,0.3903,8,67,8,341271,264339,18969,88987,2.4485809033309867,0.2518552271839604
3904,0.3904,17,90,17,341361,264249,18986,88970,2.447747230353107,0.2518833924562382
3905,0.3905,10,96,10,341457,264153,18996,88960,2.4468579791767016,0.2519306850781478
3906,0.3906,9,88,9,341545,264065,19005,88951,2.4460428322649967,0.2519744147574048
3907,0.3907,12,80,12,341625,263985,19017,88939,2.4453017896179925,0.2520060976300847
3908,0.3908,17,96,17,341721,263889,19034,88922,2.444412538441587,0.25203862691355994
3909,0.3909,5,71,5,341792,263818,19039,88917,2.443754863092371,0.2520787560066339
3910,0.391,10,96,10,341888,263722,19049,88907,2.4428656119159657,0.25212617226603595
3911,0.3911,6,80,6,341968,263642,19055,88901,2.4421245692689615,0.2521706571964271
3912,0.3912,6,83,6,342051,263559,19061,88895,2.4413557375226946,0.25221731062776986
3913,0.3913,9,79,9,342130,263480,19070,88886,2.4406239579087776,0.2522547578370217
3914,0.3914,8,86,8,342216,263394,19078,88878,2.439827337063248,0.25229935958577465
3915,0.3915,9,91,9,342307,263303,19087,88869,2.4389844010522808,0.2523454448394534
3916,0.3916,6,97,6,342404,263206,19093,88863,2.4380858868427877,0.2524022279723577
3917,0.3917,13,85,13,342489,263121,19106,88850,2.4372985290303455,0.2524355699759355
3918,0.3918,12,71,12,342560,263050,19118,88838,2.4366408536811295,0.2524610103214659
3919,0.3919,7,95,7,342655,262955,19125,88831,2.435760865537812,0.2525143126787308
3920,0.392,13,87,13,342742,262868,19138,88818,2.4349549816591947,0.2525491489567398
3921,0.3921,8,69,8,342811,262799,19146,88810,2.434315832376153,0.25258170297119814
3922,0.3922,12,88,12,342899,262711,19158,88798,2.4335006854644483,0.2526194208398647
3923,0.3923,11,88,11,342987,262623,19169,88787,2.4326855385527435,0.2526592868728835
3924,0.3924,9,75,9,343062,262548,19178,88778,2.431990811071177,0.25269407900354657
3925,0.3925,8,96,8,343158,262452,19186,88770,2.431101559894772,0.2527461263816048
3926,0.3926,5,79,5,343237,262373,19191,88765,2.4303697802808553,0.2527923494466563
3927,0.3927,10,82,10,343319,262291,19201,88755,2.4296102115676756,0.25283011343242767
3928,0.3928,6,94,6,343413,262197,19207,88749,2.4287394864574456,0.2528850592398831
3929,0.3929,9,79,9,343492,262118,19216,88740,2.4280077068435286,0.25292283487906786
3930,0.393,11,68,11,343560,262050,19227,88729,2.427377820593575,0.25294843762026803
3931,0.3931,7,78,7,343638,261972,19234,88722,2.426655304012746,0.2529897859672535
3932,0.3932,11,82,11,343720,261890,19245,88711,2.4258957352995667,0.25302551903731024
3933,0.3933,2,84,2,343804,261806,19247,88709,2.4251176405202117,0.2530818937848594
3934,0.3934,14,87,14,343891,261719,19261,88695,2.4243117566415946,0.2531148869622789
3935,0.3935,13,95,13,343986,261624,19274,88682,2.423431768498277,0.25315581234691953
3936,0.3936,14,74,14,344060,261550,19288,88668,2.422746304049798,0.25317944822938854
3937,0.3937,10,78,10,344138,261472,19298,88658,2.422023787468969,0.2532145203210236
3938,0.3938,10,88,10,344226,261384,19308,88648,2.421208640557264,0.25325684508844903
3939,0.3939,9,116,9,344342,261268,19317,88639,2.420134128719108,0.25332159688145706
3940,0.394,10,97,10,344439,261171,19327,88629,2.419235614509615,0.2533704974271012
3941,0.3941,13,85,13,344524,261086,19340,88616,2.418448256697173,0.2534043271127989
3942,0.3942,12,86,12,344610,261000,19352,88604,2.417651635851643,0.25344103614375124
3943,0.3943,16,78,16,344688,260922,19368,88588,2.416929119270814,0.25346342021687507
3944,0.3944,15,71,15,344759,260851,19383,88573,2.4162714439215978,0.2534828746737488
3945,0.3945,8,88,8,344847,260763,19391,88565,2.415456297009893,0.25352963404021434
3946,0.3946,10,90,10,344937,260673,19401,88555,2.414622624032013,0.25357359661882783
3947,0.3947,11,91,11,345028,260582,19412,88544,2.413779688021046,0.2536161729576142
3948,0.3948,8,80,8,345108,260502,19420,88536,2.413038645374041,0.25365719491860483
3949,0.3949,8,81,8,345189,260421,19428,88528,2.412288339693949,0.25369896460514285
3950,0.395,11,68,11,345257,260353,19439,88517,2.4116584534439958,0.2537248831943131
3951,0.3951,3,90,3,345347,260263,19442,88514,2.410824780466116,0.253783936440763
3952,0.3952,12,80,12,345427,260183,19454,88502,2.4100837378191113,0.2538164819249466
3953,0.3953,8,68,8,345495,260115,19462,88494,2.409453851569158,0.2538488679293994
3954,0.3954,15,95,15,345590,260020,19477,88479,2.4085738634258402,0.2538859508922551
3955,0.3955,9,101,9,345691,259919,19486,88470,2.4076382970839973,0.2539402794003255
3956,0.3956,7,91,7,345782,259828,19493,88463,2.40679536107303,0.25399163343296266
3957,0.3957,6,83,6,345865,259745,19499,88457,2.4060265293267626,0.25403932200274554
3958,0.3958,13,75,13,345940,259670,19512,88444,2.4053318018451963,0.25406619670567687
3959,0.3959,11,87,11,346027,259583,19523,88433,2.4045259179665788,0.254106133051354
3960,0.396,8,95,8,346122,259488,19531,88425,2.4036459298232615,0.2541583671780014
3961,0.3961,13,89,13,346211,259399,19544,88412,2.402821519878469,0.2541955257309286
3962,0.3962,12,91,12,346302,259308,19556,88400,2.4019785838675016,0.254236313228341
3963,0.3963,12,87,12,346389,259221,19568,88388,2.4011726999888845,0.2542741988843787
3964,0.3964,4,94,4,346483,259127,19572,88384,2.4003019748786545,0.2543343951702248
3965,0.3965,8,89,8,346572,259038,19580,88376,2.399477564933862,0.2543823795241412
3966,0.3966,12,88,12,346660,258950,19592,88364,2.398662418022157,0.2544210714224016
3967,0.3967,9,80,9,346740,258870,19601,88355,2.397921375375153,0.25446036431708546
3968,0.3968,7,100,7,346840,258770,19608,88348,2.3969950720663973,0.25451863631387595
3969,0.3969,9,78,9,346918,258692,19617,88339,2.3962725554855684,0.2545565093608352
3970,0.397,13,84,13,347002,258608,19630,88326,2.395494460706214,0.25459021024171746
3971,0.3971,10,92,10,347094,258516,19640,88316,2.3946422616621588,0.2546362504036536
3972,0.3972,13,82,13,347176,258434,19653,88303,2.393882692948979,0.2546685239821536
3973,0.3973,4,78,4,347254,258356,19657,88299,2.39316017636815,0.2547172260604924
3974,0.3974,13,81,13,347335,258275,19670,88286,2.392409870688058,0.25474880324098786
3975,0.3975,15,77,15,347412,258198,19685,88271,2.3916966171403162,0.25477315430817765
3976,0.3976,8,90,8,347502,258108,19693,88263,2.3908629441624365,0.25482214157651767
3977,0.3977,6,81,6,347583,258027,19699,88257,2.3901126384823446,0.2548688359843366
3978,0.3978,11,92,11,347675,257935,19710,88246,2.3892604394382895,0.2549128923886637
3979,0.3979,9,69,9,347744,257866,19719,88237,2.3886212901552484,0.25494433737933503
3980,0.398,11,71,11,347815,257795,19730,88226,2.387963614806032,0.2549729640686548
3981,0.3981,18,96,18,347911,257699,19748,88208,2.387074363629627,0.2550049579800351
3982,0.3982,9,85,9,347996,257614,19757,88199,2.386287005817185,0.25504824861991887
3983,0.3983,14,80,14,348076,257534,19771,88185,2.3855459631701805,0.2550771001883032
3984,0.3984,13,88,13,348164,257446,19784,88172,2.3847308162584757,0.255114027625876
3985,0.3985,8,87,8,348251,257359,19792,88164,2.3839249323798586,0.2551610167774649
3986,0.3986,16,66,16,348317,257293,19808,88148,2.38331357219608,0.2551752687144838
3987,0.3987,12,73,12,348390,257220,19820,88136,2.3826373707806883,0.25520332642259
3988,0.3988,9,89,9,348479,257131,19829,88127,2.381812960835896,0.25524969732779546
3989,0.3989,12,80,12,348559,257051,19841,88115,2.381071918188892,0.25528296529785666
3990,0.399,15,70,15,348629,256981,19856,88100,2.380423505872763,0.2553023782822004
3991,0.3991,11,80,11,348709,256901,19867,88089,2.3796824632257585,0.25533783587930087
3992,0.3992,9,82,9,348791,256819,19876,88080,2.3789228945125793,0.25537911098611477
3993,0.3993,13,105,13,348896,256714,19889,88067,2.377950276038386,0.25542880843201915
3994,0.3994,12,93,12,348989,256621,19901,88055,2.3770888139612434,0.25547180540565634
3995,0.3995,10,88,10,349077,256533,19911,88045,2.3762736670495386,0.2555154420769753
3996,0.3996,18,82,18,349159,256451,19929,88027,2.3755140983363594,0.25553736377939956
3997,0.3997,7,77,7,349236,256374,19936,88020,2.3748008447886177,0.2555793654941724
3998,0.3998,9,98,9,349334,256276,19945,88011,2.3738930675460375,0.25563265531373536
3999,0.3999,10,100,10,349434,256176,19955,88001,2.372966764237282,0.2556853014582613
4000,0.4,13,73,13,349507,256103,19968,87988,2.3722905628218904,0.255711425175317
4001,0.4001,8,76,8,349583,256027,19976,87980,2.3715865723072365,0.25575060972596486
4002,0.4002,11,85,11,349668,255942,19987,87969,2.3707992144947942,0.25579001544004115
4003,0.4003,5,93,5,349761,255849,19992,87964,2.3699377524176515,0.25584838269640764
4004,0.4004,6,85,6,349846,255764,19998,87958,2.3691503946052097,0.2558986622910375
4005,0.4005,11,92,11,349938,255672,20009,87947,2.3682981955611546,0.25594335586798167
4006,0.4006,15,71,15,350009,255601,20024,87932,2.367640520211938,0.25596376476204613
4007,0.4007,15,88,15,350097,255513,20039,87917,2.3668253733002333,0.25599685525434585
4008,0.4008,15,75,15,350172,255438,20054,87902,2.366130645818667,0.2560202714510398
4009,0.4009,6,88,6,350260,255350,20060,87896,2.3653154989069622,0.2560729039814011
4010,0.401,10,78,10,350338,255272,20070,87886,2.364592982326133,0.25610943064127895
4011,0.4011,14,79,14,350417,255193,20084,87872,2.363861202712216,0.25613804964073866
4012,0.4012,10,88,10,350505,255105,20094,87862,2.3630460558005115,0.2561820816580021
4013,0.4013,9,91,9,350596,255014,20103,87853,2.3622031197895437,0.25623055003835304
4014,0.4014,13,81,13,350677,254933,20116,87840,2.361452814109452,0.25626289118454487
4015,0.4015,17,92,17,350769,254841,20133,87823,2.360600615065397,0.2562947960684519
4016,0.4016,9,75,9,350844,254766,20142,87814,2.3599058875838304,0.25633136785568333
4017,0.4017,7,89,7,350933,254677,20149,87807,2.3590814776390383,0.2563827799254856
4018,0.4018,17,79,17,351012,254598,20166,87790,2.3583496980251213,0.2564050141944227
4019,0.4019,9,76,9,351088,254522,20175,87781,2.3576457075104673,0.25644239168222305
4020,0.402,11,80,11,351168,254442,20186,87770,2.356904664863463,0.2564784402650988
4021,0.4021,16,83,16,351251,254359,20202,87754,2.3561358331171958,0.2565058913283038
4022,0.4022,16,91,16,351342,254268,20218,87738,2.3552928971062284,0.25653935895861474
4023,0.4023,6,93,6,351435,254175,20224,87732,2.354431435029086,0.25659609191973254
4024,0.4024,6,89,6,351524,254086,20230,87726,2.3536070250842935,0.2566498543058757
4025,0.4025,8,89,8,351613,253997,20238,87718,2.3527826151395015,0.25669929619712334
4026,0.4026,12,91,12,351704,253906,20250,87706,2.3519396791285336,0.25674156645551094
4027,0.4027,16,82,16,351786,253824,20266,87690,2.3511801104153545,0.256768390168485
4028,0.4028,13,81,13,351867,253743,20279,87677,2.3504298047352625,0.25680100755667506
4029,0.4029,12,81,12,351948,253662,20291,87665,2.3496794990551706,0.2568358201958825
4030,0.403,13,64,13,352012,253598,20304,87652,2.349086664937567,0.2568556776556777
4031,0.4031,8,76,8,352088,253522,20312,87644,2.348382674422913,0.2568954702402936
4032,0.4032,18,77,18,352165,253445,20330,87626,2.3476694208751714,0.2569142495257586
4033,0.4033,12,83,12,352248,253362,20342,87614,2.3469005891289045,0.25695063582187605
4034,0.4034,17,80,17,352328,253282,20359,87597,2.3461595464819,0.25697388222800466
4035,0.4035,7,83,7,352411,253199,20366,87590,2.345390714735633,0.25702120667040307
4036,0.4036,15,83,15,352494,253116,20381,87575,2.344621882989366,0.25705111083063537
4037,0.4037,9,85,9,352579,253031,20390,87566,2.343834525176924,0.2570956291452949
4038,0.4038,12,74,12,352653,252957,20402,87554,2.343149060728445,0.2571253204742284
4039,0.4039,11,81,11,352734,252876,20413,87543,2.342398755048353,0.2571624968054075
4040,0.404,13,84,13,352818,252792,20426,87530,2.3416206602689984,0.2571975952186459
4041,0.4041,7,73,7,352891,252719,20433,87523,2.340944458853607,0.2572374956648503
4042,0.4042,11,77,11,352968,252642,20444,87512,2.3402312053058654,0.25727170634477325
4043,0.4043,8,88,8,353056,252554,20452,87504,2.3394160583941606,0.2573208099794741
4044,0.4044,11,83,11,353139,252471,20463,87493,2.3386472266478937,0.25735960278147096
4045,0.4045,13,68,13,353207,252403,20476,87480,2.33801734039794,0.25738268757189975
4046,0.4046,16,79,16,353286,252324,20492,87464,2.3372855607840233,0.25740756000800497
4047,0.4047,8,69,8,353355,252255,20500,87456,2.3366464115009817,0.2574423554138665
4048,0.4048,14,72,14,353427,252183,20514,87442,2.335979473118678,0.2574663231505337
4049,0.4049,7,83,7,353510,252100,20521,87435,2.335210641372411,0.2575139529061805
4050,0.405,17,80,17,353590,252020,20538,87418,2.3344695987254065,0.2575374589763079
4051,0.4051,14,107,14,353697,251913,20552,87404,2.3334784541850384,0.2575880371452064
4052,0.4052,11,80,11,353777,251833,20563,87393,2.332737411538034,0.2576247103700778
4053,0.4053,13,85,13,353862,251748,20576,87380,2.331950053725592,0.25766082423155856
4054,0.4054,7,91,7,353953,251657,20583,87373,2.3311071177146245,0.25771465652007197
4055,0.4055,6,72,6,354025,251585,20589,87367,2.3304401793323204,0.25775626047345934
4056,0.4056,11,83,11,354108,251502,20600,87356,2.3296713475860535,0.2577953006864232
4057,0.4057,13,89,13,354197,251413,20613,87343,2.328846937641261,0.25783454757996904
4058,0.4058,7,77,7,354274,251336,20620,87336,2.3281336840935194,0.2578778286956111
4059,0.4059,14,97,14,354371,251239,20634,87322,2.327235169884027,0.2579210245716429
4060,0.406,7,69,7,354440,251170,20641,87315,2.3265960206009857,0.25795825516640325
4061,0.4061,20,86,20,354526,251084,20661,87295,2.325799399755456,0.2579799573850623
4062,0.4062,7,96,7,354622,250988,20668,87288,2.324910148579051,0.2580378152751008
4063,0.4063,11,79,11,354701,250909,20679,87277,2.324178368965134,0.25807395930050325
4064,0.4064,8,80,8,354781,250829,20687,87269,2.3234373263181296,0.25811746889954984
4065,0.4065,9,89,9,354870,250740,20696,87260,2.322612916373337,0.2581656804733728
4066,0.4066,8,97,8,354967,250643,20704,87252,2.3217144021638445,0.25822222879888723
4067,0.4067,8,90,8,355057,250553,20712,87244,2.3208807291859648,0.2582734600958564
4068,0.4068,14,73,14,355130,250480,20726,87230,2.3202045277705734,0.2582985401675994
4069,0.4069,6,72,6,355202,250408,20732,87224,2.3195375893882693,0.2583404416642972
4070,0.407,6,94,6,355296,250314,20738,87218,2.3186668642780393,0.2583992036310631
4071,0.4071,10,86,10,355382,250228,20748,87208,2.3178702434325094,0.2584430825400965
4072,0.4072,11,68,11,355450,250160,20759,87197,2.317240357182556,0.2584709966000409
4073,0.4073,10,81,10,355531,250079,20769,87187,2.316490051502464,0.25851108620495394
4074,0.4074,7,90,7,355621,249989,20776,87180,2.3156563785245843,0.2585646960426374
4075,0.4075,6,98,6,355719,249891,20782,87174,2.314748601282004,0.2586266743803124
4076,0.4076,10,83,10,355802,249808,20792,87164,2.3139797695357367,0.2586683760075021
4077,0.4077,9,85,9,355887,249723,20801,87155,2.3131924117232945,0.2587138370567386
4078,0.4078,13,74,13,355961,249649,20814,87142,2.312506947274816,0.25874206852320875
4079,0.4079,12,79,12,356040,249570,20826,87130,2.311775167660899,0.2587763587763588
4080,0.408,8,76,8,356116,249494,20834,87122,2.311071177146245,0.258817168524372
4081,0.4081,14,82,14,356198,249412,20848,87108,2.3103116084330653,0.25884939973849996
4082,0.4082,9,82,9,356280,249330,20857,87099,2.309552039719886,0.2588926638310015
4083,0.4083,13,64,13,356344,249266,20870,87086,2.3089592056022825,0.2589132813243269
4084,0.4084,12,84,12,356428,249182,20882,87074,2.308181110822928,0.25895151313285114
4085,0.4085,10,92,10,356520,249090,20892,87064,2.307328911778873,0.2590003391302796
4086,0.4086,9,75,9,356595,249015,20901,87055,2.306634184297306,0.25903829559318
4087,0.4087,9,93,9,356688,248922,20910,87046,2.305772722220164,0.2590901514429946
4088,0.4088,15,86,15,356774,248836,20925,87031,2.304976101374634,0.2591234030136929
4089,0.4089,10,69,10,356843,248767,20935,87021,2.304336952091593,0.2591545856314103
4090,0.409,15,80,15,356923,248687,20950,87006,2.3035959094445886,0.2591832418310778
4091,0.4091,10,77,10,357000,248610,20960,86996,2.302882655896847,0.2592206337193018
4092,0.4092,7,91,7,357091,248519,20967,86989,2.3020397198858795,0.25927548672460865
4093,0.4093,4,80,4,357171,248439,20971,86985,2.3012986772388753,0.25932849170005723
4094,0.4094,10,69,10,357240,248370,20981,86975,2.3006595279558337,0.2593597638253142
4095,0.4095,14,82,14,357322,248288,20995,86961,2.2998999592426546,0.25939227260931425
4096,0.4096,11,85,11,357407,248203,21006,86950,2.2991126014302123,0.2594337511524587
4097,0.4097,9,70,9,357477,248133,21015,86941,2.2984641891140836,0.25946805780215715
4098,0.4098,8,84,8,357561,248049,21023,86933,2.297686094334729,0.2595154366503275
4099,0.4099,13,74,13,357635,247975,21036,86920,2.29700062988625,0.25954403619044775
4100,0.41,11,68,11,357703,247907,21047,86909,2.296370743636296,0.2595724218675332
4101,0.4101,13,92,13,357795,247815,21060,86896,2.2955185445922415,0.25961501115888036
4102,0.4102,7,73,7,357868,247742,21067,86889,2.2948423431768497,0.25965615857466884
4103,0.4103,15,100,15,357968,247642,21082,86874,2.2939160398680944,0.2597005823338794
4104,0.4104,9,82,9,358050,247560,21091,86865,2.293156471154915,0.25974433729535773
4105,0.4105,7,83,7,358133,247477,21098,86858,2.292387639408648,0.2597933210701841
4106,0.4106,9,92,9,358225,247385,21107,86849,2.291535440364593,0.2598448990826786
4107,0.4107,9,86,9,358311,247299,21116,86840,2.2907388195190634,0.25989184141928956
4108,0.4108,15,64,15,358375,247235,21131,86825,2.29014598540146,0.2599083996886787
4109,0.4109,13,87,13,358462,247148,21144,86812,2.2893401015228427,0.25994729907773384
4110,0.411,14,98,14,358560,247050,21158,86798,2.2884323242802624,0.2599925714696509
4111,0.4111,8,66,8,358626,246984,21166,86790,2.287820964096484,0.2600262453037085
4112,0.4112,6,88,6,358714,246896,21172,86784,2.287005817184779,0.2600815152241669
4113,0.4113,17,88,17,358802,246808,21189,86767,2.2861906702730743,0.26011241849658995
4114,0.4114,11,73,11,358875,246735,21200,86756,2.285514468857683,0.26014495143796984
4115,0.4115,11,83,11,358958,246652,21211,86745,2.2847456371114157,0.2601853046068201
4116,0.4116,9,73,9,359031,246579,21220,86736,2.2840694356960243,0.2602223122271725
4117,0.4117,10,89,10,359120,246490,21230,86726,2.283245025751232,0.2602696149044464
4118,0.4118,8,74,8,359194,246416,21238,86718,2.282559561302753,0.2603096651797775
4119,0.4119,9,95,9,359289,246321,21247,86709,2.2816795731594355,0.2603639311773714
4120,0.412,9,75,9,359364,246246,21256,86700,2.2809848456778687,0.2604025878070318
4121,0.4121,13,84,13,359448,246162,21269,86687,2.280206750898514,0.26043941847504426
4122,0.4122,13,107,13,359555,246055,21282,86674,2.279215606358146,0.2604942761226103
4123,0.4123,8,86,8,359641,245969,21290,86666,2.2784189855126162,0.26054383934342445
4124,0.4124,10,98,10,359739,245871,21300,86656,2.277511208270036,0.26059838749936093
4125,0.4125,5,77,5,359816,245794,21305,86651,2.2767979547222943,0.26064762592308505
4126,0.4126,15,81,15,359897,245713,21320,86636,2.2760476490422024,0.2606777814887362
4127,0.4127,13,72,13,359969,245641,21333,86623,2.2753807106598987,0.26070534273950835
4128,0.4128,13,85,13,360054,245556,21346,86610,2.2745933528474565,0.26074312241469627
4129,0.4129,15,78,15,360132,245478,21361,86595,2.273870836266627,0.26077097505668934
4130,0.413,12,78,12,360210,245400,21373,86583,2.273148319685798,0.2608055231743794
4131,0.4131,11,94,11,360304,245306,21384,86572,2.2722775945755678,0.2608548924604825
4132,0.4132,12,83,12,360387,245223,21396,86560,2.271508762829301,0.26089341527444143
4133,0.4133,8,76,8,360463,245147,21404,86552,2.2708047723146465,0.26093536609998824
4134,0.4134,9,77,9,360540,245070,21413,86543,2.270091518766905,0.2609758966023648
4135,0.4135,5,92,5,360632,244978,21418,86538,2.26923931972285,0.26103717467633536
4136,0.4136,13,85,13,360717,244893,21431,86525,2.268451961910408,0.26107513774146246
4137,0.4137,2,83,2,360800,244810,21433,86523,2.267683130164141,0.2611360776016877
4138,0.4138,11,95,11,360895,244715,21444,86512,2.2668031420208234,0.2611864370960097
4139,0.4139,11,74,11,360969,244641,21455,86501,2.2661176775723444,0.2612202620024038
4140,0.414,11,75,11,361044,244566,21466,86490,2.2654229500907777,0.2612548934319269
4141,0.4141,10,85,10,361129,244481,21476,86480,2.2646355922783354,0.26129966974960794
4142,0.4142,8,85,8,361214,244396,21484,86472,2.2638482344658937,0.2613489367361002
4143,0.4143,8,92,8,361306,244304,21492,86464,2.2629960354218386,0.26140376336284044
4144,0.4144,11,93,11,361399,244211,21503,86453,2.262134573344696,0.2614527133283333
4145,0.4145,9,103,9,361502,244108,21512,86444,2.261180480936678,0.261514073428689
4146,0.4146,10,88,10,361590,244020,21522,86434,2.260365334024973,0.26156136708891403
4147,0.4147,18,90,18,361680,243930,21540,86416,2.2595316610470935,0.26159239100821563
4148,0.4148,11,86,11,361766,243844,21551,86405,2.2587350402015636,0.2616359171413085
4149,0.4149,4,93,4,361859,243751,21555,86401,2.2578735781244212,0.26170067120598994
4150,0.415,14,70,14,361929,243681,21569,86387,2.2572251658082925,0.26172485669619594
4151,0.4151,11,86,11,362015,243595,21580,86376,2.2564285449627626,0.2617684584402872
4152,0.4152,17,88,17,362103,243507,21597,86359,2.2556133980510578,0.2618002461605622
4153,0.4153,12,73,12,362176,243434,21609,86347,2.2549371966356664,0.26183133655365226
4154,0.4154,11,72,11,362248,243362,21620,86336,2.2542702582533627,0.26186388755770434
4155,0.4155,13,84,13,362332,243278,21633,86323,2.2534921634740077,0.26190151122114314
4156,0.4156,9,80,9,362412,243198,21642,86314,2.2527511208270035,0.26194493675495883
4157,0.4157,6,79,6,362491,243119,21648,86308,2.252019341213087,0.26199431133452933
4158,0.4158,14,72,14,362563,243047,21662,86294,2.2513524028307828,0.2620202161285719
4159,0.4159,13,84,13,362647,242963,21675,86281,2.250574308051428,0.26205792664406946
4160,0.416,18,90,18,362737,242873,21693,86263,2.2497406350735485,0.2620892275533518
4161,0.4161,19,73,19,362810,242800,21712,86244,2.249064433658157,0.2621047641044967
4162,0.4162,13,74,13,362884,242726,21725,86231,2.248378969209678,0.26213456469994556
4163,0.4163,14,85,14,362969,242641,21739,86217,2.247591611397236,0.2621709065919029
4164,0.4164,17,79,17,363048,242562,21756,86200,2.2468598317833193,0.2621957525504772
4165,0.4165,11,71,11,363119,242491,21767,86189,2.246202156434103,0.2622276986734818
4166,0.4166,11,77,11,363196,242414,21778,86178,2.245488902886361,0.26226444953011635
4167,0.4167,5,72,5,363268,242342,21783,86173,2.244821964504057,0.26231070118563843
4168,0.4168,12,74,12,363342,242268,21795,86161,2.2441365000555784,0.26234285035730703
4169,0.4169,12,88,12,363430,242180,21807,86149,2.2433213531438736,0.2623862040818813
4170,0.417,7,83,7,363513,242097,21814,86142,2.2425525213976063,0.26243682194985973
4171,0.4171,7,93,7,363606,242004,21821,86135,2.241691059320464,0.26249546686008063
4172,0.4172,11,81,11,363687,241923,21832,86124,2.240940753640372,0.26253555130819667
4173,0.4173,5,85,5,363772,241838,21837,86119,2.24015339582793,0.2625923520461524
4174,0.4174,9,78,9,363850,241760,21846,86110,2.2394308792471005,0.2626345807789673
4175,0.4175,13,74,13,363924,241686,21859,86097,2.238745414798622,0.26266462873303376
4176,0.4176,6,99,6,364023,241587,21865,86091,2.237828374522954,0.2627304854155604
4177,0.4177,13,81,13,364104,241506,21878,86078,2.237078068842862,0.26276619126697276
4178,0.4178,10,87,10,364191,241419,21888,86068,2.236272184964245,0.262813485726151
4179,0.4179,6,82,6,364273,241337,21894,86062,2.2355126162510652,0.26286579983445274
4180,0.418,14,76,14,364349,241261,21908,86048,2.2348086257364113,0.2628953068812651
4181,0.4181,17,76,17,364425,241185,21925,86031,2.234104635221757,0.2629180724658941
4182,0.4182,10,83,10,364508,241102,21935,86021,2.23333580347549,0.26296224967367016
4183,0.4183,13,57,13,364565,241045,21948,86008,2.2328078105894993,0.2629787832553134
4184,0.4184,7,77,7,364642,240968,21955,86001,2.2320945570417576,0.26302493508558916
4185,0.4185,15,80,15,364722,240888,21970,85986,2.2313535143947534,0.2630554892710953
4186,0.4186,7,98,7,364820,240790,21977,85979,2.230445737152173,0.26311859448111663
4187,0.4187,11,92,11,364912,240698,21988,85968,2.229593538108118,0.2631678840160898
4188,0.4188,17,97,17,365009,240601,22005,85951,2.2286950238986254,0.26320769739582056
4189,0.4189,18,73,18,365082,240528,22023,85933,2.228018822483234,0.26322592897773395
4190,0.419,9,78,9,365160,240450,22032,85924,2.2272963059024047,0.26326852016398367
4191,0.4191,11,64,11,365224,240386,22043,85913,2.226703471784801,0.26329532116249205
4192,0.4192,7,64,7,365288,240322,22050,85906,2.226110637667198,0.26333116715916477
4193,0.4193,9,82,9,365370,240240,22059,85897,2.2253510689540184,0.2633770470691765
4194,0.4194,15,85,15,365455,240155,22074,85882,2.224563711141576,0.26341182135769864
4195,0.4195,9,100,9,365555,240055,22083,85873,2.223637407832821,0.26347230063081417
4196,0.4196,12,92,12,365647,239963,22095,85861,2.222785208788766,0.26351956884698485
4197,0.4197,12,94,12,365741,239869,22107,85849,2.221914483678536,0.2635684856225324
4198,0.4198,10,80,10,365821,239789,22117,85839,2.2211734410315316,0.2636106231650841
4199,0.4199,11,88,11,365909,239701,22128,85828,2.2203582941198268,0.26365700137314957
4200,0.42,17,84,17,365993,239617,22145,85811,2.2195801993404722,0.26368659119682386
4201,0.4201,16,74,16,366067,239543,22161,85795,2.218894734891993,0.2637103566137371
4202,0.4202,23,86,23,366153,239457,22184,85772,2.2180981140464633,0.26372801933406925
4203,0.4203,13,75,13,366228,239382,22197,85759,2.217403386564897,0.26375941514604434
4204,0.4204,15,82,15,366310,239300,22212,85744,2.2166438178517174,0.26379197893208306
4205,0.4205,15,86,15,366396,239214,22227,85729,2.2158471970061875,0.2638278098004881
4206,0.4206,8,76,8,366472,239138,22235,85721,2.2151432064915335,0.26387140267008147
4207,0.4207,7,89,7,366561,239049,22242,85714,2.2143187965467415,0.26392784892367666
4208,0.4208,8,80,8,366641,238969,22250,85706,2.2135777538997368,0.26397474397474396
4209,0.4209,13,69,13,366710,238900,22263,85693,2.2129386046166957,0.26400138018996094
4210,0.421,15,83,15,366793,238817,22278,85678,2.212169772870429,0.2640348849751152
4211,0.4211,5,88,5,366881,238729,22283,85673,2.211354625958724,0.26409516587443976
4212,0.4212,13,82,13,366963,238647,22296,85660,2.2105950572455444,0.2641324424079653
4213,0.4213,13,70,13,367033,238577,22309,85647,2.2099466449294156,0.26415996348203713
4214,0.4214,16,73,16,367106,238504,22325,85631,2.2092704435140242,0.2641831335708887
4215,0.4215,11,80,11,367186,238424,22336,85620,2.20852940086702,0.26422337707224947
4216,0.4216,13,83,13,367269,238341,22349,85607,2.2077605691207527,0.26426154814970304
4217,0.4217,11,74,11,367343,238267,22360,85596,2.207075104672274,0.2642969403729355
4218,0.4218,7,72,7,367415,238195,22367,85589,2.20640816628997,0.2643398067847701
4219,0.4219,16,93,16,367508,238102,22383,85573,2.2055467042128276,0.2643793929095543
4220,0.422,10,78,10,367586,238024,22393,85563,2.2048241876319983,0.264420387716441
4221,0.4221,5,76,5,367662,237948,22398,85558,2.2041201971173443,0.26447113809326567
4222,0.4222,12,77,12,367739,237871,22410,85546,2.2034069435696026,0.26450681318545405
4223,0.4223,12,77,12,367816,237794,22422,85534,2.2026936900218606,0.2645425079176564
4224,0.4224,13,86,13,367902,237708,22435,85521,2.201897069176331,0.26458331399719703
4225,0.4225,10,76,10,367978,237632,22445,85511,2.201193078661677,0.26462278310221793
4226,0.4226,13,96,13,368074,237536,22458,85498,2.2003038274852718,0.2646718302098231
4227,0.4227,15,85,15,368159,237451,22473,85483,2.1995164696728295,0.2647073395802238
4228,0.4228,5,85,5,368244,237366,22478,85478,2.1987291118603878,0.2647656453271549
4229,0.4229,11,103,11,368347,237263,22489,85467,2.1977750194523695,0.26482508598518884
4230,0.423,7,59,7,368406,237204,22496,85460,2.197228500500204,0.26485756080628764
4231,0.4231,10,75,10,368481,237129,22506,85450,2.196533773018637,0.26489635097138997
4232,0.4232,7,56,7,368537,237073,22513,85443,2.196015043165734,0.26492639124880624
4233,0.4233,6,72,6,368609,237001,22519,85437,2.1953481047834305,0.26497187056116217
4234,0.4234,11,76,11,368685,236925,22530,85426,2.194644114268776,0.26500926009225967
4235,0.4235,15,86,15,368771,236839,22545,85411,2.1938474934232466,0.26504577191621415
4236,0.4236,11,90,11,368861,236749,22556,85400,2.1930138204453664,0.2650947232491797
4237,0.4237,15,82,15,368943,236667,22571,85385,2.1922542517321872,0.26512799175288465
4238,0.4238,16,99,16,369042,236568,22587,85369,2.1913372114565193,0.265172999686274
4239,0.4239,11,85,11,369127,236483,22598,85358,2.190549853644077,0.26521791816455953
4240,0.424,11,80,11,369207,236403,22609,85347,2.189808810997073,0.26525874125874127
4241,0.4241,12,69,12,369276,236334,22621,85335,2.1891696617140317,0.26528823106982646
4242,0.4242,21,84,21,369360,236250,22642,85314,2.188391566934677,0.26530954957644515
4243,0.4243,9,81,9,369441,236169,22651,85305,2.1876412612545852,0.2653558297094011
4244,0.4244,10,78,10,369519,236091,22661,85295,2.186918744673756,0.2653973726297972
4245,0.4245,13,85,13,369604,236006,22674,85282,2.1861313868613137,0.2654378626030228
4246,0.4246,11,92,11,369696,235914,22685,85271,2.185279187817259,0.2654887370207201
4247,0.4247,15,95,15,369791,235819,22700,85256,2.1843991996739414,0.2655329751615666
4248,0.4248,8,94,8,369885,235725,22708,85248,2.1835284745637114,0.26559243300838387
4249,0.4249,6,73,6,369958,235652,22714,85242,2.1828522731483195,0.2656391207065261
4250,0.425,17,77,17,370035,235575,22731,85225,2.182139019600578,0.2656639650872818
4251,0.4251,15,82,15,370117,235493,22746,85210,2.1813794508873987,0.2656975457042809
4252,0.4252,2,81,2,370198,235412,22748,85208,2.1806291452073068,0.2657600898259622
4253,0.4253,15,72,15,370270,235340,22763,85193,2.1799622068250026,0.2657854261495696
4254,0.4254,8,101,8,370371,235239,22771,85185,2.1790266404831597,0.2658508725938132
4255,0.4255,13,73,13,370444,235166,22784,85172,2.1783504390677684,0.2658816624939907
4256,0.4256,13,68,13,370512,235098,22797,85159,2.1777205528178145,0.2659083173826021
4257,0.4257,8,70,8,370582,235028,22805,85151,2.1770721405016857,0.26594811027581444
4258,0.4258,11,93,11,370675,234935,22816,85140,2.1762106784245434,0.26600015621338746
4259,0.4259,14,86,14,370761,234849,22830,85126,2.1754140575790135,0.2660395343386202
4260,0.426,12,84,12,370845,234765,22842,85114,2.174635962799659,0.2660818622041459
4261,0.4261,10,104,10,370949,234661,22852,85104,2.1736726073585535,0.26614545056525885
4262,0.4262,19,63,19,371012,234598,22871,85085,2.1730890362740376,0.26615428408767433
4263,0.4263,13,79,13,371091,234519,22884,85072,2.1723572566601206,0.26619022438053636
4264,0.4264,11,69,11,371160,234450,22895,85061,2.1717181073770795,0.266222446175562
4265,0.4265,11,70,11,371230,234380,22906,85050,2.1710696950609507,0.2662555176407977
4266,0.4266,14,85,14,371315,234295,22920,85036,2.1702823372485085,0.2662942213565235
4267,0.4267,10,81,10,371396,234214,22930,85026,2.1695320315684166,0.26633880466107
4268,0.4268,16,79,16,371475,234135,22946,85010,2.1688002519545,0.26636795187140644
4269,0.4269,8,89,8,371564,234046,22954,85002,2.1679758420097075,0.26642386098643467
4270,0.427,10,74,10,371638,233972,22964,84992,2.1672903775612284,0.26646267290352516
4271,0.4271,13,58,13,371696,233914,22977,84979,2.1667531216421505,0.26648123351719855
4272,0.4272,13,92,13,371788,233822,22990,84966,2.1659009225980954,0.26652822565466705
4273,0.4273,14,79,14,371867,233743,23004,84952,2.165169142984179,0.266562073455812
4274,0.4274,10,90,10,371957,233653,23014,84942,2.1643354700062987,0.26661435364647906
4275,0.4275,19,85,19,372042,233568,23033,84923,2.163548112193857,0.2666417575378896
4276,0.4276,13,86,13,372128,233482,23046,84910,2.162751491348327,0.2666838362772934
4277,0.4277,10,97,10,372225,233385,23056,84900,2.1618529771388344,0.2667420707856167
4278,0.4278,8,64,8,372289,233321,23064,84892,2.161260143021231,0.2667772843975576
4279,0.4279,11,83,11,372372,233238,23075,84881,2.160491311274964,0.26682153533740516
4280,0.428,11,75,11,372447,233163,23086,84870,2.1597965837933972,0.26685909952740755
4281,0.4281,12,73,12,372520,233090,23098,84858,2.159120382378006,0.2668926994351278
4282,0.4282,17,88,17,372608,233002,23115,84841,2.158305235466301,0.2669273823869017
4283,0.4283,8,85,8,372693,232917,23123,84833,2.157517877653859,0.26698033044846575
4284,0.4284,12,97,12,372790,232820,23135,84821,2.156619363444366,0.26703416750356535
4285,0.4285,9,95,9,372885,232725,23144,84812,2.1557393753010485,0.26709328361734225
4286,0.4286,9,78,9,372963,232647,23153,84803,2.155016858720219,0.26713813198928965
4287,0.4287,11,75,11,373038,232572,23164,84792,2.154322131238653,0.26717586115627484
4288,0.4288,13,74,13,373112,232498,23177,84779,2.153636666790174,0.26720814934583975
4289,0.4289,11,71,11,373183,232427,23188,84768,2.1529789914409574,0.2672425479594571
4290,0.429,14,77,14,373260,232350,23202,84754,2.1522657378932157,0.2672750895605227
4291,0.4291,10,86,10,373346,232264,23212,84744,2.1514691170476863,0.26732448392469593
4292,0.4292,13,112,13,373458,232152,23225,84731,2.1504316573418802,0.26738891010246685
4293,0.4293,9,81,9,373539,232071,23234,84722,2.1496813516617883,0.26743646482087674
4294,0.4294,9,74,9,373613,231997,23243,84713,2.1489958872133093,0.2674781345710587
4295,0.4295,7,64,7,373677,231933,23250,84706,2.1484030530957057,0.2675160040298258
4296,0.4296,8,76,8,373753,231857,23258,84698,2.1476990625810517,0.26756171913253624
4297,0.4297,12,85,12,373838,231772,23270,84686,2.1469117047686095,0.2676058118296899
4298,0.4298,15,81,15,373919,231691,23285,84671,2.1461613990885176,0.26763960273357734
4299,0.4299,9,85,9,374004,231606,23294,84662,2.1453740412760753,0.2676906927036564
4300,0.43,12,91,12,374095,231515,23306,84650,2.144531105265108,0.2677399459143169
4301,0.4301,9,77,9,374172,231438,23315,84641,2.1438178517173663,0.2677843197428491
4302,0.4302,14,76,14,374248,231362,23329,84627,2.1431138612027123,0.2678162847440892
4303,0.4303,6,79,6,374327,231283,23335,84621,2.1423820815887953,0.26786935271474877
4304,0.4304,12,93,12,374420,231190,23347,84609,2.141520619511653,0.267920417734065
4305,0.4305,11,74,11,374494,231116,23358,84598,2.140835155063174,0.2679577085590123
4306,0.4306,13,80,13,374574,231036,23371,84585,2.1400941124161696,0.2679954755862253
4307,0.4307,13,78,13,374652,230958,23384,84572,2.1393715958353403,0.268031565936678
4308,0.4308,7,75,7,374727,230883,23391,84565,2.1386768683537736,0.26807904947883643
4309,0.4309,7,85,7,374812,230798,23398,84558,2.137889510541332,0.2681350600591078
4310,0.431,16,83,16,374895,230715,23414,84542,2.1371206787950645,0.2681685101361746
4311,0.4311,9,85,9,374980,230630,23423,84533,2.1363333209826227,0.2682199369849887
4312,0.4312,14,79,14,375059,230551,23437,84519,2.1356015413687057,0.2682546735646047
4313,0.4313,12,97,12,375156,230454,23449,84507,2.134703027159213,0.26830940973644357
4314,0.4314,10,89,10,375245,230365,23459,84497,2.1338786172144206,0.2683620125642345
4315,0.4315,8,79,8,375324,230286,23467,84489,2.133146837600504,0.2684107695973314
4316,0.4316,12,85,12,375409,230201,23479,84477,2.132359479788062,0.26845537342934683
4317,0.4317,14,95,14,375504,230106,23493,84463,2.131479491644744,0.2685038894487378
4318,0.4318,8,74,8,375578,230032,23501,84455,2.130794027196265,0.268548461462636
4319,0.4319,6,84,6,375662,229948,23507,84449,2.1300159324169106,0.2686062526041915
4320,0.432,16,65,16,375727,229883,23523,84433,2.1294138352662197,0.2686245689051782
4321,0.4321,8,78,8,375805,229805,23531,84425,2.1286913186853904,0.2686726283295675
4322,0.4322,11,65,11,375870,229740,23542,84414,2.128089221534699,0.26870261082144425
4323,0.4323,15,77,15,375947,229663,23557,84399,2.1273759679869575,0.268733562162885
4324,0.4324,15,98,15,376045,229565,23572,84384,2.126468190744377,0.26878250926105834
4325,0.4325,12,79,12,376124,229486,23584,84372,2.1257364111304606,0.26882220622064756
4326,0.4326,13,81,13,376205,229405,23597,84359,2.1249861054503687,0.26886130977422523
4327,0.4327,13,74,13,376279,229331,23610,84346,2.1243006410018896,0.26889443599626367
4328,0.4328,17,86,17,376365,229245,23627,84329,2.12350402015636,0.2689285463718293
4329,0.4329,11,70,11,376435,229175,23638,84318,2.1228556078402314,0.2689629433512072
4330,0.433,22,91,22,376526,229084,23660,84296,2.1220126718292636,0.26898972493458423
4331,0.4331,13,78,13,376604,229006,23673,84283,2.1212901552484347,0.2690263622406149
4332,0.4332,14,101,14,376705,228905,23687,84269,2.120354588906592,0.26908044729128217
4333,0.4333,17,87,17,376792,228818,23704,84252,2.119548705027974,0.2691155332673204
4334,0.4334,11,88,11,376880,228730,23715,84241,2.1187335581162694,0.26916551373769454
4335,0.4335,9,69,9,376949,228661,23724,84232,2.1180944088332283,0.26920384923919677
4336,0.4336,10,86,10,377035,228575,23734,84222,2.117297787987699,0.2692545005227032
4337,0.4337,14,75,14,377110,228500,23748,84208,2.116603060506132,0.2692863629967893
4338,0.4338,9,74,9,377184,228426,23757,84199,2.115917596057653,0.2693290683726509
4339,0.4339,15,78,15,377262,228348,23772,84184,2.1151950794768237,0.26936121741133706
4340,0.434,12,78,12,377340,228270,23784,84172,2.114472562895995,0.2694004007143726
4341,0.4341,9,89,9,377429,228181,23793,84163,2.1136481529512023,0.2694561124913557
4342,0.4342,12,98,12,377527,228083,23805,84151,2.112740375708622,0.26951260913289393
4343,0.4343,8,86,8,377613,227997,23813,84143,2.111943754863092,0.2695681425001602
4344,0.4344,13,68,13,377681,227929,23826,84130,2.1113138686131387,0.26959645451661385
4345,0.4345,14,87,14,377768,227842,23840,84116,2.1105079847345216,0.26963886164163126
4346,0.4346,8,84,8,377852,227758,23848,84108,2.109729889955167,0.2696927526565897
4347,0.4347,5,76,5,377928,227682,23853,84103,2.1090258994405127,0.2697467806340908
4348,0.4348,11,82,11,378010,227600,23864,84092,2.1082663307273335,0.26979197412830613
4349,0.4349,13,76,13,378086,227524,23877,84079,2.107562340212679,0.2698273123172755
4350,0.435,10,79,10,378165,227445,23887,84069,2.1068305605987625,0.2698723010843814
4351,0.4351,9,86,9,378251,227359,23896,84060,2.1060339397532326,0.26992572707509815
4352,0.4352,11,79,11,378330,227280,23907,84049,2.105302160139316,0.2699684256847258
4353,0.4353,7,76,7,378406,227204,23914,84042,2.104598169624662,0.27001792794124263
4354,0.4354,11,73,11,378479,227131,23925,84031,2.1039219682092702,0.2700554694982035
4355,0.4355,13,66,13,378545,227065,23938,84018,2.1033106080254917,0.2700822610042979
4356,0.4356,12,77,12,378622,226988,23950,84006,2.10259735447775,0.27012096696399285
4357,0.4357,11,61,11,378683,226927,23961,83995,2.1020323094594096,0.2701481400479863
4358,0.4358,10,67,10,378750,226860,23971,83985,2.1014116862425434,0.2701828885779086
4359,0.4359,12,73,12,378823,226787,23983,83973,2.100735484827152,0.2702181747972712
4360,0.436,10,87,10,378910,226700,23993,83963,2.0999296009485344,0.2702703572681652
4361,0.4361,11,75,11,378985,226625,24004,83952,2.099234873466968,0.2703097782514481
4362,0.4362,11,82,11,379067,226543,24015,83941,2.0984753047537885,0.2703553162159725
4363,0.4363,14,74,14,379141,226469,24029,83927,2.0977898403053095,0.27038686065542084
4364,0.4364,13,97,13,379238,226372,24042,83914,2.096891326095817,0.27044081911526785
4365,0.4365,9,89,9,379327,226283,24051,83905,2.0960669161510244,0.2704972468309541
4366,0.4366,10,75,10,379402,226208,24061,83895,2.095372188669458,0.2705391434458873
4367,0.4367,9,95,9,379497,226113,24070,83886,2.0944922005261404,0.2706008729060416
4368,0.4368,15,87,15,379584,226026,24085,83871,2.0936863166475232,0.27064153573606714
4369,0.4369,9,99,9,379683,225927,24094,83862,2.0927692763718553,0.27070683594317424
4370,0.437,11,72,11,379755,225855,24105,83851,2.092102337989551,0.2707438667639632
4371,0.4371,14,78,14,379833,225777,24119,83837,2.0913798214087223,0.27077909913634396
4372,0.4372,9,85,9,379918,225692,24128,83828,2.09059246359628,0.2708322563970018
4373,0.4373,11,90,11,380008,225602,24139,83817,2.0897587906184003,0.2708851104812568
4374,0.4374,7,84,7,380092,225518,24146,83810,2.0889806958390453,0.2709421714167486
4375,0.4375,9,85,9,380177,225433,24155,83801,2.0881933380266036,0.2709954274109574
4376,0.4376,13,88,13,380265,225345,24168,83788,2.0873781911148988,0.271041913998182
4377,0.4377,10,83,10,380348,225262,24178,83778,2.0866093593686315,0.27109112089049964
4378,0.4378,11,66,11,380414,225196,24189,83767,2.085997999184853,0.27112307946258934
4379,0.4379,11,73,11,380487,225123,24200,83756,2.0853217977694616,0.27116119904558095
4380,0.438,19,78,19,380565,225045,24219,83737,2.0845992811886322,0.2711848488577702
4381,0.4381,11,66,11,380631,224979,24230,83726,2.0839879210048537,0.27121685751769486
4382,0.4382,12,90,12,380721,224889,24242,83714,2.083154248026974,0.27126761567450736
4383,0.4383,14,86,14,380807,224803,24256,83700,2.082357627181444,0.27131016554133996
4384,0.4384,14,86,14,380893,224717,24270,83686,2.0815610063359147,0.27135274300185147
4385,0.4385,15,71,15,380964,224646,24285,83671,2.080903330986698,0.2713797811992203
4386,0.4386,13,66,13,381030,224580,24298,83658,2.0802919708029197,0.27140715940279914
4387,0.4387,14,71,14,381101,224509,24312,83644,2.0796342954537033,0.27143659156328187
4388,0.4388,14,85,14,381186,224424,24326,83630,2.078846937641261,0.27147837716763945
4389,0.4389,7,88,7,381274,224336,24333,83623,2.0780317907295567,0.2715393932309171
4390,0.439,10,72,10,381346,224264,24343,83613,2.0773648523472525,0.2715792345644527
4391,0.4391,14,77,14,381423,224187,24357,83599,2.076651598799511,0.271614043523747
4392,0.4392,10,97,10,381520,224090,24367,83589,2.0757530845900183,0.27167599998699943
4393,0.4393,14,90,14,381610,224000,24381,83575,2.074919411612138,0.2717223441437048
4394,0.4394,7,97,7,381707,223903,24388,83568,2.0740208974026455,0.2717914860263244
4395,0.4395,10,75,10,381782,223828,24398,83558,2.0733261699210788,0.2718341108573585
4396,0.4396,10,82,10,381864,223746,24408,83548,2.0725666012078996,0.27188295248198796
4397,0.4397,14,81,14,381945,223665,24422,83534,2.0718162955278077,0.271921458077663
4398,0.4398,9,82,9,382027,223583,24431,83525,2.071056726814628,0.2719727262070672
4399,0.4399,11,64,11,382091,223519,24442,83514,2.070463892697025,0.2720033351463849
4400,0.44,11,79,11,382170,223440,24453,83503,2.069732113083108,0.2720472530730461
4401,0.4401,15,101,15,382271,223339,24468,83488,2.068796546741265,0.27210121664651415
4402,0.4402,12,80,12,382351,223259,24480,83476,2.0680555040942608,0.2721437071087421
4403,0.4403,11,80,11,382431,223179,24491,83465,2.0673144614472565,0.2721885965484405
4404,0.4404,11,76,11,382507,223103,24502,83454,2.066610470932602,0.27222996049674286
4405,0.4405,12,82,12,382589,223021,24514,83442,2.065850902219423,0.27227430391270724
4406,0.4406,9,62,9,382651,222959,24523,83433,2.0652765941679943,0.2723080237081908
4407,0.4407,12,75,12,382726,222884,24535,83421,2.064581866686428,0.27234619088816703
4408,0.4408,17,80,17,382806,222804,24552,83404,2.0638408240394233,0.27237694638938237
4409,0.4409,14,78,14,382884,222726,24566,83390,2.0631183074585944,0.27241307216872035
4410,0.441,12,74,12,382958,222652,24578,83378,2.0624328430101153,0.2724504133581675
4411,0.4411,11,70,11,383028,222582,24589,83367,2.0617844306939865,0.2724865909024053
4412,0.4412,19,92,19,383120,222490,24608,83348,2.0609322316499314,0.27252336204134214
4413,0.4413,14,94,14,383214,222396,24622,83334,2.0600615065397014,0.27257383966244725
4414,0.4414,11,69,11,383283,222327,24633,83323,2.0594223572566603,0.2726091935220023
4415,0.4415,8,80,8,383363,222247,24641,83315,2.0586813146096556,0.2726615220478986
4416,0.4416,13,80,13,383443,222167,24654,83302,2.0579402719626514,0.2727019763052879
4417,0.4417,17,82,17,383525,222085,24671,83285,2.057180703249472,0.2727347152634509
4418,0.4418,14,75,14,383600,222010,24685,83271,2.0564859757679055,0.27276836750403727
4419,0.4419,15,71,15,383671,221939,24700,83256,2.055828300418689,0.27279608119399074
4420,0.442,9,65,9,383736,221874,24709,83247,2.055226203267998,0.27283274504213084
4421,0.4421,13,79,13,383815,221795,24722,83234,2.054494423654081,0.2728724154096824
4422,0.4422,11,70,11,383885,221725,24733,83223,2.0538460113379524,0.27290882379946746
4423,0.4423,14,90,14,383975,221635,24747,83209,2.0530123383600727,0.2729560037264962
4424,0.4424,18,65,18,384040,221570,24765,83191,2.0524102412093814,0.2729712791334849
4425,0.4425,20,83,20,384123,221487,24785,83171,2.0516414094631146,0.2729979189780016
4426,0.4426,11,85,11,384208,221402,24796,83160,2.0508540516506724,0.27304785232563483
4427,0.4427,10,78,10,384286,221324,24806,83150,2.0501315350698435,0.2730939259181408
4428,0.4428,11,99,11,384385,221225,24817,83139,2.0492144947941755,0.2731564836840099
4429,0.4429,9,81,9,384466,221144,24826,83130,2.0484641891140836,0.27320770095374564
4430,0.443,10,61,10,384527,221083,24836,83120,2.0478991440957426,0.273238593965214
4431,0.4431,13,76,13,384603,221007,24849,83107,2.0471951535810886,0.2732758110445425
4432,0.4432,8,102,8,384705,220905,24857,83099,2.046250324206158,0.27334837699503955
4433,0.4433,16,82,16,384787,220823,24873,83083,2.0454907554929784,0.27338387527722385
4434,0.4434,11,84,11,384871,220739,24884,83072,2.044712660713624,0.2734331541649249
4435,0.4435,13,73,13,384944,220666,24897,83059,2.0440364592982325,0.2734677751255247
4436,0.4436,16,72,16,385016,220594,24913,83043,2.043369520915929,0.2734943369879165
4437,0.4437,6,97,6,385113,220497,24919,83037,2.0424710067064358,0.2735673763071023
4438,0.4438,9,68,9,385181,220429,24928,83028,2.0418411204564824,0.2736071337949034
4439,0.4439,19,84,19,385265,220345,24947,83009,2.041063025677128,0.2736374005287552
4440,0.444,18,92,18,385357,220253,24965,82991,2.0402108266330727,0.27367730276608937
4441,0.4441,10,75,10,385432,220178,24975,82981,2.039516099151506,0.27372105066978053
4442,0.4442,12,78,12,385510,220100,24987,82969,2.038793582570677,0.2737627404980384
4443,0.4443,15,65,15,385575,220035,25002,82954,2.038191485419986,0.2737855169659625
4444,0.4444,10,75,10,385650,219960,25012,82944,2.0374967579384196,0.27382933206560495
4445,0.4445,14,70,14,385720,219890,25026,82930,2.036848345622291,0.27385905818638134
4446,0.4446,9,93,9,385813,219797,25035,82921,2.035986883545148,0.273921603604675
4447,0.4447,7,94,7,385907,219703,25042,82914,2.035116158434918,0.27398989481754166
4448,0.4448,9,77,9,385984,219626,25051,82905,2.0344029048871763,0.2740380324660944
4449,0.4449,13,69,13,386053,219557,25064,82892,2.033763755604135,0.274069347228789
4450,0.445,17,79,17,386132,219478,25081,82875,2.0330319759902182,0.27410014122565346
4451,0.4451,9,74,9,386206,219404,25090,82866,2.032346511541739,0.2741456313891554
4452,0.4452,14,82,14,386288,219322,25104,82852,2.03158694282856,0.2741863959175839
4453,0.4453,11,77,11,386365,219245,25115,82841,2.030873689280818,0.2742298550743828
4454,0.4454,15,79,15,386444,219166,25130,82826,2.0301419096669013,0.27426554345810483
4455,0.4455,7,86,7,386530,219080,25137,82819,2.029345288821372,0.27432684440822924
4456,0.4456,16,80,16,386610,219000,25153,82803,2.028604246174367,0.2743610898500015
4457,0.4457,15,71,15,386681,218929,25168,82788,2.027946570825151,0.27438957698770705
4458,0.4458,17,66,17,386747,218863,25185,82771,2.0273352106413722,0.2744087205023306
4459,0.4459,9,79,9,386826,218784,25194,82762,2.0266034310274557,0.2744589548526593
4460,0.446,12,85,12,386911,218699,25206,82750,2.0258160732150134,0.27450746229047035
4461,0.4461,11,74,11,386985,218625,25217,82739,2.0251306087665344,0.27454838666861336
4462,0.4462,10,78,10,387063,218547,25227,82729,2.0244080921857055,0.2745953876179981
4463,0.4463,10,72,10,387135,218475,25237,82719,2.0237411538034014,0.27463694495906293
4464,0.4464,18,91,18,387226,218384,25255,82701,2.022898217792434,0.27467658634604847
4465,0.4465,19,69,19,387295,218315,25274,82682,2.022259068509393,0.27469376771197057
4466,0.4466,12,88,12,387383,218227,25286,82670,2.021443921597688,0.27474517858270436
4467,0.4467,11,77,11,387460,218150,25297,82659,2.0207306680499464,0.2747889857018906
4468,0.4468,14,67,14,387527,218083,25311,82645,2.02011004483308,0.27481644542576683
4469,0.4469,12,88,12,387615,217995,25323,82633,2.0192948979213754,0.2748679431057653
4470,0.447,15,92,15,387707,217903,25338,82618,2.0184426988773203,0.27491589606050826
4471,0.4471,15,77,15,387784,217826,25353,82603,2.0177294453295787,0.2749501546122378
4472,0.4472,11,91,11,387875,217735,25364,82592,2.0168865093186112,0.27500690913570874
4473,0.4473,13,80,13,387955,217655,25377,82579,2.016145466671607,0.2750487952730204
4474,0.4474,16,76,16,388031,217579,25393,82563,2.015441476156953,0.2750797955634333
4475,0.4475,12,78,12,388109,217501,25405,82551,2.0147189595761237,0.27512231213256366
4476,0.4476,6,75,6,388184,217426,25411,82545,2.014024232094557,0.27517660040470576
4477,0.4477,9,78,9,388262,217348,25420,82536,2.0133017155137276,0.27522642088274135
4478,0.4478,13,83,13,388345,217265,25433,82523,2.0125328837674608,0.27527119164209374
4479,0.4479,8,76,8,388421,217189,25441,82515,2.011828893252807,0.27532165069535275
4480,0.448,8,67,8,388488,217122,25449,82507,2.0112082700359406,0.2753638666484219
4481,0.4481,10,78,10,388566,217044,25459,82497,2.0104857534551113,0.27541137941049804
4482,0.4482,8,71,8,388637,216973,25467,82489,2.009828078105895,0.2754573201274285
4483,0.4483,10,67,10,388704,216906,25477,82479,2.009207454889029,0.27549476426674685
4484,0.4484,9,65,9,388769,216841,25486,82470,2.008605357738338,0.27553280701344085
4485,0.4485,12,90,12,388859,216751,25498,82458,2.007771684760458,0.2755866300813144
4486,0.4486,9,98,9,388957,216653,25507,82449,2.006863907517878,0.27565512768219536
4487,0.4487,12,74,12,389031,216579,25519,82437,2.0061784430693987,0.27569427722931217
4488,0.4488,9,73,9,389104,216506,25528,82428,2.0055022416540074,0.27573979540634386
4489,0.4489,6,86,6,389190,216420,25534,82422,2.0047056208084775,0.27580460577830423
4490,0.449,12,99,12,389289,216321,25546,82410,2.0037885805328095,0.2758669170591602
4491,0.4491,11,87,11,389376,216234,25557,82399,2.0029826966541924,0.27592061158679715
4492,0.4492,11,60,11,389436,216174,25568,82388,2.002426914668939,0.2759493840475345
4493,0.4493,13,90,13,389526,216084,25581,82375,2.0015932416910593,0.2760010587718916
4494,0.4494,14,88,14,389614,215996,25595,82361,2.0007780947793545,0.2760484922425148
4495,0.4495,9,90,9,389704,215906,25604,82352,1.9999444218014746,0.27610994508110426
4496,0.4496,8,76,8,389780,215830,25612,82344,1.9992404312868206,0.27616089934065347
4497,0.4497,10,91,10,389871,215739,25622,82334,1.9983974952758532,0.2762209257463776
4498,0.4498,12,75,12,389946,215664,25634,82322,1.9977027677942865,0.27626130086648365
4499,0.4499,12,73,12,390019,215591,25646,82310,1.997026566378895,0.2762998445792394
4500,0.45,16,87,16,390106,215504,25662,82294,1.996220682500278,0.27634168127388364
4501,0.4501,12,72,12,390178,215432,25674,82282,1.995553744117974,0.2763793439341113
4502,0.4502,8,70,8,390248,215362,25682,82274,1.9949053318018453,0.27642489483799004
4503,0.4503,12,69,12,390317,215293,25694,82262,1.994266182518804,0.2764598141520055
4504,0.4504,15,77,15,390394,215216,25709,82247,1.9935529289710623,0.2764948918016695
4505,0.4505,12,83,12,390477,215133,25721,82235,1.9927840972247952,0.2765428694412311
4506,0.4506,12,85,12,390562,215048,25733,82223,1.9919967394123532,0.2765927386122427
4507,0.4507,9,78,9,390640,214970,25742,82214,1.9912742228315239,0.2766434262948207
4508,0.4508,5,79,5,390719,214891,25747,82209,1.990542443217607,0.2767048131942107
4509,0.4509,15,58,15,390777,214833,25762,82194,1.990005187298529,0.2767223181730954
4510,0.451,10,69,10,390846,214764,25772,82184,1.9893660380154878,0.27676226140603744
4511,0.4511,5,98,5,390944,214666,25777,82179,1.9884582607729075,0.2768414492411865
4512,0.4512,15,98,15,391042,214568,25792,82164,1.9875504835303273,0.27689632395562325
4513,0.4513,13,57,13,391099,214511,25805,82151,1.9870224906443366,0.27691783915702045
4514,0.4514,11,77,11,391176,214434,25816,82140,1.986309237096595,0.2769629165065043
4515,0.4515,9,83,9,391259,214351,25825,82131,1.9855404053503278,0.2770185036528356
4516,0.4516,16,68,16,391327,214283,25841,82115,1.9849105191003742,0.2770430299799594
4517,0.4517,10,68,10,391395,214215,25851,82105,1.9842806328504206,0.27708220842332615
4518,0.4518,11,79,11,391474,214136,25862,82094,1.9835488532365038,0.27712925767140395
4519,0.4519,18,85,18,391559,214051,25880,82076,1.9827614954240615,0.2771648650747821
4520,0.452,12,80,12,391639,213971,25892,82064,1.9820204527770573,0.2772104649788032
4521,0.4521,10,72,10,391711,213899,25902,82054,1.9813535143947534,0.2772534828165283
4522,0.4522,10,85,10,391796,213814,25912,82044,1.9805661565823114,0.27730870890765164
4523,0.4523,10,82,10,391878,213732,25922,82034,1.9798065878691318,0.27736115713097514
4524,0.4524,13,86,13,391964,213646,25935,82021,1.979009967023602,0.2774100592896739
4525,0.4525,10,81,10,392045,213565,25945,82011,1.9782596613435104,0.27746163423282
4526,0.4526,9,84,9,392129,213481,25954,82002,1.9774815665641559,0.2775185036025761
4527,0.4527,15,87,15,392216,213394,25969,81987,1.9766756826855385,0.2775635535122435
4528,0.4528,10,71,10,392287,213323,25979,81977,1.9760180073363223,0.27760582458516764
4529,0.4529,12,73,12,392360,213250,25991,81965,1.9753418059209307,0.2776451061091069
4530,0.453,9,67,9,392427,213183,26000,81956,1.9747211827040647,0.27768610722405374
4531,0.4531,20,78,20,392505,213105,26020,81936,1.9739986661232354,0.2777105554821194
4532,0.4532,9,54,9,392559,213051,26029,81927,1.9734984623365075,0.27773935683339096
4533,0.4533,18,83,18,392642,212968,26047,81909,1.9727296305902404,0.27777344452093583
4534,0.4534,13,91,13,392733,212877,26060,81896,1.971886694579273,0.27782734510962676
4535,0.4535,15,83,15,392816,212794,26075,81881,1.971117862833006,0.27786883855094596
4536,0.4536,14,88,14,392904,212706,26089,81867,1.9703027159213014,0.2779175280830219
4537,0.4537,8,87,8,392991,212619,26097,81859,1.969496832042684,0.27798001888086715
4538,0.4538,7,87,7,393078,212532,26104,81852,1.9686909481640669,0.2780450024457851
4539,0.4539,12,73,12,393151,212459,26116,81840,1.9680147467486755,0.2780845330769048
4540,0.454,6,80,6,393231,212379,26122,81834,1.967273704101671,0.27814542525313296
4541,0.4541,7,81,7,393312,212298,26129,81827,1.966523398421579,0.27820484487887803
4542,0.4542,12,71,12,393383,212227,26141,81815,1.9658657230723628,0.27824256398745756
4543,0.4543,8,88,8,393471,212139,26149,81807,1.965050576160658,0.27830621950970585
4544,0.4544,18,96,18,393567,212043,26167,81789,1.9641613249842529,0.2783529363718043
4545,0.4545,9,68,9,393635,211975,26176,81780,1.9635314387342993,0.2783952613572535
4546,0.4546,16,78,16,393713,211897,26192,81764,1.96280892215347,0.2784298902475984
4547,0.4547,9,82,9,393795,211815,26201,81755,1.9620493534402905,0.2784855400756208
4548,0.4548,10,77,10,393872,211738,26211,81745,1.9613360998925489,0.2785340207098878
4549,0.4549,9,74,9,393946,211664,26220,81736,1.9606506354440698,0.27858214042263124
4550,0.455,9,66,9,394012,211598,26229,81727,1.9600392752602913,0.27862268814454955
4551,0.4551,12,94,12,394106,211504,26241,81715,1.959168550150061,0.2786824864691579
4552,0.4552,10,73,10,394179,211431,26251,81705,1.9584923487346697,0.27872728017029635
4553,0.4553,7,70,7,394249,211361,26258,81698,1.957843936418541,0.27877662859697194
4554,0.4554,17,88,17,394337,211273,26275,81681,1.9570287895068361,0.2788185175829652
4555,0.4555,13,85,13,394422,211188,26288,81668,1.956241431694394,0.27886742972655504
4556,0.4556,11,79,11,394501,211109,26299,81657,1.9555096520804773,0.27891558445994413
4557,0.4557,11,61,11,394562,211048,26310,81646,1.9549446070621364,0.2789466131864678
4558,0.4558,10,79,10,394641,210969,26320,81636,1.9542128274482196,0.2789972830266058
4559,0.4559,13,68,13,394709,210901,26333,81623,1.953582941198266,0.2790300966758283
4560,0.456,12,57,12,394766,210844,26345,81611,1.9530549483122754,0.2790548973346327
4561,0.4561,16,86,16,394852,210758,26361,81595,1.9522583274667458,0.27909752935663396
4562,0.4562,11,61,11,394913,210697,26372,81584,1.951693282448405,0.27912864674747934
4563,0.4563,13,82,13,394995,210615,26385,81571,1.9509337137352254,0.27917490913322335
4564,0.4564,4,68,4,395063,210547,26389,81567,1.9503038274852718,0.27923002663343766
4565,0.4565,14,94,14,395157,210453,26403,81553,1.9494331023750417,0.27928535715019553
4566,0.4566,8,76,8,395233,210377,26411,81545,1.9487291118603876,0.2793383163995862
4567,0.4567,12,84,12,395317,210293,26423,81533,1.947951017081033,0.2793890880182026
4568,0.4568,11,90,11,395407,210203,26434,81522,1.947117344103153,0.27944811037792444
4569,0.4569,20,87,20,395494,210116,26454,81502,1.946311460224536,0.2794820621497987
4570,0.457,4,65,4,395559,210051,26458,81498,1.945709363073845,0.27953448648426166
4571,0.4571,18,93,18,395652,209958,26476,81480,1.9448479009967024,0.2795791900850267
4572,0.4572,13,85,13,395737,209873,26489,81467,1.9440605431842604,0.2796286126175602
4573,0.4573,6,75,6,395812,209798,26495,81461,1.9433658157026936,0.27968577795020927
4574,0.4574,13,73,13,395885,209725,26508,81448,1.9426896142873022,0.27972373812132306
4575,0.4575,10,69,10,395954,209656,26518,81438,1.942050465004261,0.2797652991817076
4576,0.4576,14,75,14,396029,209581,26532,81424,1.9413557375226944,0.27980275253002523
4577,0.4577,21,64,21,396093,209517,26553,81403,1.940762903405091,0.27981231953801733
4578,0.4578,21,72,21,396165,209445,26574,81382,1.9400959650227871,0.27982958941226227
4579,0.4579,16,75,16,396240,209370,26590,81366,1.9394012375412204,0.27986214297507017
4580,0.458,10,78,10,396318,209292,26600,81356,1.9386787209603913,0.2799124714431202
4581,0.4581,21,84,21,396402,209208,26621,81335,1.9379006261810368,0.2799413511941434
4582,0.4582,8,82,8,396484,209126,26629,81327,1.9371410574678574,0.28000055086365094
4583,0.4583,8,75,8,396559,209051,26637,81319,1.9364463299862906,0.2800530357819334
4584,0.4584,12,90,12,396649,208961,26649,81307,1.935612657008411,0.28011010514421153
4585,0.4585,7,84,7,396733,208877,26656,81300,1.9348345622290564,0.2801738249413289
4586,0.4586,18,81,18,396814,208796,26674,81282,1.9340842565489644,0.28020739249443255
4587,0.4587,10,84,10,396898,208712,26684,81272,1.93330616176961,0.2802637386890311
4588,0.4588,14,86,14,396984,208626,26698,81258,1.9325095409240802,0.28031212484994
4589,0.4589,16,72,16,397056,208554,26714,81242,1.9318426025417763,0.2803420337064694
4590,0.459,14,72,14,397128,208482,26728,81228,1.9311756641594724,0.28037692865279074
4591,0.4591,23,87,23,397215,208395,26751,81205,1.9303697802808553,0.2804040055248619
4592,0.4592,15,74,15,397289,208321,26766,81190,1.9296843158323762,0.2804383943960678
4593,0.4593,10,83,10,397372,208238,26776,81180,1.9289154840861091,0.28049395683751527
4594,0.4594,6,74,6,397446,208164,26782,81174,1.92823001963763,0.28055077452667815
4595,0.4595,15,83,15,397529,208081,26797,81159,1.9274611878913632,0.28059397040519984
4596,0.4596,20,85,20,397614,207996,26817,81139,1.926673830078921,0.28062669687170355
4597,0.4597,9,60,9,397674,207936,26826,81130,1.9261180480936677,0.28066254765347703
4598,0.4598,10,93,10,397767,207843,26836,81120,1.9252565860165252,0.280727982475265
4599,0.4599,17,73,17,397840,207770,26853,81103,1.9245803846011338,0.2807565954589041
4600,0.46,8,67,8,397907,207703,26861,81095,1.9239597613842676,0.2808018061066905
4601,0.4601,8,73,8,397980,207630,26869,81087,1.9232835599688762,0.2808528766924012
4602,0.4602,14,66,14,398046,207564,26883,81073,1.9226721997850977,0.28088221537779284
4603,0.4603,16,81,16,398127,207483,26899,81057,1.9219218941050058,0.28092118943647326
4604,0.4604,11,80,11,398207,207403,26910,81046,1.9211808514580013,0.28097167956900526
4605,0.4605,14,74,14,398281,207329,26924,81032,1.9204953870095225,0.28100887429298693
4606,0.4606,15,90,15,398371,207239,26939,81017,1.9196617140316425,0.2810591973801066
4607,0.4607,14,94,14,398465,207145,26953,81003,1.9187909889214125,0.28111595430126185
4608,0.4608,14,69,14,398534,207076,26967,80989,1.9181518396383712,0.28114835193445925
4609,0.4609,21,78,21,398612,206998,26988,80968,1.9174293230575419,0.28117208281533235
4610,0.461,14,72,14,398684,206926,27002,80954,1.916762384675238,0.28120744754758925
4611,0.4611,19,73,19,398757,206853,27021,80935,1.9160861832598466,0.28123132305725046
4612,0.4612,8,71,8,398828,206782,27029,80927,1.9154285079106304,0.2812807385239947
4613,0.4613,12,76,12,398904,206706,27041,80915,1.9147245173959762,0.2813250770979866
4614,0.4614,13,52,13,398956,206654,27054,80902,1.9142428396754234,0.281343460056476
4615,0.4615,10,58,10,399014,206596,27064,80892,1.9137055837563453,0.28137522261798753
4616,0.4616,16,83,16,399097,206513,27080,80876,1.9129367520100782,0.28141647731819935
4617,0.4617,10,67,10,399164,206446,27090,80866,1.912316128793212,0.28145709194186114
4618,0.4618,17,69,17,399233,206377,27107,80849,1.911676979510171,0.28148217779727464
4619,0.4619,9,81,9,399314,206296,27116,80840,1.910926673830079,0.28153906162933245
4620,0.462,12,74,12,399388,206222,27128,80828,1.9102412093816,0.28158160599198745
4621,0.4621,16,87,16,399475,206135,27144,80812,1.9094353255029828,0.2816269206508519
4622,0.4622,14,90,14,399565,206045,27158,80798,1.9086016525251028,0.28168022228187545
4623,0.4623,6,76,6,399641,205969,27164,80792,1.9078976620104486,0.28173984607390823
4624,0.4624,11,77,11,399718,205892,27175,80781,1.907184408462707,0.28178796049854715
4625,0.4625,19,76,19,399794,205816,27194,80762,1.906480417948053,0.28181507303421754
4626,0.4626,11,79,11,399873,205737,27205,80751,1.9057486383341362,0.2818652090139901
4627,0.4627,11,83,11,399956,205654,27216,80740,1.9049798065878691,0.28191931395210795
4628,0.4628,14,76,14,400032,205578,27230,80726,1.904275816073215,0.28195903654856375
4629,0.4629,13,83,13,400115,205495,27243,80713,1.903506984326948,0.28200818984794274
4630,0.463,12,74,12,400189,205421,27255,80701,1.902821519878469,0.28205101320415765
4631,0.4631,17,95,17,400284,205326,27272,80684,1.9019415317351513,0.2821020244047411
4632,0.4632,15,59,15,400343,205267,27287,80669,1.9013950127829857,0.28212257288344245
4633,0.4633,16,76,16,400419,205191,27303,80653,1.9006910222683315,0.28215740054015476
4634,0.4634,14,83,14,400502,205108,27317,80639,1.8999221905220645,0.28220418762051747
4635,0.4635,18,62,18,400564,205046,27335,80621,1.8993478824706362,0.282220207444332
4636,0.4636,7,67,7,400631,204979,27342,80614,1.89872725925377,0.2822688231154125
4637,0.4637,6,83,6,400714,204896,27348,80608,1.897958427507503,0.28233579914817303
4638,0.4638,7,72,7,400786,204824,27355,80601,1.897291489125199,0.2823894192870281
4639,0.4639,8,83,8,400869,204741,27363,80593,1.8965226573789322,0.2824514428704606
4640,0.464,9,83,9,400952,204658,27372,80584,1.8957538256326651,0.2825109906675735
4641,0.4641,10,81,10,401033,204577,27382,80574,1.8950035199525732,0.2825660790247974
4642,0.4642,16,81,16,401114,204496,27398,80558,1.8942532142724813,0.28260610270334746
4643,0.4643,16,62,16,401176,204434,27414,80542,1.893678906221053,0.2826273089663691
4644,0.4644,13,69,13,401245,204365,27427,80529,1.8930397569380117,0.28266302554634354
4645,0.4645,19,86,19,401331,204279,27446,80510,1.892243136092482,0.28270052565232506
4646,0.4646,15,82,15,401413,204197,27461,80495,1.8914835673793027,0.2827441585994689
4647,0.4647,14,75,14,401488,204122,27475,80481,1.8907888398977362,0.2827833859797683
4648,0.4648,18,84,18,401572,204038,27493,80463,1.8900107451183816,0.2828215015061458
4649,0.4649,15,60,15,401632,203978,27508,80448,1.8894549631331283,0.28284334062286853
4650,0.465,9,72,9,401704,203906,27517,80439,1.8887880247508244,0.28289226116161703
4651,0.4651,16,63,16,401767,203843,27533,80423,1.8882044536663085,0.28291459407737823
4652,0.4652,13,72,13,401839,203771,27546,80410,1.8875375152840046,0.2829534697956584
4653,0.4653,8,85,8,401924,203686,27554,80402,1.8867501574715624,0.2830179381036862
4654,0.4654,13,70,13,401994,203616,27567,80389,1.8861017451554336,0.2830548757944402
4655,0.4655,14,107,14,402101,203509,27581,80375,1.8851106006150653,0.28312620647870257
4656,0.4656,12,75,12,402176,203434,27593,80363,1.8844158731334988,0.28317071709707997
4657,0.4657,11,75,11,402251,203359,27604,80352,1.8837211456519323,0.28321778147481064
4658,0.4658,13,60,13,402311,203299,27617,80339,1.883165363666679,0.2832448402541267
4659,0.4659,17,73,17,402384,203226,27634,80322,1.8824891622512876,0.2832747894536375
4660,0.466,10,77,10,402461,203149,27644,80312,1.881775908703546,0.2833264540801027
4661,0.4661,13,76,13,402537,203073,27657,80299,1.8810719181888917,0.28336956368307387
4662,0.4662,9,74,9,402611,202999,27666,80290,1.8803864537404127,0.2834208176102849
4663,0.4663,11,69,11,402680,202930,27677,80279,1.8797473044573716,0.2834620368702972
4664,0.4664,11,82,11,402762,202848,27688,80268,1.878987735744192,0.2835162972067986
4665,0.4665,9,71,9,402833,202777,27697,80259,1.8783300603949757,0.28356463488743483
4666,0.4666,9,78,9,402911,202699,27706,80250,1.8776075438141464,0.28362001632803086
4667,0.4667,20,91,20,403002,202608,27726,80230,1.876764607803179,0.2836606113747092
4668,0.4668,13,87,13,403089,202521,27739,80217,1.8759587239245619,0.2837149587250387
4669,0.4669,13,77,13,403166,202444,27752,80204,1.8752454703768202,0.28375930485975487
4670,0.467,11,71,11,403237,202373,27763,80193,1.8745877950276038,0.2838027221958764
4671,0.4671,12,70,12,403307,202303,27775,80181,1.873939382711475,0.2838426247150281
4672,0.4672,19,78,19,403385,202225,27794,80162,1.8732168661306459,0.28387284117186695
4673,0.4673,14,83,14,403468,202142,27808,80148,1.8724480343843788,0.2839207906762549
4674,0.4674,11,83,11,403551,202059,27819,80137,1.8716792026381117,0.28397638520744445
4675,0.4675,13,79,13,403630,201980,27832,80124,1.8709474230241951,0.28402291353543374
4676,0.4676,13,79,13,403709,201901,27845,80111,1.8702156434102783,0.28406947222104023
4677,0.4677,12,72,12,403781,201829,27857,80099,1.8695487050279744,0.28411154621037993
4678,0.4678,13,74,13,403855,201755,27870,80086,1.8688632405794954,0.28415312179562235
4679,0.4679,10,64,10,403919,201691,27880,80076,1.8682704064618918,0.28419225814236587
4680,0.468,14,70,14,403989,201621,27894,80062,1.867621994145763,0.28422730516218586
4681,0.4681,13,76,13,404065,201545,27907,80049,1.866918003631109,0.28427097168263527
4682,0.4682,13,82,13,404147,201463,27920,80036,1.8661584349179294,0.2843207258285109
4683,0.4683,9,72,9,404219,201391,27929,80027,1.8654914965356255,0.2843705804177416
4684,0.4684,17,73,17,404292,201318,27946,80010,1.8648152951202341,0.28440112608769835
4685,0.4685,7,69,7,404361,201249,27953,80003,1.8641761458371928,0.28445308833359406
4686,0.4686,11,62,11,404423,201187,27964,79992,1.8636018377857646,0.2844878173690069
4687,0.4687,14,79,14,404502,201108,27978,79978,1.8628700581718478,0.2845321360722341
4688,0.4688,11,69,11,404571,201039,27989,79967,1.8622309088888065,0.2845739948613197
4689,0.4689,16,60,16,404631,200979,28005,79951,1.8616751269035532,0.2845940269818104
4690,0.469,11,75,11,404706,200904,28016,79940,1.8609803994219867,0.284642007662617
4691,0.4691,9,75,9,404781,200829,28025,79931,1.8602856719404202,0.2846951132639977
4692,0.4692,14,64,14,404845,200765,28039,79917,1.8596928378228168,0.28472434997612955
4693,0.4693,10,67,10,404912,200698,28049,79907,1.8590722146059506,0.28476684307122113
4694,0.4694,12,75,12,404987,200623,28061,79895,1.858377487124384,0.28481238280609444
4695,0.4695,11,86,11,405073,200537,28072,79884,1.8575808662788544,0.2848716750885276
4696,0.4696,15,77,15,405150,200460,28087,79869,1.8568676127311128,0.2849116573740141
4697,0.4697,10,81,10,405231,200379,28097,79859,1.8561173070510208,0.28496849106830624
4698,0.4698,10,76,10,405307,200303,28107,79849,1.8554133165363667,0.28502027470801566
4699,0.4699,11,73,11,405380,200230,28118,79838,1.8547371151209753,0.2850664838539212
4700,0.47,16,76,16,405456,200154,28134,79822,1.854033124606321,0.2851030088293282
4701,0.4701,13,82,13,405538,200072,28147,79809,1.8532735558931417,0.2851533330236779
4702,0.4702,14,84,14,405622,199988,28161,79795,1.8524954611137872,0.2852031753180143
4703,0.4703,16,80,16,405702,199908,28177,79779,1.8517544184667827,0.2852438618884682
4704,0.4704,11,80,11,405782,199828,28188,79768,1.8510133758197784,0.2852973576159888
4705,0.4705,15,61,15,405843,199767,28203,79753,1.8504483308014377,0.28532126502575844
4706,0.4706,16,80,16,405923,199687,28219,79737,1.8497072881544332,0.28536203046266606
4707,0.4707,12,79,12,406002,199608,28231,79725,1.8489755085405164,0.2854120350978939
4708,0.4708,13,67,13,406069,199541,28244,79712,1.8483548853236504,0.2854472467618969
4709,0.4709,14,90,14,406159,199451,28258,79698,1.8475212123457705,0.28550344081476203
4710,0.471,10,81,10,406240,199370,28268,79688,1.8467709066656786,0.285560707809846
4711,0.4711,10,71,10,406311,199299,28278,79678,1.8461132313164623,0.2856077741175796
4712,0.4712,7,82,7,406393,199217,28285,79671,1.845353662603283,0.28567381888069765
4713,0.4713,8,76,8,406469,199141,28293,79663,1.8446496720886287,0.2857311946743949
4714,0.4714,12,82,12,406551,199059,28305,79651,1.8438901033754493,0.2857845071938574
4715,0.4715,15,75,15,406626,198984,28320,79636,1.8431953758938826,0.2858229847103582
4716,0.4716,12,95,12,406721,198889,28332,79624,1.8423153877505651,0.28588970712318634
4717,0.4717,10,60,10,406781,198829,28342,79614,1.8417596057653118,0.28592566521693846
4718,0.4718,12,77,12,406858,198752,28354,79602,1.8410463522175702,0.2859739755850464
4719,0.4719,10,86,10,406944,198666,28364,79592,1.8402497313720405,0.2860366997534662
4720,0.472,8,60,8,407004,198606,28372,79584,1.8396939493867872,0.28607786045508465
4721,0.4721,10,67,10,407071,198539,28382,79574,1.839073326169921,0.2861211090456038
4722,0.4722,11,77,11,407148,198462,28393,79563,1.8383600726221794,0.28617210682492583
4723,0.4723,8,79,8,407227,198383,28401,79555,1.8376282930082626,0.28623290086278236
4724,0.4724,19,70,19,407297,198313,28420,79536,1.8369798806921338,0.28625620390931766
4725,0.4725,17,75,17,407372,198238,28437,79519,1.8362851532105673,0.28628981447812296
4726,0.4726,16,90,16,407462,198148,28453,79503,1.8354514802326873,0.2863414862543265
4727,0.4727,10,71,10,407533,198077,28463,79493,1.834793804883471,0.28638901898620167
4728,0.4728,15,73,15,407606,198004,28478,79478,1.8341176034680795,0.2864257861771214
4729,0.4729,9,77,9,407683,197927,28487,79469,1.8334043499203379,0.2864821410546655
4730,0.473,14,91,14,407774,197836,28501,79455,1.8325614139093704,0.2865401329289447
4731,0.4731,6,78,6,407852,197758,28507,79449,1.8318388973285413,0.28660531660455907
4732,0.4732,13,69,13,407921,197689,28520,79436,1.8311997480455,0.2866432115471358
4733,0.4733,18,90,18,408011,197599,28538,79418,1.83036607506762,0.2866899865351224
4734,0.4734,11,81,11,408092,197518,28549,79407,1.8296157693875283,0.28674550871174503
4735,0.4735,13,78,13,408170,197440,28562,79394,1.828893252806699,0.28679280724188505
4736,0.4736,9,69,9,408239,197371,28571,79385,1.8282541035236577,0.28684111636242754
4737,0.4737,10,79,10,408318,197292,28581,79375,1.827522323909741,0.2868972447021148
4738,0.4738,13,65,13,408383,197227,28594,79362,1.82692022675905,0.28693115055190194
4739,0.4739,14,86,14,408469,197141,28608,79348,1.8261236059135204,0.2869842923226602
4740,0.474,12,92,12,408561,197049,28620,79336,1.8252714068694653,0.2870488629990774
4741,0.4741,8,69,8,408630,196980,28628,79328,1.824632257586424,0.2870999030067895
4742,0.4742,14,81,14,408711,196899,28642,79314,1.8238819519063323,0.2871479618989693
4743,0.4743,10,65,10,408776,196834,28652,79304,1.8232798547556412,0.2871897384641013
4744,0.4744,13,73,13,408849,196761,28665,79291,1.8226036533402497,0.28723211568834855
4745,0.4745,12,75,12,408924,196686,28677,79279,1.8219089258586831,0.287279183954487
4746,0.4746,9,68,9,408992,196618,28686,79270,1.8212790396087295,0.2873267412863191
4747,0.4747,14,87,14,409079,196531,28700,79256,1.8204731557301124,0.2873812036100324
4748,0.4748,18,69,18,409148,196462,28718,79238,1.819834006447071,0.28740660137830976
4749,0.4749,8,93,8,409241,196369,28726,79230,1.8189725443699285,0.287482900881353
4750,0.475,7,72,7,409313,196297,28733,79223,1.8183056059876246,0.28753992450638793
4751,0.4751,14,89,14,409402,196208,28747,79209,1.8174811960428323,0.2875966262068064
4752,0.4752,14,70,14,409472,196138,28761,79195,1.8168327837267035,0.2876335201374336
4753,0.4753,12,70,12,409542,196068,28773,79183,1.8161843714105748,0.28767561244100837
4754,0.4754,9,82,9,409624,195986,28782,79174,1.8154248026973951,0.28773804332025005
4755,0.4755,20,67,20,409691,195919,28802,79154,1.8148041794805292,0.28775634104401376
4756,0.4756,10,78,10,409769,195841,28812,79144,1.8140816628996999,0.28781206247613506
4757,0.4757,13,75,13,409844,195766,28825,79131,1.8133869354181333,0.2878569064049444
4758,0.4758,18,75,18,409919,195691,28843,79113,1.8126922079365668,0.2878888225790018
4759,0.4759,13,77,13,409996,195614,28856,79100,1.8119789543888252,0.287935816885925
4760,0.476,13,87,13,410083,195527,28869,79087,1.8111730705102078,0.2879933288179044
4761,0.4761,6,86,6,410169,195441,28875,79081,1.8103764496646781,0.2880679872651372
4762,0.4762,15,66,15,410235,195375,28890,79066,1.8097650894808996,0.28809835265138956
4763,0.4763,11,84,11,410319,195291,28901,79055,1.8089869947015451,0.2881580194353116
4764,0.4764,11,69,11,410388,195222,28912,79044,1.8083478454185038,0.2882019645161996
4765,0.4765,16,75,16,410463,195147,28928,79028,1.8076531179369373,0.2882392632442783
4766,0.4766,13,72,13,410535,195075,28941,79015,1.8069861795546334,0.2882812214965887
4767,0.4767,9,69,9,410604,195006,28950,79006,1.806347030271592,0.2883304380830037
4768,0.4768,15,90,15,410694,194916,28965,78991,1.8055133572937123,0.2883862040765661
4769,0.4769,10,63,10,410757,194853,28975,78981,1.8049297862091964,0.28842656499923314
4770,0.477,8,75,8,410832,194778,28983,78973,1.8042350587276297,0.28848479092313817
4771,0.4771,14,86,14,410918,194692,28997,78959,1.8034384378821,0.2885390515656804
4772,0.4772,8,75,8,410993,194617,29005,78951,1.8027437104005335,0.28859735056731783
4773,0.4773,11,75,11,411068,194542,29016,78940,1.802048982918967,0.288647881761871
4774,0.4774,15,81,15,411149,194461,29031,78925,1.801298677238875,0.2886943735231504
4775,0.4775,14,68,14,411217,194393,29045,78911,1.8006687909889214,0.2887297661212423
4776,0.4776,19,74,19,411291,194319,29064,78892,1.7999833265404424,0.2887585053310445
4777,0.4777,17,89,17,411380,194230,29081,78875,1.79915891659565,0.28880833379103277
4778,0.4778,15,86,15,411466,194144,29096,78860,1.7983622957501204,0.2888602364800516
4779,0.4779,10,88,10,411554,194056,29106,78850,1.7975471488384156,0.28892732296101953
4780,0.478,12,74,12,411628,193982,29118,78838,1.7968616843899365,0.28897441536544244
4781,0.4781,15,74,15,411702,193908,29133,78823,1.7961762199414577,0.2890137168125369
4782,0.4782,17,77,17,411779,193831,29150,78806,1.795462966393716,0.2890510092173843
4783,0.4783,16,67,16,411846,193764,29166,78790,1.7948423431768499,0.289080329035714
4784,0.4784,13,57,13,411903,193707,29179,78777,1.7943143502908592,0.2891068833399392
4785,0.4785,17,80,17,411983,193627,29196,78760,1.793573307643855,0.28914742627217893
4786,0.4786,13,90,13,412073,193537,29209,78747,1.792739634665975,0.28920906112735234
4787,0.4787,20,70,20,412143,193467,29229,78727,1.7920912223498462,0.28923121009280145
4788,0.4788,14,63,14,412206,193404,29243,78713,1.7915076512653303,0.2892616043834086
4789,0.4789,6,73,6,412279,193331,29249,78707,1.790831449849939,0.2893235503863431
4790,0.479,14,83,14,412362,193248,29263,78693,1.7900626181036718,0.2893752689002394
4791,0.4791,19,85,19,412447,193163,29282,78674,1.7892752602912299,0.28941608390322143
4792,0.4792,16,56,16,412503,193107,29298,78658,1.7887565304383268,0.2894338858940629
4793,0.4793,17,81,17,412584,193026,29315,78641,1.788006224758235,0.2894757184347013
4794,0.4794,6,82,6,412666,192944,29321,78635,1.7872466560450553,0.2895474245063131
4795,0.4795,13,84,13,412750,192860,29334,78622,1.7864685612657007,0.2896029939369829
4796,0.4796,16,74,16,412824,192786,29350,78606,1.785783096817222,0.2896400778210117
4797,0.4797,11,82,11,412906,192704,29361,78595,1.7850235281040423,0.2896988193837795
4798,0.4798,10,90,10,412996,192614,29371,78585,1.7841898551261626,0.28976876758395126
4799,0.4799,13,74,13,413070,192540,29384,78572,1.7835043906776835,0.28981380388916755
4800,0.48,14,61,14,413131,192479,29398,78558,1.7829393456593428,0.28984234624792926
4801,0.4801,9,66,9,413197,192413,29407,78549,1.782327985475564,0.2898893571792355
4802,0.4802,17,73,17,413270,192340,29424,78532,1.7816517840601727,0.28992291562066214
4803,0.4803,13,74,13,413344,192266,29437,78519,1.7809663196116936,0.28996805583765717
4804,0.4804,5,63,5,413407,192203,29442,78514,1.7803827485271777,0.2900224219387774
4805,0.4805,13,76,13,413483,192127,29455,78501,1.7796787580125237,0.29006976366081855
4806,0.4806,14,74,14,413557,192053,29469,78487,1.7789932935640447,0.29011236785687883
4807,0.4807,12,71,12,413628,191982,29481,78475,1.7783356182148282,0.29015703050762226
4808,0.4808,23,71,23,413699,191911,29504,78452,1.777677942865612,0.2901728416980134
4809,0.4809,13,69,13,413768,191842,29517,78439,1.7770387935825707,0.29021277855269145
4810,0.481,16,67,16,413835,191775,29533,78423,1.7764181703657045,0.2902427109008949
4811,0.4811,13,68,13,413903,191707,29546,78410,1.7757882841157508,0.29028161870596814
4812,0.4812,17,83,17,413986,191624,29563,78393,1.7750194523694838,0.2903261646488925
4813,0.4813,11,68,11,414054,191556,29574,78382,1.7743895661195301,0.2903703813468278
4814,0.4814,13,88,13,414142,191468,29587,78369,1.7735744192078253,0.29043088975937326
4815,0.4815,13,87,13,414229,191381,29600,78356,1.7727685353292082,0.2904903665422245
4816,0.4816,19,87,19,414316,191294,29619,78337,1.771962651450591,0.29053410030745724
4817,0.4817,9,71,9,414387,191223,29628,78328,1.7713049761013746,0.2905869390208161
4818,0.4818,11,58,11,414445,191165,29639,78317,1.7707677201822964,0.29062052381977277
4819,0.4819,8,64,8,414509,191101,29647,78309,1.770174886064693,0.2906684978285884
4820,0.482,12,66,12,414575,191035,29659,78297,1.7695635258809144,0.2907081223174372
4821,0.4821,11,75,11,414650,190960,29670,78286,1.7688687983993479,0.29076012271305796
4822,0.4822,18,75,18,414725,190885,29688,78268,1.7681740709177813,0.29079371212655997
4823,0.4823,16,83,16,414808,190802,29704,78252,1.7674052391715143,0.2908412437651921
4824,0.4824,10,75,10,414883,190727,29714,78242,1.7667105116899477,0.2908959768597868
4825,0.4825,13,75,13,414958,190652,29727,78229,1.7660157842083812,0.2909428334467664
4826,0.4826,13,79,13,415037,190573,29740,78216,1.7652840045944644,0.290994051095841
4827,0.4827,11,71,11,415108,190502,29751,78205,1.764626329245248,0.2910419155436963
4828,0.4828,16,80,16,415188,190422,29767,78189,1.7638852865982437,0.2910863665300379
4829,0.4829,12,93,12,415281,190329,29779,78177,1.7630238245211012,0.2911555049049183
4830,0.483,16,65,16,415346,190264,29795,78161,1.7624217273704101,0.29118375710161126
4831,0.4831,15,73,15,415419,190191,29810,78146,1.7617455259550188,0.291223349743047
4832,0.4832,20,92,20,415511,190099,29830,78126,1.7608933269109637,0.2912703886662317
4833,0.4833,12,89,12,415600,190010,29842,78114,1.7600689169661714,0.2913353522996822
4834,0.4834,17,70,17,415670,189940,29859,78097,1.7594205046500426,0.29136649044721435
4835,0.4835,13,74,13,415744,189866,29872,78084,1.7587350402015636,0.2914125769733159
4836,0.4836,13,76,13,415820,189790,29885,78071,1.7580310496869094,0.291460869630144
4837,0.4837,11,96,11,415916,189694,29896,78060,1.7571417985105042,0.2915362608961958
4838,0.4838,14,80,14,415996,189614,29910,78046,1.7564007558635,0.2915863408802212
4839,0.4839,14,83,14,416079,189531,29924,78032,1.755631924117233,0.29163972597107973
4840,0.484,15,90,15,416169,189441,29939,78017,1.7547982511393532,0.2916981357820667
4841,0.4841,9,90,9,416259,189351,29948,78008,1.7539645781614732,0.2917724856840428
4842,0.4842,14,67,14,416326,189284,29962,77994,1.753343954944607,0.2918085289473881
4843,0.4843,9,68,9,416394,189216,29971,77985,1.7527140686946534,0.29185893765367643
4844,0.4844,13,82,13,416476,189134,29984,77972,1.751954499981474,0.2919140715670932
4845,0.4845,19,76,19,416552,189058,30003,77953,1.7512505094668198,0.29194677372842315
4846,0.4846,8,68,8,416620,188990,30011,77945,1.7506206232168662,0.2919999250753929
4847,0.4847,10,74,10,416694,188916,30021,77935,1.7499351587683871,0.2920543674185219
4848,0.4848,15,68,15,416762,188848,30036,77920,1.7493052725184335,0.2920890061776525
4849,0.4849,11,67,11,416829,188781,30047,77909,1.7486846493015673,0.2921331883460197
4850,0.485,11,95,11,416924,188686,30058,77898,1.7478046611582496,0.2922080845061969
4851,0.4851,15,78,15,417002,188608,30073,77883,1.7470821445774205,0.2922537721724186
4852,0.4852,9,75,9,417077,188533,30082,77874,1.7463874170958538,0.292312138945298
4853,0.4853,19,52,19,417129,188481,30101,77855,1.745905739375301,0.2923187252192719
4854,0.4854,13,71,13,417200,188410,30114,77842,1.7452480640260848,0.29236212310142273
4855,0.4855,20,70,20,417270,188340,30134,77822,1.744599651709956,0.2923858402025834
4856,0.4856,11,71,11,417341,188269,30145,77811,1.7439419763607396,0.2924346061334937
4857,0.4857,15,73,15,417414,188196,30160,77796,1.7432657749453482,0.29247496165298204
4858,0.4858,11,76,11,417490,188120,30171,77785,1.742561784430694,0.2925292867753521
4859,0.4859,15,82,15,417572,188038,30186,77770,1.7418022157175146,0.2925796063323903
4860,0.486,18,67,18,417639,187971,30204,77752,1.7411815925006484,0.29260545756295087
4861,0.4861,17,64,17,417703,187907,30221,77735,1.740588758383045,0.2926306834009682
4862,0.4862,10,71,10,417774,187836,30231,77725,1.7399310830338286,0.2926822839197021
4863,0.4863,10,79,10,417853,187757,30241,77715,1.7391993034199118,0.292742737463838
4864,0.4864,13,84,13,417937,187673,30254,77702,1.7384212086405573,0.29280075365049457
4865,0.4865,8,83,8,418020,187590,30262,77694,1.7376523768942902,0.2928710363233365
4866,0.4866,9,65,9,418085,187525,30271,77685,1.7370502797435992,0.2929188190490555
4867,0.4867,18,72,18,418157,187453,30289,77667,1.7363833413612952,0.29295036210018105
4868,0.4868,16,58,16,418215,187395,30305,77651,1.7358460854422173,0.29297178602959484
4869,0.4869,9,69,9,418284,187326,30314,77642,1.735206936159176,0.2930240632831134
4870,0.487,19,74,19,418358,187252,30333,77623,1.734521471710697,0.29305521472392637
4871,0.4871,13,79,13,418437,187173,30346,77610,1.7337896920967801,0.2931079412197913
4872,0.4872,10,82,10,418519,187091,30356,77600,1.7330301233836007,0.29317203833904437
4873,0.4873,14,64,14,418583,187027,30370,77586,1.7324372892659972,0.2932055492360542
4874,0.4874,10,72,10,418655,186955,30380,77576,1.7317703508836935,0.2932586350938075
4875,0.4875,9,73,9,418728,186882,30389,77567,1.7310941494683019,0.29331553532061
4876,0.4876,17,63,17,418791,186819,30406,77550,1.730510578383786,0.2933399906948243
4877,0.4877,22,71,22,418862,186748,30428,77528,1.7298529030345697,0.29335997215032766
4878,0.4878,9,78,9,418940,186670,30437,77519,1.7291303864537404,0.2934225119138193
4879,0.4879,17,60,17,419000,186610,30454,77502,1.728574604468487,0.2934436905555219
4880,0.488,14,59,14,419059,186551,30468,77488,1.7280280855163215,0.29347179772685095
4881,0.4881,10,72,10,419131,186479,30478,77478,1.7273611471340176,0.29352508173679803
4882,0.4882,11,82,11,419213,186397,30489,77467,1.7266015784208382,0.2935868477700634
4883,0.4883,11,71,11,419284,186326,30500,77456,1.7259439030716217,0.29363641188557216
4884,0.4884,12,91,12,419375,186235,30512,77444,1.7251009670606543,0.29370560416263713
4885,0.4885,15,93,15,419468,186142,30527,77429,1.7242395049835118,0.2937690413588748
4886,0.4886,15,62,15,419530,186080,30542,77414,1.7236651969320835,0.2937979612438993
4887,0.4887,9,99,9,419629,185981,30551,77405,1.7227481566564156,0.2938842611224591
4888,0.4888,13,71,13,419700,185910,30564,77392,1.7220904813071993,0.2939286446741764
4889,0.4889,13,76,13,419776,185834,30577,77379,1.7213864907925451,0.2939786408726013
4890,0.489,12,93,12,419869,185741,30589,77367,1.7205250287154026,0.2940503519467291
4891,0.4891,17,75,17,419944,185666,30606,77350,1.719830301233836,0.29408857255832344
4892,0.4892,17,63,17,420007,185603,30623,77333,1.7192467301493202,0.2941133964158579
4893,0.4893,12,68,12,420075,185535,30635,77321,1.7186168438993663,0.2941572572054661
4894,0.4894,20,74,20,420149,185461,30655,77301,1.7179313794508875,0.29418637398101705
4895,0.4895,15,70,15,420219,185391,30670,77286,1.7172829671347587,0.2942244657887824
4896,0.4896,7,78,7,420297,185313,30677,77279,1.7165604505539294,0.29429304776992443
4897,0.4897,16,64,16,420361,185249,30693,77263,1.715967616436326,0.2943217833851405
4898,0.4898,9,78,9,420439,185171,30702,77254,1.7152450998554967,0.2943850623987806
4899,0.4899,17,78,17,420517,185093,30719,77237,1.7145225832746676,0.29442686692334086
4900,0.49,13,92,13,420609,185001,30732,77224,1.7136703842306125,0.2944951854323577
4901,0.4901,16,61,16,420670,184940,30748,77208,1.7131053392122717,0.2945206524558646
4902,0.4902,13,64,13,420734,184876,30761,77195,1.7125125050946681,0.2945575817240366
4903,0.4903,19,63,19,420797,184813,30780,77176,1.7119289340101522,0.2945772532434568
4904,0.4904,14,81,14,420878,184732,30794,77162,1.7111786283300603,0.2946306520958861
4905,0.4905,16,80,16,420958,184652,30810,77146,1.710437585683056,0.29467757584091553
4906,0.4906,16,76,16,421034,184576,30826,77130,1.7097335951684018,0.29472002934590724
4907,0.4907,13,88,13,421122,184488,30839,77117,1.7089184482566973,0.29478412109860286
4908,0.4908,13,78,13,421200,184410,30852,77104,1.708195931675868,0.29483698769473143
4909,0.4909,7,58,7,421258,184352,30859,77097,1.7076586757567898,0.2948835145668945
4910,0.491,18,81,18,421339,184271,30877,77079,1.7069083700766978,0.29492634398316436
4911,0.4911,14,85,14,421424,184186,30891,77065,1.7061210122642558,0.2949845168056773
4912,0.4912,11,66,11,421490,184120,30902,77054,1.7055096520804773,0.2950293673949168
4913,0.4913,15,70,15,421560,184050,30917,77039,1.7048612397643483,0.29506796532983004
4914,0.4914,11,79,11,421639,183971,30928,77028,1.7041294601504318,0.29512756753857294
4915,0.4915,10,81,10,421720,183890,30938,77018,1.7033791544703398,0.29519217501954714
4916,0.4916,10,78,10,421798,183812,30948,77008,1.7026566378895105,0.2952534314853155
4917,0.4917,17,56,17,421854,183756,30965,76991,1.7021379080366075,0.2952708947753953
4918,0.4918,13,61,13,421915,183695,30978,76978,1.7015728630182667,0.2953048455344435
4919,0.4919,15,84,15,421999,183611,30993,76963,1.7007947682389122,0.2953594756192099
4920,0.492,15,73,15,422072,183538,31008,76948,1.7001185668235206,0.29540167225877784
4921,0.4921,12,57,12,422129,183481,31020,76936,1.69959057393753,0.29543386184465686
4922,0.4922,11,69,11,422198,183412,31031,76925,1.6989514246544888,0.29548239397396453
4923,0.4923,11,78,11,422276,183334,31042,76914,1.6982289080736597,0.29554117610894226
4924,0.4924,17,64,17,422340,183270,31059,76897,1.697636073956056,0.29556784680608994
4925,0.4925,14,75,14,422415,183195,31073,76883,1.6969413464744896,0.29561516160536455
4926,0.4926,14,59,14,422474,183136,31087,76869,1.696394827522324,0.29564431453241286
4927,0.4927,13,62,13,422536,183074,31100,76856,1.6958205194708955,0.2956796060477821
4928,0.4928,7,74,7,422610,183000,31107,76849,1.6951350550224165,0.295744836424231
4929,0.4929,8,72,8,422682,182928,31115,76841,1.6944681166401125,0.29580511916356456
4930,0.493,16,76,16,422758,182852,31131,76825,1.6937641261254586,0.29584830385440375
4931,0.4931,17,86,17,422844,182766,31148,76808,1.692967505279929,0.29590020572168246
4932,0.4932,17,59,17,422903,182707,31165,76791,1.692420986327763,0.29592135584859997
4933,0.4933,13,68,13,422971,182639,31178,76778,1.6917911000778094,0.29596364155009114
4934,0.4934,19,71,19,423042,182568,31197,76759,1.6911334247285932,0.29599308980553507
4935,0.4935,15,66,15,423108,182502,31212,76744,1.6905220645448145,0.29602771113151216
4936,0.4936,12,95,12,423203,182407,31224,76732,1.689642076401497,0.2961036355006387
4937,0.4937,13,70,13,423273,182337,31237,76719,1.6889936640853682,0.29614832314248657
4938,0.4938,16,80,16,423353,182257,31253,76703,1.6882526214383637,0.29619632375656474
4939,0.4939,17,63,17,423416,182194,31270,76686,1.6876690503538478,0.29622218788627935
4940,0.494,12,85,12,423501,182109,31282,76674,1.6868816925414059,0.2962868503727061
4941,0.4941,19,60,19,423561,182049,31301,76655,1.6863259105561526,0.29630388397550866
4942,0.4942,17,74,17,423635,181975,31318,76638,1.6856404461076735,0.29634241124769445
4943,0.4943,10,70,10,423705,181905,31328,76628,1.6849920337915447,0.29639543114418665
4944,0.4944,14,59,14,423764,181846,31342,76614,1.684445514839379,0.2964249787201114
4945,0.4945,10,72,10,423836,181774,31352,76604,1.6837785764570752,0.2964803504942371
4946,0.4946,14,74,14,423910,181700,31366,76590,1.6830931120085961,0.2965271593944791
4947,0.4947,16,77,16,423987,181623,31382,76574,1.6823798584608545,0.29657199735086
4948,0.4948,19,72,19,424059,181551,31401,76555,1.6817129200785506,0.29660294607641824
4949,0.4949,15,78,15,424137,181473,31416,76540,1.6809904034977212,0.2966517190994252
4950,0.495,12,69,12,424206,181404,31428,76528,1.6803512542146801,0.2966983546050897
4951,0.4951,9,80,9,424286,181324,31437,76519,1.6796102115676756,0.29676586139627603
4952,0.4952,18,71,18,424357,181253,31455,76501,1.6789525362184594,0.2967984977924688
4953,0.4953,14,72,14,424429,181181,31469,76487,1.6782855978361555,0.29684322461462037
4954,0.4954,13,71,13,424500,181110,31482,76474,1.677627922486939,0.29688955835766195
4955,0.4955,12,84,12,424584,181026,31494,76462,1.6768498277075845,0.2969536444416827
4956,0.4956,12,82,12,424666,180944,31506,76450,1.6760902589944051,0.29701547044608656
4957,0.4957,14,66,14,424732,180878,31520,76436,1.6754788988106266,0.2970534055667395
4958,0.4958,13,79,13,424811,180799,31533,76423,1.6747471191967098,0.29710911197331485
4959,0.4959,13,73,13,424884,180726,31546,76410,1.6740709177813182,0.2971579242113123
4960,0.496,13,79,13,424963,180647,31559,76397,1.6733391381674014,0.29721370660276064
4961,0.4961,12,70,12,425033,180577,31571,76385,1.6726907258512727,0.29726185194698046
4962,0.4962,15,63,15,425096,180514,31586,76370,1.6721071547667568,0.2972937201227013
4963,0.4963,16,65,16,425161,180449,31602,76354,1.6715050576160657,0.29732518701105515
4964,0.4964,21,67,21,425228,180382,31623,76333,1.6708844343991998,0.29734530510488283
4965,0.4965,13,64,13,425292,180318,31636,76320,1.6702916002815962,0.297383863652304
4966,0.4966,14,82,14,425374,180236,31650,76306,1.6695320315684168,0.2974405750325483
4967,0.4967,6,76,6,425450,180160,31656,76300,1.6688280410537626,0.2975122826171723
4968,0.4968,15,63,15,425513,180097,31671,76285,1.6682444699692467,0.2975442893806898
4969,0.4969,10,81,10,425594,180016,31681,76275,1.6674941642891548,0.2976109188383517
4970,0.497,17,80,17,425674,179936,31698,76258,1.6667531216421505,0.2976572441196905
4971,0.4971,13,71,13,425745,179865,31711,76245,1.6660954462929343,0.2977041115145836
4972,0.4972,15,81,15,425826,179784,31726,76230,1.6653451406128423,0.2977571539056458
4973,0.4973,11,63,11,425889,179721,31737,76219,1.6647615695283264,0.29780026568727047
4974,0.4974,10,66,10,425955,179655,31747,76209,1.6641502093445477,0.29784963887065
4975,0.4975,14,66,14,426021,179589,31761,76195,1.6635388491607692,0.29788806180214555
4976,0.4976,13,71,13,426092,179518,31774,76182,1.6628811738115528,0.29793508017207665
4977,0.4977,19,83,19,426175,179435,31793,76163,1.662112342065286,0.29797963990328563
4978,0.4978,17,75,17,426250,179360,31810,76146,1.6614176145837194,0.2980203987381901
4979,0.4979,18,74,18,426324,179286,31828,76128,1.6607321501352403,0.2980572717235547
4980,0.498,14,64,14,426388,179222,31842,76114,1.6601393160176368,0.2980934924961619
4981,0.4981,22,65,22,426453,179157,31864,76092,1.6595372188669457,0.2981089054217646
4982,0.4982,7,75,7,426528,179082,31871,76085,1.6588424913853792,0.2981772721394224
4983,0.4983,8,66,8,426594,179016,31879,76077,1.6582311312016007,0.2982324093565876
4984,0.4984,20,61,20,426655,178955,31899,76057,1.65766608618326,0.2982487098646338
4985,0.4985,18,77,18,426732,178878,31917,76039,1.656952832635518,0.29828924708826793
4986,0.4986,13,74,13,426806,178804,31930,76026,1.6562673681870392,0.29834006985048855
4987,0.4987,15,65,15,426871,178739,31945,76011,1.6556652710363482,0.2983748773307164
4988,0.4988,12,60,12,426931,178679,31957,75999,1.655109489051095,0.2984121125499651
4989,0.4989,11,71,11,427002,178608,31968,75988,1.6544518137018784,0.2984650190890666
4990,0.499,13,69,13,427071,178539,31981,75975,1.6538126644188373,0.2985101016054127
4991,0.4991,18,65,18,427136,178474,31999,75957,1.6532105672681463,0.29853673491044724
4992,0.4992,11,96,11,427232,178378,32010,75946,1.6523213160917412,0.29861908431764206
4993,0.4993,12,77,12,427309,178301,32022,75934,1.6516080625439995,0.2986764214211261
4994,0.4994,17,65,17,427374,178236,32039,75917,1.6510059653933085,0.2987058976285938
4995,0.4995,10,67,10,427441,178169,32049,75907,1.6503853421764423,0.2987570648152521
4996,0.4996,9,65,9,427506,178104,32058,75898,1.6497832450257512,0.2988086707978677
4997,0.4997,17,86,17,427592,178018,32075,75881,1.6489866241802216,0.29886293368622957
4998,0.4998,15,70,15,427662,177948,32090,75866,1.6483382118640928,0.2989039217694847
4999,0.4999,17,80,17,427742,177868,32107,75849,1.6475971692170885,0.2989511936527706
5000,0.5,13,66,13,427808,177802,32120,75836,1.6469858090333098,0.2989930530914138
5001,0.5001,15,90,15,427898,177712,32135,75821,1.64615213605543,0.2990577163525064
5002,0.5002,11,90,11,427988,177622,32146,75810,1.6453184630775501,0.29913349537548534
5003,0.5003,13,67,13,428055,177555,32159,75797,1.644697839860684,0.2991766396160283
5004,0.5004,16,80,16,428135,177475,32175,75781,1.6439567972136797,0.29922686925482517
5005,0.5005,8,84,8,428219,177391,32183,75773,1.6431787024343252,0.2993040084688186
5006,0.5006,18,73,18,428292,177318,32201,75755,1.6425025010189336,0.2993405064941736
5007,0.5007,18,67,18,428359,177251,32219,75737,1.6418818778020674,0.29936993058959316
5008,0.5008,12,68,12,428427,177183,32231,75725,1.6412519915521138,0.2994171793695731
5009,0.5009,15,72,15,428499,177111,32246,75710,1.6405850531698098,0.2994608833918069
5010,0.501,8,69,8,428568,177042,32254,75702,1.6399459038867688,0.29952046339378974
5011,0.5011,15,82,15,428650,176960,32269,75687,1.6391863351735891,0.29957608837627203
5012,0.5012,13,75,13,428725,176885,32282,75674,1.6384916076920226,0.29962899758076333
5013,0.5013,14,74,14,428799,176811,32296,75660,1.6378061432435436,0.2996779828178286
5014,0.5014,12,66,12,428865,176745,32308,75648,1.637194783059765,0.2997230509562468
5015,0.5015,10,74,10,428939,176671,32318,75638,1.636509318611286,0.2997832023431586
5016,0.5016,12,59,12,428998,176612,32330,75626,1.6359627996591204,0.2998200112592076
5017,0.5017,15,64,15,429062,176548,32345,75611,1.6353699655415168,0.2998544569101242
5018,0.5018,17,81,17,429143,176467,32362,75594,1.634619659861425,0.2999035947647593
5019,0.5019,13,78,13,429221,176389,32375,75581,1.6338971432805958,0.2999603127356431
5020,0.502,11,60,11,429281,176329,32386,75570,1.6333413612953425,0.30000119095351707
5021,0.5021,16,77,16,429358,176252,32402,75554,1.6326281077476008,0.3000484499972201
5022,0.5022,10,76,10,429434,176176,32412,75544,1.6319241172329468,0.30011123470522805
5023,0.5023,10,74,10,429508,176102,32422,75534,1.6312386527844678,0.30017167654866556
5024,0.5024,11,81,11,429589,176021,32433,75523,1.6304883471043758,0.30023773176859714
5025,0.5025,8,67,8,429656,175954,32441,75515,1.6298677238875097,0.3002954638543916
5026,0.5026,21,63,21,429719,175891,32462,75494,1.6292841528029938,0.3003122700240667
5027,0.5027,14,56,14,429775,175835,32476,75480,1.6287654229500907,0.30034021049280785
5028,0.5028,11,74,11,429849,175761,32487,75469,1.6280799585016117,0.30039804163515504
5029,0.5029,8,64,8,429913,175697,32495,75461,1.6274871243840083,0.3004523049235939
5030,0.503,14,71,14,429984,175626,32509,75447,1.6268294490347919,0.3004982614618059
5031,0.5031,13,73,13,430057,175553,32522,75434,1.6261532476194005,0.30054943084701596
5032,0.5032,17,77,17,430134,175476,32539,75417,1.6254399940716588,0.3005942772416927
5033,0.5033,11,67,11,430201,175409,32550,75406,1.6248193708547927,0.30064390088312104
5034,0.5034,12,59,12,430260,175350,32562,75394,1.624272851902627,0.30068117282965895
5035,0.5035,10,77,10,430337,175273,32572,75384,1.6235595983548854,0.30074564045687935
5036,0.5036,13,71,13,430408,175202,32585,75371,1.622901923005669,0.30079457882533234
5037,0.5037,14,65,14,430473,175137,32599,75357,1.622299825854978,0.30083355289947067
5038,0.5038,12,68,12,430541,175069,32611,75345,1.6216699396050243,0.3008817398388269
5039,0.5039,11,64,11,430605,175005,32622,75334,1.621077105487421,0.3009279417110398
5040,0.504,16,62,16,430667,174943,32638,75318,1.6205027974359925,0.3009578000567408
5041,0.5041,18,86,18,430753,174857,32656,75300,1.6197061765904628,0.30101096511390846
5042,0.5042,13,78,13,430831,174779,32669,75287,1.6189836600096335,0.3010685179112714
5043,0.5043,13,72,13,430903,174707,32682,75274,1.6183167216273298,0.3011188850352627
5044,0.5044,16,71,16,430974,174636,32698,75258,1.6176590462781133,0.30115969170928475
5045,0.5045,18,53,18,431027,174583,32716,75240,1.6171681055244729,0.3011732306472983
5046,0.5046,16,67,16,431094,174516,32732,75224,1.6165474823076067,0.30120925762793305
5047,0.5047,14,81,14,431175,174435,32746,75210,1.615797176627515,0.3012678002763925
5048,0.5048,9,78,9,431253,174357,32755,75201,1.6150746600466857,0.3013367633976871
5049,0.5049,2,79,2,431332,174278,32757,75199,1.6143428804327689,0.30142658441459536
5050,0.505,10,74,10,431406,174204,32767,75189,1.6136574159842898,0.3014880128953098
5051,0.5051,14,81,14,431487,174123,32781,75175,1.612907110304198,0.3015467432550602
5052,0.5052,15,80,15,431567,174043,32796,75160,1.6121660676571936,0.3016015055998523
5053,0.5053,19,79,19,431646,173964,32815,75141,1.6114342880432768,0.3016438851086891
5054,0.5054,17,84,17,431730,173880,32832,75124,1.6106561932639223,0.30169796469133026
5055,0.5055,15,71,15,431801,173809,32847,75109,1.609998517914706,0.3017419391124788
5056,0.5056,11,77,11,431878,173732,32858,75098,1.6092852643669644,0.30180444480167185
5057,0.5057,12,65,12,431943,173667,32870,75086,1.6086831672162734,0.3018496259341596
5058,0.5058,15,68,15,432011,173599,32885,75071,1.6080532809663197,0.30189005509309524
5059,0.5059,9,67,9,432078,173532,32894,75062,1.6074326577494535,0.3019461451201558
5060,0.506,15,82,15,432160,173450,32909,75047,1.606673089036274,0.30200364591926665
5061,0.5061,13,55,13,432215,173395,32922,75034,1.6061636222164586,0.30203398153999733
5062,0.5062,10,83,10,432298,173312,32932,75024,1.6053947904701915,0.30210682301398106
5063,0.5063,16,66,16,432364,173246,32948,75008,1.604783430286413,0.30214216085138607
5064,0.5064,23,50,23,432414,173196,32971,74985,1.6043202786320352,0.3021383586978858
5065,0.5065,11,80,11,432494,173116,32982,74974,1.603579235985031,0.30220484501592165
5066,0.5066,11,63,11,432557,173053,32993,74963,1.602995664900515,0.3022506612476614
5067,0.5067,12,64,12,432621,172989,33005,74951,1.6024028307829115,0.3022949100588852
5068,0.5068,11,80,11,432701,172909,33016,74940,1.6016617881359072,0.3023615185052189
5069,0.5069,10,75,10,432776,172834,33026,74930,1.6009670606543407,0.30242488820006136
5070,0.507,12,80,12,432856,172754,33038,74918,1.6002260180073362,0.3024887754772441
5071,0.5071,14,73,14,432929,172681,33052,74904,1.5995498165919448,0.30253852212371507
5072,0.5072,11,74,11,433003,172607,33063,74893,1.5988643521434658,0.3025979797979798
5073,0.5073,14,63,14,433066,172544,33077,74879,1.5982807810589499,0.3026355674290587
5074,0.5074,14,79,14,433145,172465,33091,74865,1.597549001445033,0.30269275866251566
5075,0.5075,15,70,15,433215,172395,33106,74850,1.5969005891289043,0.30273615239944185
5076,0.5076,20,62,20,433277,172333,33126,74830,1.596326281077476,0.3027556713585771
5077,0.5077,18,93,18,433370,172240,33144,74812,1.5954648190003335,0.30281883975843144
5078,0.5078,17,63,17,433433,172177,33161,74795,1.5948812479158176,0.30284809614045316
5079,0.5079,16,70,16,433503,172107,33177,74779,1.5942328355996889,0.302888782677025
5080,0.508,11,77,11,433580,172030,33188,74768,1.593519582051947,0.3029522119304046
5081,0.5081,12,70,12,433650,171960,33200,74756,1.5928711697358182,0.30300426401206243
5082,0.5082,27,57,27,433707,171903,33227,74729,1.5923431768498277,0.30299798890654905
5083,0.5083,14,57,14,433764,171846,33241,74715,1.591815183963837,0.3030284594887269
5084,0.5084,13,60,13,433824,171786,33254,74702,1.591259401978584,0.30306546363311804
5085,0.5085,15,60,15,433884,171726,33269,74687,1.5907036199933307,0.3030968333651228
5086,0.5086,10,85,10,433969,171641,33279,74677,1.5899162621808884,0.30317313391631956
5087,0.5087,8,93,8,434062,171548,33287,74669,1.589054800103746,0.3032650060718797
5088,0.5088,20,75,20,434137,171473,33307,74649,1.5883600726221794,0.3033008020412641
5089,0.5089,17,57,17,434194,171416,33324,74632,1.587832079736189,0.30332292885940954
5090,0.509,17,77,17,434271,171339,33341,74615,1.5871188261884472,0.3033697358042561
5091,0.5091,14,74,14,434345,171265,33355,74601,1.5864333617399682,0.3034213758714096
5092,0.5092,13,80,13,434425,171185,33368,74588,1.5856923190929637,0.30348329556135134
5093,0.5093,14,69,14,434494,171116,33382,74574,1.5850531698099226,0.3035288371525093
5094,0.5094,16,76,16,434570,171040,33398,74558,1.5843491792952684,0.303577390695364
5095,0.5095,19,65,19,434635,170975,33417,74539,1.5837470821445774,0.3036038678038727
5096,0.5096,12,71,12,434706,170904,33429,74527,1.5830894067953611,0.3036576471594868
5097,0.5097,17,63,17,434769,170841,33446,74510,1.5825058357108452,0.3036873703388207
5098,0.5098,13,82,13,434851,170759,33459,74497,1.5817462669976656,0.30375199791238544
5099,0.5099,9,76,9,434927,170683,33468,74488,1.5810422764830117,0.3038205986841837
5100,0.51,6,60,6,434987,170623,33474,74482,1.5804864944977584,0.3038779298667918
5101,0.5101,10,62,10,435049,170561,33484,74472,1.57991218644633,0.30392640991213427
5102,0.5102,24,59,24,435108,170502,33508,74448,1.5793656674941643,0.3039314145744029
5103,0.5103,14,63,14,435171,170439,33522,74434,1.5787820964096484,0.3039698129234338
5104,0.5104,10,62,10,435233,170377,33532,74424,1.57820778835822,0.30401836593804765
5105,0.5105,12,72,12,435305,170305,33544,74412,1.577540849975916,0.3040736851138254
5106,0.5106,14,70,14,435375,170235,33558,74398,1.5768924376597873,0.3041208667677705
5107,0.5107,11,85,11,435460,170150,33569,74387,1.5761050798473453,0.3041952751526354
5108,0.5108,15,66,15,435526,170084,33584,74372,1.5754937196635665,0.30423470890466997
5109,0.5109,15,78,15,435604,170006,33599,74357,1.5747712030827374,0.3042891108719405
5110,0.511,13,93,13,435697,169913,33612,74344,1.5739097410055949,0.30436794032514936
5111,0.5111,15,65,15,435762,169848,33627,74329,1.5733076438549038,0.3044062299069937
5112,0.5112,17,71,17,435833,169777,33644,74312,1.5726499685056876,0.30444632900294566
5113,0.5113,10,77,10,435910,169700,33654,74302,1.5719367149579457,0.30451389742707025
5114,0.5114,16,69,16,435979,169631,33670,74286,1.5712975656749046,0.30455441810123934
5115,0.5115,19,78,19,436057,169553,33689,74267,1.5705750490940753,0.3045976540070544
5116,0.5116,15,73,15,436130,169480,33704,74252,1.569898847678684,0.30464608668537574
5117,0.5117,13,81,13,436211,169399,33717,74239,1.569148541998592,0.3047102668713419
5118,0.5118,11,78,11,436289,169321,33728,74228,1.5684260254177629,0.30477645155594973
5119,0.5119,13,89,13,436378,169232,33741,74215,1.5676016154729704,0.3048507478013695
5120,0.512,13,80,13,436458,169152,33754,74202,1.5668605728259661,0.304913829236421
5121,0.5121,9,88,9,436546,169064,33763,74193,1.5660454259142613,0.30499841731173205
5122,0.5122,17,76,17,436622,168988,33780,74176,1.5653414353996074,0.3050451547104012
5123,0.5123,9,76,9,436698,168912,33789,74167,1.5646374448849532,0.3051147980697633
5124,0.5124,17,67,17,436765,168845,33806,74150,1.564016821668087,0.30515031173480933
5125,0.5125,14,72,14,436837,168773,33820,74136,1.563349883285783,0.305200713024219
5126,0.5126,12,73,12,436910,168700,33832,74124,1.5626736818703917,0.3052581293447106
5127,0.5127,13,72,13,436982,168628,33845,74111,1.5620067434880878,0.3053114662250401
5128,0.5128,14,67,14,437049,168561,33859,74097,1.5613861202712216,0.3053556857799867
5129,0.5129,12,77,12,437126,168484,33871,74085,1.56067286672348,0.30541825212619916
5130,0.513,17,50,17,437176,168434,33888,74068,1.5602097150691023,0.30543253251519575
5131,0.5131,14,65,14,437241,168369,33902,74054,1.5596076179184113,0.30547431555586724
5132,0.5132,8,72,8,437313,168297,33910,74046,1.5589406795361074,0.3055421448112799
5133,0.5133,10,83,10,437396,168214,33920,74036,1.5581718477898403,0.3056181630546956
5134,0.5134,12,70,12,437466,168144,33932,74024,1.5575234354737115,0.3056720954048429
5135,0.5135,16,70,16,437536,168074,33948,74008,1.5568750231575827,0.30571459257606926
5136,0.5136,18,74,18,437610,168000,33966,73990,1.5561895587091037,0.30575643621637255
5137,0.5137,16,74,16,437684,167926,33982,73974,1.5555040942606246,0.3058040512608516
5138,0.5138,14,65,14,437749,167861,33996,73960,1.5549019971099336,0.30584605968877804
5139,0.5139,16,60,16,437809,167801,34012,73944,1.5543462151246805,0.3058760263914455
5140,0.514,11,74,11,437883,167727,34023,73933,1.5536607506762015,0.3059380948439957
5141,0.5141,12,63,12,437946,167664,34035,73921,1.5530771795916856,0.3059834012873316
5142,0.5142,22,61,22,438007,167603,34057,73899,1.5525121345733448,0.305997465859496
5143,0.5143,11,73,11,438080,167530,34068,73888,1.5518359331579532,0.3060583717866936
5144,0.5144,9,71,9,438151,167459,34077,73879,1.551178257808737,0.30612253354216906
5145,0.5145,13,80,13,438231,167379,34090,73866,1.5504372151617325,0.30618665671827394
5146,0.5146,23,77,23,438308,167302,34113,73843,1.5497239616139908,0.3062182504302391
5147,0.5147,21,82,21,438390,167220,34134,73822,1.5489643929008114,0.30626197924013243
5148,0.5148,12,71,12,438461,167149,34146,73810,1.548306717551595,0.30631767230109685
5149,0.5149,17,67,17,438528,167082,34163,73793,1.547686094334729,0.3063539180072652
5150,0.515,17,71,17,438599,167011,34180,73776,1.5470284189855126,0.3063952788148862
5151,0.5151,13,73,13,438672,166938,34193,73763,1.5463522175701212,0.30645074179168347
5152,0.5152,16,60,16,438732,166878,34209,73747,1.545796435584868,0.30648103896103895
5153,0.5153,11,73,11,438805,166805,34220,73736,1.5451202341694765,0.3065423358180102
5154,0.5154,6,64,6,438869,166741,34226,73730,1.544527400051873,0.30660661784581095
5155,0.5155,14,80,14,438949,166661,34240,73716,1.5437863574048687,0.30666827525095997
5156,0.5156,18,58,18,439007,166603,34258,73698,1.5432491014857905,0.30669035917453524
5157,0.5157,16,67,16,439074,166536,34274,73682,1.5426284782689244,0.30672972050387565
5158,0.5158,15,75,15,439149,166461,34289,73667,1.5419337507873578,0.3067822161513859
5159,0.5159,12,70,12,439219,166391,34301,73655,1.541285338471229,0.30683702290394343
5160,0.516,13,81,13,439300,166310,34314,73642,1.5405350327911371,0.3069030472761219
5161,0.5161,14,61,14,439361,166249,34328,73628,1.5399699877727964,0.30694064041154423
5162,0.5162,15,64,15,439425,166185,34343,73613,1.5393771536551928,0.3069792074996455
5163,0.5163,13,68,13,439493,166117,34356,73600,1.5387472674052391,0.3070287046809363
5164,0.5164,15,56,15,439549,166061,34371,73585,1.5382285375523361,0.30705707585355063
5165,0.5165,15,61,15,439610,166000,34386,73570,1.5376634925339954,0.30709187293901574
5166,0.5166,14,65,14,439675,165935,34400,73556,1.5370613953833043,0.3071347148744629
5167,0.5167,15,64,15,439739,165871,34415,73541,1.5364685612657007,0.3071734081833826
5168,0.5168,15,72,15,439811,165799,34430,73526,1.5358016228833968,0.30722239632299175
5169,0.5169,13,81,13,439892,165718,34443,73513,1.5350513172033051,0.3072887711040793
5170,0.517,12,66,12,439958,165652,34455,73501,1.5344399570195264,0.3073388165734906
5171,0.5171,13,72,13,440030,165580,34468,73488,1.5337730186372225,0.3073937122492345
5172,0.5172,15,60,15,440090,165520,34483,73473,1.5332172366519694,0.30742741419204744
5173,0.5173,13,73,13,440163,165447,34496,73460,1.5325410352365778,0.30748366519189474
5174,0.5174,15,73,15,440236,165374,34511,73445,1.5318648338211864,0.3075341576675223
5175,0.5175,17,83,17,440319,165291,34528,73428,1.5310960020749194,0.3075917710781295
5176,0.5176,15,91,15,440410,165200,34543,73413,1.530253066063952,0.307665550493896
5177,0.5177,12,54,12,440464,165146,34555,73401,1.529752862277224,0.30770036931925365
5178,0.5178,13,68,13,440532,165078,34568,73388,1.5291229760272704,0.3077503711220887
5179,0.5179,8,78,8,440610,165000,34576,73380,1.528400459446441,0.3078278379058646
5180,0.518,12,71,12,440681,164929,34588,73368,1.5277427840972249,0.3078846985064856
5181,0.5181,14,77,14,440758,164852,34602,73354,1.5270295305494832,0.30794354466302276
5182,0.5182,12,77,12,440835,164775,34614,73342,1.5263162770017416,0.3080082480461286
5183,0.5183,18,80,18,440915,164695,34632,73324,1.525575234354737,0.30805944063289065
5184,0.5184,11,65,11,440980,164630,34643,73313,1.524973137204046,0.30811160656123526
5185,0.5185,4,75,4,441055,164555,34647,73309,1.5242784097224795,0.3081971210439579
5186,0.5186,15,55,15,441110,164500,34662,73294,1.523768942902664,0.3082247659739102
5187,0.5187,8,70,8,441180,164430,34670,73286,1.5231205305865352,0.3082922478924431
5188,0.5188,10,86,10,441266,164344,34680,73276,1.5223239097410055,0.30837471593300225
5189,0.5189,11,56,11,441322,164288,34691,73265,1.5218051798881025,0.3084153851982505
5190,0.519,14,80,14,441402,164208,34705,73251,1.5210641372410982,0.3084785162912334
5191,0.5191,19,83,19,441485,164125,34724,73232,1.5202953054948312,0.3085310313156974
5192,0.5192,14,89,14,441574,164036,34738,73218,1.519470895550039,0.3086059666011953
5193,0.5193,11,74,11,441648,163962,34749,73207,1.5187854311015598,0.3086701887683466
5194,0.5194,16,90,16,441738,163872,34765,73191,1.51795175812368,0.3087407144936156
5195,0.5195,15,76,15,441814,163796,34780,73176,1.517247767609026,0.3087959758958864
5196,0.5196,10,71,10,441885,163725,34790,73166,1.5165900922598095,0.30885934881443367
5197,0.5197,14,81,14,441966,163644,34804,73152,1.5158397865797177,0.3089241372320478
5198,0.5198,16,56,16,442022,163588,34820,73136,1.5153210567268147,0.30895050776431626
5199,0.5199,10,76,10,442098,163512,34830,73126,1.5146170662121605,0.3090205292472046
5200,0.52,16,80,16,442178,163432,34846,73110,1.5138760235651563,0.3090783032188787
5201,0.5201,11,72,11,442250,163360,34857,73099,1.5132090851828524,0.30914027378953646
5202,0.5202,17,68,17,442318,163292,34874,73082,1.5125791989328985,0.30917952059025106
5203,0.5203,10,64,10,442382,163228,34884,73072,1.5119863648152951,0.3092340245450698
5204,0.5204,19,69,19,442451,163159,34903,73053,1.5113472155322538,0.3092687924406889
5205,0.5205,19,71,19,442522,163088,34922,73034,1.5106895401830376,0.3093062061137886
5206,0.5206,11,68,11,442590,163020,34933,73023,1.510059653933084,0.30936312451544845
5207,0.5207,16,72,16,442662,162948,34949,73007,1.50939271555078,0.3094106927168316
5208,0.5208,16,76,16,442738,162872,34965,72991,1.5086887250361258,0.30946354451524827
5209,0.5209,8,73,8,442811,162799,34973,72983,1.5080125236207345,0.3095359272548371
5210,0.521,6,89,6,442900,162710,34979,72977,1.507188113675942,0.3096352365637477
5211,0.5211,10,77,10,442977,162633,34989,72967,1.5064748601282003,0.30970713073005096
5212,0.5212,19,75,19,443052,162558,35008,72948,1.5057801326466338,0.30975007006190924
5213,0.5213,13,59,13,443111,162499,35021,72935,1.5052336136944682,0.30978958009463375
5214,0.5214,14,70,14,443181,162429,35035,72921,1.5045852013783394,0.3098406628425749
5215,0.5215,17,73,17,443254,162356,35052,72904,1.5039089999629478,0.3098869336053728
5216,0.5216,16,66,16,443320,162290,35068,72888,1.5032976397791693,0.3099269489493065
5217,0.5217,9,75,9,443395,162215,35077,72879,1.5026029122976028,0.30999940449352176
5218,0.5218,27,65,27,443460,162150,35104,72852,1.5020008151469117,0.31000587229044857
5219,0.5219,10,63,10,443523,162087,35114,72842,1.5014172440623959,0.31005963503867123
5220,0.522,18,75,18,443598,162012,35132,72824,1.5007225165808293,0.3101057759457664
5221,0.5221,3,81,3,443679,161931,35135,72821,1.4999722109007374,0.3102039599236641
5222,0.5222,15,82,15,443761,161849,35150,72806,1.4992126421875578,0.310268266178006
5223,0.5223,15,65,15,443826,161784,35165,72791,1.498610545036867,0.310310135351167
5224,0.5224,17,65,17,443891,161719,35182,72774,1.498008447886176,0.3103461510578141
5225,0.5225,18,67,18,443958,161652,35200,72756,1.4973878246693098,0.3103818982287294
5226,0.5226,8,81,8,444039,161571,35208,72748,1.4966375189892178,0.31046564725865167
5227,0.5227,21,67,21,444106,161504,35229,72727,1.4960168957723516,0.31049263334059113
5228,0.5228,14,70,14,444176,161434,35243,72713,1.4953684834562229,0.31054423076101767
5229,0.5229,16,81,16,444257,161353,35259,72697,1.494618177776131,0.3106045716727195
5230,0.523,16,84,16,444341,161269,35275,72681,1.4938400829967764,0.31066894635605896
5231,0.5231,12,72,12,444413,161197,35287,72669,1.4931731446144725,0.31072922100690137
5232,0.5232,11,75,11,444488,161122,35298,72658,1.492478417132906,0.31079647531867566
5233,0.5233,9,82,9,444570,161040,35307,72649,1.4917188484197266,0.310878988741447
5234,0.5234,9,65,9,444635,160975,35316,72640,1.4911167512690355,0.3109389379962759
5235,0.5235,18,65,18,444700,160910,35334,72622,1.4905146541183445,0.3109723720946166
5236,0.5236,19,70,19,444770,160840,35353,72603,1.4898662418022157,0.31100953980200735
5237,0.5237,13,60,13,444830,160780,35366,72590,1.4893104598169624,0.31105112053820116
5238,0.5238,11,67,11,444897,160713,35377,72579,1.4886898366000962,0.31110796769713495
5239,0.5239,9,77,9,444974,160636,35386,72570,1.4879765830523546,0.31118410332495733
5240,0.524,25,68,25,445042,160568,35411,72545,1.487346696802401,0.3112010055209276
5241,0.5241,13,82,13,445124,160486,35424,72532,1.4865871280892216,0.3112720905681106
5242,0.5242,24,71,24,445195,160415,35448,72508,1.485929452740005,0.3112960076935296
5243,0.5243,14,55,14,445250,160360,35462,72494,1.4854199859201898,0.31132812835510665
5244,0.5244,10,65,10,445315,160295,35472,72484,1.4848178887694987,0.3113854772122915
5245,0.5245,18,75,18,445390,160220,35490,72466,1.4841231612879322,0.31143257437061106
5246,0.5246,15,81,15,445471,160139,35505,72451,1.4833728556078403,0.3114966249623802
5247,0.5247,11,73,11,445544,160066,35516,72440,1.4826966541924487,0.3115618521672559
5248,0.5248,17,72,17,445616,159994,35533,72423,1.482029715810145,0.3116080149042454
5249,0.5249,14,71,14,445687,159923,35547,72409,1.4813720404609285,0.3116617598953222
5250,0.525,7,55,7,445742,159868,35554,72402,1.480862573641113,0.311714814655358
5251,0.5251,24,80,24,445822,159788,35578,72378,1.4801215309941087,0.31175107466209523
5252,0.5252,13,68,13,445890,159720,35591,72365,1.479491644744155,0.3118038649632678
5253,0.5253,16,65,16,445955,159655,35607,72349,1.478889547593464,0.3118437613144601
5254,0.5254,16,61,16,446016,159594,35623,72333,1.4783245025751233,0.3118783065361083
5255,0.5255,8,75,8,446091,159519,35631,72325,1.4776297750935565,0.31195545280447196
5256,0.5256,12,67,12,446158,159452,35643,72313,1.4770091518766906,0.312010010139581
5257,0.5257,8,64,8,446222,159388,35651,72305,1.476416317759087,0.31207244068659823
5258,0.5258,19,76,19,446298,159312,35670,72286,1.475712327244433,0.31211841207609736
5259,0.5259,19,69,19,446367,159243,35689,72267,1.4750731779613917,0.31215498250615525
5260,0.526,9,70,9,446437,159173,35698,72258,1.474424765645263,0.31222264951540635
5261,0.5261,18,54,18,446491,159119,35716,72240,1.473924561858535,0.31224201349418
5262,0.5262,10,89,10,446580,159030,35726,72230,1.4731001519137426,0.31233243967828417
5263,0.5263,16,55,16,446635,158975,35742,72214,1.4725906850939272,0.31235915203578024
5264,0.5264,12,84,12,446719,158891,35754,72202,1.4718125903145727,0.3124369842444384
5265,0.5265,16,68,16,446787,158823,35770,72186,1.4711827040646188,0.3124813318961599
5266,0.5266,25,82,25,446869,158741,35795,72161,1.4704231353514394,0.31251786472183
5267,0.5267,13,57,13,446926,158684,35808,72148,1.469895142465449,0.3125563180148333
5268,0.5268,15,68,15,446994,158616,35823,72133,1.4692652562154953,0.3126037382610542
5269,0.5269,13,85,13,447079,158531,35836,72120,1.468477898403053,0.3126801964873337
5270,0.527,19,64,19,447143,158467,35855,72101,1.4678850642854497,0.31271035009194686
5271,0.5271,9,65,9,447208,158402,35864,72092,1.4672829671347587,0.312771699046396
5272,0.5272,16,76,16,447284,158326,35880,72076,1.4665789766201045,0.3128271455976945
5273,0.5273,23,56,23,447340,158270,35903,72053,1.4660602467672015,0.3128345844748462
5274,0.5274,13,69,13,447409,158201,35916,72040,1.4654210974841602,0.31288953748463566
5275,0.5275,11,73,11,447482,158128,35927,72029,1.4647448960687688,0.3129559387722294
5276,0.5276,16,72,16,447554,158056,35943,72013,1.4640779576864649,0.3130060981705488
5277,0.5277,18,62,18,447616,157994,35961,71995,1.4635036496350364,0.31303671045136944
5278,0.5278,16,69,16,447685,157925,35977,71979,1.4628645003519953,0.3130828519729974
5279,0.5279,17,67,17,447752,157858,35994,71962,1.4622438771351292,0.3131233138978331
5280,0.528,8,79,8,447831,157779,36002,71954,1.4615120975212124,0.3132070708169919
5281,0.5281,17,84,17,447915,157695,36019,71937,1.4607340027418578,0.3132707984949833
5282,0.5282,17,59,17,447974,157636,36036,71920,1.460187483789692,0.31330045827597625
5283,0.5283,15,77,15,448051,157559,36051,71905,1.4594742302419503,0.3133607014607956
5284,0.5284,9,88,9,448139,157471,36060,71896,1.4586590833302457,0.31345398422615284
5285,0.5285,17,72,17,448211,157399,36077,71879,1.4579921449479418,0.3135015134465583
5286,0.5286,13,60,13,448271,157339,36090,71866,1.4574363629626885,0.3135446434414607
5287,0.5287,16,61,16,448332,157278,36106,71850,1.4568713179443478,0.31358018225620615
5288,0.5288,18,64,18,448396,157214,36124,71832,1.4562784838267442,0.3136138592247845
5289,0.5289,16,71,16,448467,157143,36140,71816,1.455620808477528,0.3136631449298783
5290,0.529,13,70,13,448537,157073,36153,71803,1.4549723961613992,0.3137200929761093
5291,0.5291,17,70,17,448607,157003,36170,71786,1.4543239838452704,0.31376508485984905
5292,0.5292,10,75,10,448682,156928,36180,71776,1.4536292563637037,0.31383797397509444
5293,0.5293,17,62,17,448744,156866,36197,71759,1.4530549483122754,0.31387206123564787
5294,0.5294,18,82,18,448826,156784,36215,71741,1.4522953795990958,0.3139306421616891
5295,0.5295,9,67,9,448893,156717,36224,71732,1.4516747563822299,0.3139956839382094
5296,0.5296,12,71,12,448964,156646,36236,71720,1.4510170810330134,0.3140572589614916
5297,0.5297,15,62,15,449026,156584,36251,71705,1.4504427729815852,0.3140974817008266
5298,0.5298,15,75,15,449101,156509,36266,71690,1.4497480455000185,0.31415562732527313
5299,0.5299,11,67,11,449168,156442,36277,71679,1.4491274222831525,0.31421482458870514
5300,0.53,18,78,18,449246,156364,36295,71661,1.4484049057023232,0.3142681723495231
5301,0.5301,14,69,14,449315,156295,36309,71647,1.4477657564192818,0.31432118696861483
5302,0.5302,10,70,10,449385,156225,36319,71637,1.447117344103153,0.3143876556863365
5303,0.5303,16,59,16,449444,156166,36335,71621,1.4465708251509874,0.31442092832338986
5304,0.5304,10,75,10,449519,156091,36345,71611,1.445876097669421,0.3144943830093719
5305,0.5305,15,73,15,449592,156018,36360,71596,1.4451998962540293,0.31455007161246673
5306,0.5306,16,86,16,449678,155932,36376,71580,1.4444032754084997,0.3146207672562326
5307,0.5307,13,68,13,449746,155864,36389,71567,1.443773389158546,0.3146756598704662
5308,0.5308,8,67,8,449813,155797,36397,71559,1.4431527659416798,0.3147442776966519
5309,0.5309,14,76,14,449889,155721,36411,71545,1.4424487754270259,0.31480731829662156
5310,0.531,17,60,17,449949,155661,36428,71528,1.4418929934417726,0.31483918675640105
5311,0.5311,13,78,13,450027,155583,36441,71515,1.4411704768609432,0.3149081013483166
5312,0.5312,16,67,16,450094,155516,36457,71499,1.4405498536440773,0.31495275642578685
5313,0.5313,15,88,15,450182,155428,36472,71484,1.4397347067323725,0.3150296150049358
5314,0.5314,13,77,13,450259,155351,36485,71471,1.4390214531846308,0.3150973009672783
5315,0.5315,16,65,16,450324,155286,36501,71455,1.4384193560339398,0.3151392999060602
5316,0.5316,19,65,19,450389,155221,36520,71436,1.4378172588832487,0.315172264699524
5317,0.5317,16,73,16,450462,155148,36536,71420,1.4371410574678574,0.31522545107870487
5318,0.5318,12,74,12,450536,155074,36548,71408,1.4364555930193783,0.31529216449872394
5319,0.5319,18,71,18,450607,155003,36566,71390,1.4357979176701618,0.3153366049303645
5320,0.532,14,75,14,450682,154928,36580,71376,1.4351031901885953,0.3153987556561086
5321,0.5321,17,67,17,450749,154861,36597,71359,1.4344825669717292,0.315440721421625
5322,0.5322,18,66,18,450815,154795,36615,71341,1.4338712067879507,0.31547829624650653
5323,0.5323,15,63,15,450878,154732,36630,71326,1.4332876357034348,0.3155207955480452
5324,0.5324,8,59,8,450937,154673,36638,71318,1.4327411167512691,0.31557893898429584
5325,0.5325,11,71,11,451008,154602,36649,71307,1.4320834414020527,0.3156447950280865
5326,0.5326,6,67,6,451075,154535,36655,71301,1.4314628181851865,0.315720257177775
5327,0.5327,16,63,16,451138,154472,36671,71285,1.4308792471006706,0.31575986569630177
5328,0.5328,15,75,15,451213,154397,36686,71270,1.430184519619104,0.31581932670705065
5329,0.5329,15,72,15,451285,154325,36701,71255,1.4295175812368002,0.3158746342760883
5330,0.533,20,52,20,451337,154273,36721,71235,1.4290359035162474,0.3158867978076166
5331,0.5331,13,71,13,451408,154202,36734,71222,1.428378228167031,0.31594683795869116
5332,0.5332,13,77,13,451485,154125,36747,71209,1.4276649746192893,0.31601533723273006
5333,0.5333,16,70,16,451555,154055,36763,71193,1.4270165623031605,0.3160649595112942
5334,0.5334,18,62,18,451617,153993,36781,71175,1.426442254251732,0.31609731400554253
5335,0.5335,11,62,11,451679,153931,36792,71164,1.4258679462003039,0.31615095848419555
5336,0.5336,14,100,14,451779,153831,36806,71150,1.4249416428915485,0.3162489276872269
5337,0.5337,19,69,19,451848,153762,36825,71131,1.4243024936085071,0.31628819038387146
5338,0.5338,10,70,10,451918,153692,36835,71121,1.4236540812923784,0.3163562605365348
5339,0.5339,19,70,19,451988,153622,36854,71102,1.4230056689762496,0.31639700254534453
5340,0.534,8,67,8,452055,153555,36862,71094,1.4223850457593834,0.3164670218874778
5341,0.5341,15,70,15,452125,153485,36877,71079,1.4217366334432546,0.31652001211235997
5342,0.5342,14,65,14,452190,153420,36891,71065,1.4211345362925636,0.3165690357930374
5343,0.5343,9,71,9,452261,153349,36900,71056,1.4204768609433474,0.31664178605646043
5344,0.5344,19,66,19,452327,153283,36919,71037,1.4198655007595686,0.3166770684736091
5345,0.5345,12,75,12,452402,153208,36931,71025,1.4191707732780021,0.3167464200184629
5346,0.5346,20,64,20,452466,153144,36951,71005,1.4185779391603988,0.31677589460582023
5347,0.5347,15,62,15,452528,153082,36966,70990,1.4180036311089703,0.3168178085615338
5348,0.5348,11,54,11,452582,153028,36977,70979,1.4175034273222424,0.3168606338194789
5349,0.5349,10,70,10,452652,152958,36987,70969,1.4168550150061137,0.3169291778124121
5350,0.535,16,76,16,452728,152882,37003,70953,1.4161510244914595,0.31698795988116246
5351,0.5351,7,61,7,452789,152821,37010,70946,1.4155859794731187,0.31705300602859227
5352,0.5352,9,82,9,452871,152739,37019,70937,1.4148264107599393,0.31714175861513977
5353,0.5353,7,67,7,452938,152672,37026,70930,1.4142057875430731,0.31721540952227617
5354,0.5354,17,69,17,453007,152603,37043,70913,1.4135666382600318,0.31726140410529896
5355,0.5355,9,81,9,453088,152522,37052,70904,1.4128163325799399,0.31734892089550903
5356,0.5356,19,80,19,453168,152442,37071,70885,1.4120752899329356,0.31740452341185793
5357,0.5357,9,60,9,453228,152382,37080,70876,1.4115195079476823,0.31746230818156573
5358,0.5358,10,79,10,453307,152303,37090,70866,1.4107877283337655,0.3175441033476872
5359,0.5359,16,64,16,453371,152239,37106,70850,1.4101948942161622,0.3175862548131015
5360,0.536,18,72,18,453443,152167,37124,70832,1.4095279558338583,0.31763371136193436
5361,0.5361,13,68,13,453511,152099,37137,70819,1.4088980695839046,0.31769081007365935
5362,0.5362,15,66,15,453577,152033,37152,70804,1.408286709400126,0.3177389751253158
5363,0.5363,17,72,17,453649,151961,37169,70787,1.407619771017822,0.3177896097832528
5364,0.5364,23,81,23,453730,151880,37192,70764,1.4068694653377303,0.31783474964517344
5365,0.5365,17,73,17,453803,151807,37209,70747,1.4061932639223387,0.3178868948659651
5366,0.5366,16,70,16,453873,151737,37225,70731,1.40554485160621,0.317937860726037
5367,0.5367,21,65,21,453938,151672,37246,70710,1.4049427544555189,0.3179663821712189
5368,0.5368,17,80,17,454018,151592,37263,70693,1.4042017118085146,0.3180286569044245
5369,0.5369,16,65,16,454083,151527,37279,70677,1.4035996146578236,0.31807258195172006
5370,0.537,17,56,17,454139,151471,37296,70660,1.4030808848049205,0.3181005802882083
5371,0.5371,18,66,18,454205,151405,37314,70642,1.402469524621142,0.31813985327430677
5372,0.5372,13,68,13,454273,151337,37327,70629,1.4018396383711882,0.31819738158096283
5373,0.5373,12,58,12,454331,151279,37339,70617,1.40130238245211,0.31824368172477197
5374,0.5374,10,76,10,454407,151203,37349,70607,1.400598391937456,0.3183219872864163
5375,0.5375,7,73,7,454480,151130,37356,70600,1.3999221905220645,0.31840526766788435
5376,0.5376,10,72,10,454552,151058,37366,70590,1.3992552521397605,0.31847794701508697
5377,0.5377,14,69,14,454621,150989,37380,70576,1.3986161028567194,0.31853406449574617
5378,0.5378,6,74,6,454695,150915,37386,70570,1.3979306384082404,0.31862202857981353
5379,0.5379,20,62,20,454757,150853,37406,70550,1.397356330356812,0.3186497021268908
5380,0.538,19,65,19,454822,150788,37425,70531,1.396754233206121,0.31868479434662184
5381,0.5381,13,58,13,454880,150730,37438,70518,1.396216977287043,0.31872830488863174
5382,0.5382,13,74,13,454954,150656,37451,70505,1.395531512838564,0.31879490506915775
5383,0.5383,10,66,10,455020,150590,37461,70495,1.3949201526547852,0.31885926227469075
5384,0.5384,23,61,23,455081,150529,37484,70472,1.3943551076364444,0.3188763851747277
5385,0.5385,15,76,15,455157,150453,37499,70457,1.3936511171217905,0.31893983975374585
5386,0.5386,12,79,12,455236,150374,37511,70445,1.3929193375078737,0.3190169324197646
5387,0.5387,12,75,12,455311,150299,37523,70433,1.392224610026307,0.31908830618125145
5388,0.5388,9,73,9,455384,150226,37532,70424,1.3915484086109156,0.31916610015862223
5389,0.5389,16,69,16,455453,150157,37548,70408,1.3909092593278742,0.31921655747738764
5390,0.539,13,65,13,455518,150092,37561,70395,1.3903071621771832,0.319270523885762
5391,0.5391,17,66,17,455584,150026,37578,70378,1.3896958019934047,0.3193136240721584
5392,0.5392,16,69,16,455653,149957,37594,70362,1.3890566527103634,0.3193641946450374
5393,0.5393,14,81,14,455734,149876,37608,70348,1.3883063470302717,0.31943839000290614
5394,0.5394,28,76,28,455810,149800,37636,70320,1.3876023565156175,0.31946211157550425
5395,0.5395,16,65,16,455875,149735,37652,70304,1.3870002593649264,0.3195069964869864
5396,0.5396,16,64,16,455939,149671,37668,70288,1.386407425247323,0.3195504616769489
5397,0.5397,18,78,18,456017,149593,37686,70270,1.3856849086664937,0.319608119601752
5398,0.5398,16,77,16,456094,149516,37702,70254,1.384971655118752,0.31967056468125765
5399,0.5399,16,69,16,456163,149447,37718,70238,1.3843325058357108,0.3197214193049139
5400,0.54,8,62,8,456225,149385,37726,70230,1.3837581977842826,0.3197868998019261
5401,0.5401,15,76,15,456301,149309,37741,70215,1.3830542072696284,0.31985113245021046
5402,0.5402,15,60,15,456361,149249,37756,70200,1.382498425284375,0.31989209337932734
5403,0.5403,18,61,18,456422,149188,37774,70182,1.3819333802660343,0.31992524046132104
5404,0.5404,13,64,13,456486,149124,37787,70169,1.381340546148431,0.31997829388078963
5405,0.5405,12,63,12,456549,149061,37799,70157,1.380756975063915,0.3200330264850514
5406,0.5406,17,61,17,456610,149000,37816,70140,1.380191930045574,0.3200693620516565
5407,0.5407,12,66,12,456676,148934,37828,70128,1.3795805698617956,0.3201285480822781
5408,0.5408,20,51,20,456727,148883,37848,70108,1.3791081551743303,0.3201410103611564
5409,0.5409,20,70,20,456797,148813,37868,70088,1.3784597428582015,0.32018126915820394
5410,0.541,10,68,10,456865,148745,37878,70078,1.3778298566082479,0.32024969952884297
5411,0.5411,14,66,14,456931,148679,37892,70064,1.3772184964244691,0.3203028211188472
5412,0.5412,18,68,18,456999,148611,37910,70046,1.3765886101745155,0.32034647873152927
5413,0.5413,16,69,16,457068,148542,37926,70030,1.3759494608914744,0.3203978551690061
5414,0.5414,12,68,12,457136,148474,37938,70018,1.3753195746415205,0.3204602456840525
5415,0.5415,14,70,14,457206,148404,37952,70004,1.3746711623253918,0.3205193948939599
5416,0.5416,17,67,17,457273,148337,37969,69987,1.3740505391085256,0.3205648485736795
5417,0.5417,17,56,17,457329,148281,37986,69970,1.3735318092556226,0.3205941782626425
5418,0.5418,11,67,11,457396,148214,37997,69959,1.3729111860387566,0.32065837660938795
5419,0.5419,13,62,13,457458,148152,38010,69946,1.3723368779873282,0.3207090390558373
5420,0.542,14,66,14,457524,148086,38024,69932,1.3717255178035497,0.320762505848141
5421,0.5421,11,80,11,457604,148006,38035,69921,1.3709844751565452,0.32084597135738113
5422,0.5422,14,73,14,457677,147933,38049,69907,1.3703082737411538,0.32090984208593465
5423,0.5423,19,66,19,457743,147867,38068,69888,1.3696969135573753,0.3209478542398567
5424,0.5424,10,59,10,457802,147808,38078,69878,1.3691503946052095,0.3210036474555093
5425,0.5425,16,76,16,457878,147732,38094,69862,1.3684464040905555,0.3210658382124507
5426,0.5426,16,65,16,457943,147667,38110,69846,1.3678443069398645,0.3211118415910773
5427,0.5427,19,69,19,458012,147598,38129,69827,1.3672051576568232,0.32115442106473496
5428,0.5428,11,63,11,458075,147535,38140,69816,1.3666215865723073,0.3212131529185511
5429,0.5429,19,72,19,458147,147463,38159,69797,1.3659546481900033,0.32126024118567614
5430,0.543,19,71,19,458218,147392,38178,69778,1.3652969728407869,0.3213058893954045
5431,0.5431,19,74,19,458292,147318,38197,69759,1.364611508392308,0.32135601652869716
5432,0.5432,7,65,7,458357,147253,38204,69752,1.364009411241617,0.3214303817884381
5433,0.5433,9,72,9,458429,147181,38213,69743,1.363342472859313,0.3215089155648983
5434,0.5434,19,72,19,458501,147109,38232,69724,1.3626755344770092,0.3215562206859657
5435,0.5435,15,71,15,458572,147038,38247,69709,1.3620178591277927,0.3216146013554974
5436,0.5436,17,78,17,458650,146960,38264,69692,1.3612953425469636,0.3216771596846556
5437,0.5437,14,54,14,458704,146906,38278,69678,1.3607951387602357,0.3217135153104569
5438,0.5438,16,86,16,458790,146820,38294,69662,1.359998517914706,0.32179118818192737
5439,0.5439,15,72,15,458862,146748,38309,69647,1.3593315795324021,0.3218512442524088
5440,0.544,9,57,9,458919,146691,38318,69638,1.3588035866464114,0.32190783482565904
5441,0.5441,15,64,15,458983,146627,38333,69623,1.358210752528808,0.3219560693641618
5442,0.5442,11,58,11,459041,146569,38344,69612,1.35767349660973,0.32200794704437485
5443,0.5443,18,81,18,459122,146488,38362,69594,1.356923190929638,0.32207217630344037
5444,0.5444,13,72,13,459194,146416,38375,69581,1.356256252547334,0.3221387334083344
5445,0.5445,23,76,23,459270,146340,38398,69558,1.35555226203268,0.3221799182947503
5446,0.5446,21,64,21,459334,146276,38419,69537,1.3549594279150765,0.3222095054514788
5447,0.5447,11,68,11,459402,146208,38430,69526,1.3543295416651229,0.3222765071801385
5448,0.5448,10,68,10,459470,146140,38440,69516,1.3536996554151692,0.3223467003004785
5449,0.5449,13,64,13,459534,146076,38453,69503,1.3531068212975657,0.3224015326168133
5450,0.545,19,81,19,459615,145995,38472,69484,1.3523565156174737,0.3224629778307863
5451,0.5451,13,57,13,459672,145938,38485,69471,1.3518285227314832,0.3225074161246745
5452,0.5452,12,69,12,459741,145869,38497,69459,1.351189373448442,0.32257300490414625
5453,0.5453,11,67,11,459808,145802,38508,69448,1.3505687502315757,0.32263879210220675
5454,0.5454,19,59,19,459867,145743,38527,69429,1.3500222312794101,0.3226674474373989
5455,0.5455,16,85,16,459952,145658,38543,69413,1.3492348734669681,0.32274458202175094
5456,0.5456,18,64,18,460016,145594,38561,69395,1.3486420393493646,0.3227839563884664
5457,0.5457,16,65,16,460081,145529,38577,69379,1.3480399421986735,0.32283116496361236
5458,0.5458,9,67,9,460148,145462,38586,69370,1.3474193189818073,0.32290347806658226
5459,0.5459,22,73,22,460221,145389,38608,69348,1.346743117566416,0.3229438801883234
5460,0.546,9,75,9,460296,145314,38617,69339,1.3460483900848494,0.32302832944333415
5461,0.5461,19,65,19,460361,145249,38636,69320,1.3454462929341584,0.3230662397643648
5462,0.5462,21,63,21,460424,145186,38657,69299,1.3448627218496425,0.3230948551180735
5463,0.5463,9,58,9,460482,145128,38666,69290,1.3443254659305643,0.32315383969629413
5464,0.5464,13,68,13,460550,145060,38679,69277,1.3436955796806107,0.32321531046902774
5465,0.5465,11,70,11,460620,144990,38690,69266,1.343047167364482,0.3232861623478456
5466,0.5466,8,63,8,460683,144927,38698,69258,1.3424635962799658,0.3233559773093354
5467,0.5467,18,59,18,460742,144868,38716,69240,1.3419170773278002,0.3233881966110561
5468,0.5468,14,62,14,460804,144806,38730,69226,1.3413427692763717,0.32343761680496375
5469,0.5469,9,65,9,460869,144741,38739,69217,1.340740672125681,0.3235074173435908
5470,0.547,11,72,11,460941,144669,38750,69206,1.340073733743377,0.32358153126826417
5471,0.5471,17,56,17,460997,144613,38767,69189,1.339555003890474,0.3236125012862368
5472,0.5472,13,69,13,461066,144544,38780,69176,1.3389158546074327,0.3236758375444507
5473,0.5473,20,74,20,461140,144470,38800,69156,1.3382303901589536,0.3237246402591445
5474,0.5474,15,81,15,461221,144389,38815,69141,1.3374800844788617,0.3237999344354423
5475,0.5475,15,63,15,461284,144326,38830,69126,1.3368965133943458,0.32384798455858926
5476,0.5476,12,66,12,461350,144260,38842,69114,1.3362851532105673,0.323910129631539
5477,0.5477,16,71,16,461421,144189,38858,69098,1.3356274778613508,0.3239672366342065
5478,0.5478,11,85,11,461506,144104,38869,69087,1.3348401200489088,0.3240615222969075
5479,0.5479,9,81,9,461587,144023,38878,69078,1.334089814368817,0.3241561513085344
5480,0.548,26,48,26,461635,143975,38904,69052,1.3336451887806142,0.3241467044083614
5481,0.5481,12,84,12,461719,143891,38916,69040,1.3328670940012597,0.3242364897548971
5482,0.5482,17,72,17,461791,143819,38933,69023,1.3322001556189558,0.32429219796844605
5483,0.5483,15,69,15,461860,143750,38948,69008,1.3315610063359147,0.32434973067992745
5484,0.5484,10,66,10,461926,143684,38958,68998,1.330949646152136,0.3244186155857101
5485,0.5485,18,75,18,462001,143609,38976,68980,1.3302549186705694,0.32447586657823313
5486,0.5486,16,64,16,462065,143545,38992,68964,1.329662084552966,0.3245227260963065
5487,0.5487,12,58,12,462123,143487,39004,68952,1.329124828633888,0.32457317159278665
5488,0.5488,8,61,8,462184,143426,39012,68944,1.3285597836155472,0.3246409568206432
5489,0.5489,16,61,16,462245,143365,39028,68928,1.3279947385972062,0.3246833385933592
5490,0.549,14,69,14,462314,143296,39042,68914,1.327355589314165,0.32474435700485366
5491,0.5491,13,56,13,462370,143240,39055,68901,1.326836859461262,0.32478870185395564
5492,0.5492,17,74,17,462444,143166,39072,68884,1.326151395012783,0.32484791322801226
5493,0.5493,16,74,16,462518,143092,39088,68868,1.325465930564304,0.32491036044536703
5494,0.5494,23,70,23,462588,143022,39111,68845,1.3248175182481752,0.3249444226802664
5495,0.5495,16,76,16,462664,142946,39127,68829,1.324113527733521,0.3250100342344469
5496,0.5496,12,54,12,462718,142892,39139,68817,1.323613323946793,0.3250546741045492
5497,0.5497,12,78,12,462796,142814,39151,68805,1.322890807365964,0.32513621177682533
5498,0.5498,12,61,12,462857,142753,39163,68793,1.322325762347623,0.3251916840781674
5499,0.5499,16,56,16,462913,142697,39179,68777,1.32180703249472,0.32522674182168965
5500,0.55,10,57,10,462970,142640,39189,68767,1.3212790396087295,0.3252825119319606
5501,0.5501,17,73,17,463043,142567,39206,68750,1.3206028381933381,0.32534060203391113
5502,0.5502,11,66,11,463109,142501,39217,68739,1.3199914780095594,0.32540711986366216
5503,0.5503,18,69,18,463178,142432,39235,68721,1.3193523287265183,0.3254559490038029
5504,0.5504,17,56,17,463234,142376,39252,68704,1.3188335988736153,0.3254879666477165
5505,0.5505,16,51,16,463285,142325,39268,68688,1.31836118418615,0.3255154895669935
5506,0.5506,5,56,5,463341,142269,39273,68683,1.317842454333247,0.32558591527930525
5507,0.5507,8,67,8,463408,142202,39281,68675,1.3172218311163808,0.3256637755658512
5508,0.5508,12,66,12,463474,142136,39293,68663,1.316610470932602,0.3257273516477782
5509,0.5509,16,65,16,463539,142071,39309,68647,1.316008373781911,0.3257766303780408
5510,0.551,16,60,16,463599,142011,39325,68631,1.315452591796658,0.32581821289201585
5511,0.5511,17,65,17,463664,141946,39342,68614,1.314850494645967,0.3258643617021277
5512,0.5512,16,78,16,463742,141868,39358,68598,1.3141279780651376,0.3259338800566362
5513,0.5513,19,61,19,463803,141807,39377,68579,1.3135629330467968,0.32596750734364455
5514,0.5514,15,63,15,463866,141744,39392,68564,1.312979361962281,0.326017079711661
5515,0.5515,16,69,16,463935,141675,39408,68548,1.3123402126792396,0.3260727893712867
5516,0.5516,15,80,15,464015,141595,39423,68533,1.3115991700322354,0.3261488235742024
5517,0.5517,11,66,11,464081,141529,39434,68522,1.3109878098484569,0.32621601420607377
5518,0.5518,16,48,16,464129,141481,39450,68506,1.3105431842602542,0.32623924338173316
5519,0.5519,13,54,13,464183,141427,39463,68493,1.3100429804735263,0.3262814405487805
5520,0.552,13,79,13,464262,141348,39476,68480,1.3093112008596095,0.32636254456030656
5521,0.5521,19,64,19,464326,141284,39495,68461,1.308718366742006,0.3264011061050323
5522,0.5522,18,59,18,464385,141225,39513,68443,1.3081718477898403,0.32643512600873764
5523,0.5523,12,74,12,464459,141151,39525,68431,1.3074863833413612,0.32651181876306173
5524,0.5524,16,69,16,464528,141082,39541,68415,1.3068472340583202,0.32656792221368325
5525,0.5525,9,68,9,464596,141014,39550,68406,1.3062173478083663,0.3266450195778818
5526,0.5526,18,73,18,464669,140941,39568,68388,1.305541146392975,0.32670103043534343
5527,0.5527,16,62,16,464731,140879,39584,68372,1.3049668383415465,0.3267463476877052
5528,0.5528,8,70,8,464801,140809,39592,68364,1.3043184260254177,0.32682994459131914
5529,0.5529,16,61,16,464862,140748,39608,68348,1.303753381007077,0.3268737804644756
5530,0.553,17,56,17,464918,140692,39625,68331,1.303234651154174,0.3269066083636729
5531,0.5531,12,71,12,464989,140621,39637,68319,1.3025769758049577,0.3269790370441275
5532,0.5532,12,69,12,465058,140552,39649,68307,1.3019378265219164,0.3270483914985708
5533,0.5533,14,62,14,465120,140490,39663,68293,1.301363518470488,0.3271003865257229
5534,0.5534,20,56,20,465176,140434,39683,68273,1.300844788617585,0.3271236709837236
5535,0.5535,13,65,13,465241,140369,39696,68260,1.3002426914668939,0.3271836609483821
5536,0.5536,23,75,23,465316,140294,39719,68237,1.2995479639853273,0.3272271269019954
5537,0.5537,10,59,10,465375,140235,39729,68227,1.2990014450331617,0.32728746726022007
5538,0.5538,16,67,16,465442,140168,39745,68211,1.2983808218162955,0.3273410468425321
5539,0.5539,15,58,15,465500,140110,39760,68196,1.2978435658972174,0.32738375274836057
5540,0.554,19,61,19,465561,140049,39779,68177,1.2972785208788766,0.32741828590089617
5541,0.5541,17,43,17,465604,140006,39796,68160,1.2968802104561117,0.3274309925732348
5542,0.5542,15,65,15,465669,139941,39811,68145,1.2962781133054206,0.32748478994261987
5543,0.5543,10,52,10,465721,139889,39821,68135,1.295796435584868,0.32753432296273505
5544,0.5544,15,67,15,465788,139822,39836,68120,1.2951758123680017,0.327591347587308
5545,0.5545,14,69,14,465857,139753,39850,68106,1.2945366630849606,0.3276548044587918
5546,0.5546,13,61,13,465918,139692,39863,68093,1.2939716180666196,0.32770892990350603
5547,0.5547,19,68,19,465986,139624,39882,68074,1.293341731816666,0.3277547207965411
5548,0.5548,15,69,15,466055,139555,39897,68059,1.292702582533625,0.32781507990790604
5549,0.5549,20,67,20,466122,139488,39917,68039,1.2920819593167587,0.3278561343825141
5550,0.555,14,65,14,466187,139423,39931,68025,1.2914798621660677,0.32791350121476226
5551,0.5551,16,58,16,466245,139365,39947,68009,1.2909426062469895,0.3279533596304262
5552,0.5552,10,69,10,466314,139296,39957,67999,1.2903034569639482,0.3280301020285101
5553,0.5553,20,61,20,466375,139235,39977,67979,1.2897384119456075,0.3280618104954299
5554,0.5554,12,73,12,466448,139162,39989,67967,1.289062210530216,0.32813850305848047
5555,0.5555,16,56,16,466504,139106,40005,67951,1.288543480677313,0.32817533336231086
5556,0.5556,13,60,13,466564,139046,40018,67938,1.2879876986920598,0.3282282688516987
5557,0.5557,18,76,18,466640,138970,40036,67920,1.2872837081774056,0.32829039586253567
5558,0.5558,17,71,17,466711,138899,40053,67903,1.2866260328281893,0.3283478883182948
5559,0.5559,12,65,12,466776,138834,40065,67891,1.2860239356774983,0.3284121417341879
5560,0.556,11,71,11,466847,138763,40076,67880,1.2853662603282818,0.3284892302182992
5561,0.5561,17,64,17,466911,138699,40093,67863,1.2847734262106785,0.3285357422952915
5562,0.5562,14,75,14,466986,138624,40107,67849,1.284078698729112,0.3286095518542376
5563,0.5563,17,65,17,467051,138559,40124,67832,1.283476601578421,0.3286577418588989
5564,0.5564,13,76,13,467127,138483,40137,67819,1.2827726110637667,0.3287365124913961
5565,0.5565,14,60,14,467187,138423,40151,67805,1.2822168290785134,0.32878658572065866
5566,0.5566,16,58,16,467245,138365,40167,67789,1.2816795731594353,0.3288269934126915
5567,0.5567,12,67,12,467312,138298,40179,67777,1.2810589499425693,0.328894819847143
5568,0.5568,15,65,15,467377,138233,40194,67762,1.2804568527918783,0.32894973178960657
5569,0.5569,18,65,18,467442,138168,40212,67744,1.2798547556411872,0.3289949104471813
5570,0.557,21,76,21,467518,138092,40233,67723,1.279150765126533,0.3290479313946991
5571,0.5571,15,63,15,467581,138029,40248,67708,1.2785671940420171,0.32909977301117443
5572,0.5572,16,69,16,467650,137960,40264,67692,1.2779280447589758,0.3291579950596153
5573,0.5573,14,70,14,467720,137890,40278,67678,1.277279632442847,0.3292243929016189
5574,0.5574,19,59,19,467779,137831,40297,67659,1.2767331134906814,0.3292568981458952
5575,0.5575,21,75,21,467854,137756,40318,67638,1.276038386009115,0.32930854844834806
5576,0.5576,15,73,15,467927,137683,40333,67623,1.2753621845937233,0.3293766377991876
5577,0.5577,12,56,12,467983,137627,40345,67611,1.2748434547408203,0.3294272990381898
5578,0.5578,21,80,21,468063,137547,40366,67590,1.274102412093816,0.3294871232395911
5579,0.5579,15,67,15,468130,137480,40381,67575,1.2734817888769498,0.3295457316329765
5580,0.558,12,73,12,468203,137407,40393,67563,1.2728055874615585,0.32962384739230133
5581,0.5581,16,64,16,468267,137343,40409,67547,1.272212753343955,0.32967445946605495
5582,0.5582,18,63,18,468330,137280,40427,67529,1.271629182259439,0.32971695579784094
5583,0.5583,21,67,21,468397,137213,40448,67508,1.2710085590425728,0.3297561070920912
5584,0.5584,20,73,20,468470,137140,40468,67488,1.2703323576271814,0.3298082373868679
5585,0.5585,18,68,18,468538,137072,40486,67470,1.2697024713772278,0.3298589042837168
5586,0.5586,20,76,20,468614,136996,40506,67450,1.2689984808625736,0.329915968030678
5587,0.5587,14,65,14,468679,136931,40520,67436,1.2683963837118826,0.3299749959631447
5588,0.5588,14,84,14,468763,136847,40534,67422,1.267618288932528,0.3300647675369244
5589,0.5589,17,66,17,468829,136781,40551,67405,1.2670069287487495,0.3301156788418403
5590,0.559,12,65,12,468894,136716,40563,67393,1.2664048315980585,0.3301814226712198
5591,0.5591,13,55,13,468949,136661,40576,67380,1.265895364778243,0.3302277483446954
5592,0.5592,19,56,19,469005,136605,40595,67361,1.26537663492534,0.3302560230626673
5593,0.5593,12,71,12,469076,136534,40607,67349,1.2647189595761237,0.3303316117577238
5594,0.5594,23,69,23,469145,136465,40630,67326,1.2640798102930824,0.330367876893484
5595,0.5595,14,64,14,469209,136401,40644,67312,1.263486976175479,0.33042564784770734
5596,0.5596,12,62,12,469271,136339,40656,67300,1.2629126681240506,0.33048679280491455
5597,0.5597,7,68,7,469339,136271,40663,67293,1.262282781874097,0.33057416832052816
5598,0.5598,20,64,20,469403,136207,40683,67273,1.2616899477564933,0.3306123451936308
5599,0.5599,15,63,15,469466,136144,40698,67258,1.2611063766719774,0.3306653818546524
5600,0.56,14,77,14,469543,136067,40712,67244,1.2603931231242358,0.3307445243985815
5601,0.5601,9,60,9,469603,136007,40721,67235,1.2598373411389825,0.3308125289064268
5602,0.5602,14,67,14,469670,135940,40735,67221,1.2592167179221163,0.3308755125245495
5603,0.5603,15,68,15,469738,135872,40750,67206,1.2585868316721627,0.33093688139532595
5604,0.5604,15,66,15,469804,135806,40765,67191,1.2579754714883842,0.3309950393355567
5605,0.5605,7,73,7,469877,135733,40772,67184,1.2572992700729928,0.33109103722211547
5606,0.5606,15,63,15,469940,135670,40787,67169,1.2567156989884767,0.3311444051686313
5607,0.5607,15,70,15,470010,135600,40802,67154,1.256067286672348,0.3312092486461426
5608,0.5608,17,66,17,470076,135534,40819,67137,1.2554559264885694,0.3312610092218423
5609,0.5609,12,60,12,470136,135474,40831,67125,1.254900144503316,0.33131950305776436
5610,0.561,12,75,12,470211,135399,40843,67113,1.2542054170217496,0.3314025835506044
5611,0.5611,9,66,9,470277,135333,40852,67104,1.253594056837971,0.3314809051704975
5612,0.5612,14,67,14,470344,135266,40866,67090,1.252973433621105,0.33154440688687264
5613,0.5613,11,59,11,470403,135207,40877,67079,1.2524269146689393,0.3316047576203988
5614,0.5614,14,69,14,470472,135138,40891,67065,1.251787765385898,0.33167163691933355
5615,0.5615,21,70,21,470542,135068,40912,67044,1.2511393530697692,0.33171706776440785
5616,0.5616,13,69,13,470611,134999,40925,67031,1.2505002037867279,0.33178735831312184
5617,0.5617,18,49,18,470660,134950,40943,67013,1.2500463151654377,0.33180830152057555
5618,0.5618,13,56,13,470716,134894,40956,67000,1.2495275853125347,0.3318573112623456
5619,0.5619,9,65,9,470781,134829,40965,66991,1.2489254881618437,0.3319343969874145
5620,0.562,17,63,17,470844,134766,40982,66974,1.2483419170773278,0.33198175869931595
5621,0.5621,8,75,8,470919,134691,40990,66966,1.2476471895957613,0.33207872774066854
5622,0.5622,19,85,19,471004,134606,41009,66947,1.246859831783319,0.3321558101343071
5623,0.5623,11,54,11,471058,134552,41020,66936,1.2463596279965912,0.33220836972921464
5624,0.5624,18,75,18,471133,134477,41038,66918,1.2456649005150247,0.33227240000993075
5625,0.5625,21,57,21,471190,134420,41059,66897,1.245136907629034,0.33229682540471
5626,0.5626,21,75,21,471265,134345,41080,66876,1.2444421801474674,0.332350997162324
5627,0.5627,8,69,8,471334,134276,41088,66868,1.2438030308644263,0.3324384520542497
5628,0.5628,15,60,15,471394,134216,41103,66853,1.243247248879173,0.3324878524287682
5629,0.5629,16,66,16,471460,134150,41119,66837,1.2426358886953943,0.3325438958738625
5630,0.563,17,66,17,471526,134084,41136,66820,1.2420245285116158,0.33259666308286545
5631,0.5631,15,82,15,471608,134002,41151,66805,1.2412649597984364,0.33268262560568107
5632,0.5632,18,58,18,471666,133944,41169,66787,1.2407277038793583,0.3327189123752684
5633,0.5633,14,87,14,471753,133857,41183,66773,1.2399218200007411,0.3328166276229876
5634,0.5634,12,65,12,471818,133792,41195,66761,1.23931972285005,0.3328845741524684
5635,0.5635,18,61,18,471879,133731,41213,66743,1.2387546778317091,0.3329259654618554
5636,0.5636,11,60,11,471939,133671,41224,66732,1.238198895846456,0.3329890271103726
5637,0.5637,13,58,13,471997,133613,41237,66719,1.2376616399273779,0.3330421500309486
5638,0.5638,21,59,21,472056,133554,41258,66698,1.237115120975212,0.3330703313824581
5639,0.5639,12,64,12,472120,133490,41270,66686,1.2365222868576087,0.3331368395811686
5640,0.564,13,58,13,472178,133432,41283,66673,1.2359850309385305,0.33319007521051447
5641,0.5641,19,63,19,472241,133369,41302,66654,1.2354014598540146,0.33323167835698897
5642,0.5642,15,55,15,472296,133314,41317,66639,1.234891993034199,0.33327331923001907
5643,0.5643,14,80,14,472376,133234,41331,66625,1.2341509503871948,0.3333600188132633
5644,0.5644,18,49,18,472425,133185,41349,66607,1.2336970617659047,0.3333817169856651
5645,0.5645,15,68,15,472493,133117,41364,66592,1.233067175515951,0.33344516271174557
5646,0.5646,19,70,19,472563,133047,41383,66573,1.2324187631998222,0.3334986474301172
5647,0.5647,18,79,18,472642,132968,41401,66555,1.2316869835859054,0.3335705657994316
5648,0.5648,15,72,15,472714,132896,41416,66540,1.2310200452036015,0.3336408672456327
5649,0.5649,17,53,17,472767,132843,41433,66523,1.230529104449961,0.3336727425940231
5650,0.565,19,75,19,472842,132768,41452,66504,1.2298343769683946,0.33373479465253525
5651,0.5651,14,59,14,472901,132709,41466,66490,1.2292878580162288,0.3337868161988765
5652,0.5652,16,59,16,472960,132650,41482,66474,1.2287413390640631,0.33383218497016937
5653,0.5653,25,70,25,473030,132580,41507,66449,1.2280929267479344,0.33386591903692425
5654,0.5654,8,60,8,473090,132520,41515,66441,1.227537144762681,0.33393981735113915
5655,0.5655,12,61,12,473151,132459,41527,66429,1.2269720997443403,0.33400205140581635
5656,0.5656,9,64,9,473215,132395,41536,66420,1.2263792656267367,0.33407942056685863
5657,0.5657,19,74,19,473289,132321,41555,66401,1.2256938011782579,0.33414015559424726
5658,0.5658,17,48,17,473337,132273,41572,66384,1.2252491755900552,0.33416391066008244
5659,0.5659,17,55,17,473392,132218,41589,66367,1.2247397087702396,0.33419946118790445
5660,0.566,12,66,12,473458,132152,41601,66355,1.2241283485864611,0.33427032799850886
5661,0.5661,12,71,12,473529,132081,41613,66343,1.223470673237245,0.3343496754424868
5662,0.5662,14,78,14,473607,132003,41627,66329,1.2227481566564156,0.33443418107012485
5663,0.5663,13,72,13,473679,131931,41640,66316,1.2220812182741116,0.3345119976594854
5664,0.5664,18,60,18,473739,131871,41658,66298,1.2215254362888583,0.33455283116935547
5665,0.5665,22,77,22,473816,131794,41680,66276,1.2208121827411167,0.33460897662442574
5666,0.5666,17,70,17,473886,131724,41697,66259,1.220163770424988,0.33467014844708887
5667,0.5667,20,61,20,473947,131663,41717,66239,1.2195987254066472,0.33470606663904356
5668,0.5668,21,66,21,474013,131597,41738,66218,1.2189873652228687,0.3347471122007937
5669,0.5669,18,66,18,474079,131531,41756,66200,1.21837600503909,0.33479828656103494
5670,0.567,20,60,20,474139,131471,41776,66180,1.2178202230538369,0.3348326089926183
5671,0.5671,14,45,14,474184,131426,41790,66166,1.2174033865648968,0.33486173529292684
5672,0.5672,12,61,12,474245,131365,41802,66154,1.216838341546556,0.3349247414172814
5673,0.5673,14,54,14,474299,131311,41816,66140,1.2163381377598281,0.33496918222748934
5674,0.5674,20,70,20,474369,131241,41836,66120,1.2156897254436994,0.33502059677443874
5675,0.5675,11,64,11,474433,131177,41847,66109,1.2150968913260958,0.3350922011698752
5676,0.5676,10,52,10,474485,131125,41857,66099,1.214615213605543,0.33514683811300855
5677,0.5677,17,56,17,474541,131069,41874,66082,1.21409648375264,0.33518470613894935
5678,0.5678,12,72,12,474613,130997,41886,66070,1.213429545370336,0.33526668594944864
5679,0.5679,17,75,17,474688,130922,41903,66053,1.2127348178887696,0.33533697169691584
5680,0.568,16,64,16,474752,130858,41919,66037,1.212141983771166,0.3353919601818228
5681,0.5681,16,61,16,474813,130797,41935,66021,1.2115769387528252,0.3354418803158248
5682,0.5682,15,54,15,474867,130743,41950,66006,1.2110767349660974,0.3354832807282375
5683,0.5683,14,72,14,474939,130671,41964,65992,1.2104097965837934,0.33555879855387133
5684,0.5684,17,69,17,475008,130602,41981,65975,1.2097706473007521,0.33561912126037124
5685,0.5685,15,70,15,475078,130532,41996,65960,1.2091222349846233,0.33568796694012987
5686,0.5686,19,68,19,475146,130464,42015,65941,1.2084923487346697,0.3357399251546549
5687,0.5687,9,63,9,475209,130401,42024,65932,1.2079087776501538,0.33581720851818087
5688,0.5688,10,67,10,475276,130334,42034,65922,1.2072881544332876,0.3358980107614544
5689,0.5689,19,58,19,475334,130276,42053,65903,1.2067508985142095,0.3359329999643183
5690,0.569,18,44,18,475378,130232,42071,65885,1.206343325058357,0.33594741914265464
5691,0.5691,16,53,16,475431,130179,42087,65869,1.2058523843047166,0.3359840447237411
5692,0.5692,14,64,14,475495,130115,42101,65855,1.2052595501871133,0.33604633362249325
5693,0.5693,14,44,14,475539,130071,42115,65841,1.2048519767312609,0.3360743599166973
5694,0.5694,14,74,14,475613,129997,42129,65827,1.2041665122827818,0.3361538932919356
5695,0.5695,12,69,12,475682,129928,42141,65815,1.2035273629997407,0.3362316915547427
5696,0.5696,19,73,19,475755,129855,42160,65796,1.2028511615843491,0.3362926844227732
5697,0.5697,21,64,21,475819,129791,42181,65775,1.2022583274667458,0.33633146866019653
5698,0.5698,15,68,15,475887,129723,42196,65760,1.2016284412167921,0.3363975384048741
5699,0.5699,20,76,20,475963,129647,42216,65740,1.200924450702138,0.3364604605219385
5700,0.57,26,80,26,476043,129567,42242,65714,1.2001834080551337,0.336509952325111
5701,0.5701,18,67,18,476110,129500,42260,65696,1.1995627848382675,0.33656427385807086
5702,0.5702,16,72,16,476182,129428,42276,65680,1.1988958464559636,0.3366340693359575
5703,0.5703,14,79,14,476261,129349,42290,65666,1.1981640668420468,0.33672281619362615
5704,0.5704,22,76,22,476337,129273,42312,65644,1.1974600763273926,0.3367792444989406
5705,0.5705,16,54,16,476391,129219,42328,65628,1.1969598725406647,0.3368181188316987
5706,0.5706,15,69,15,476460,129150,42343,65613,1.1963207232576234,0.33688636958765267
5707,0.5707,15,63,15,476523,129087,42358,65598,1.1957371521731075,0.3369442946297866
5708,0.5708,13,59,13,476582,129028,42371,65585,1.1951906332209419,0.3370021529908074
5709,0.5709,13,68,13,476650,128960,42384,65572,1.1945607469709882,0.33707564822240044
5710,0.571,14,66,14,476716,128894,42398,65558,1.1939493867872095,0.3371423281838191
5711,0.5711,14,58,14,476774,128836,42412,65544,1.1934121308681314,0.3371951846897829
5712,0.5712,18,68,18,476842,128768,42430,65526,1.1927822446181777,0.3372517936735051
5713,0.5713,14,62,14,476904,128706,42444,65512,1.1922079365667495,0.33731168068871065
5714,0.5714,16,70,16,476974,128636,42460,65496,1.1915595242506207,0.33737869078771143
5715,0.5715,16,61,16,477035,128575,42476,65480,1.1909944792322797,0.33743011002035506
5716,0.5716,12,59,12,477094,128516,42488,65468,1.1904479602801141,0.33749175189706365
5717,0.5717,5,56,5,477150,128460,42493,65463,1.189929230427211,0.3375721291440417
5718,0.5718,18,61,18,477211,128399,42511,65445,1.1893641854088703,0.33761684653639007
5719,0.5719,9,63,9,477274,128336,42520,65436,1.1887806143243544,0.3376958487294346
5720,0.572,13,59,13,477333,128277,42533,65423,1.1882340953721886,0.33775425916365515
5721,0.5721,14,70,14,477403,128207,42547,65409,1.1875856830560598,0.337828485249153
5722,0.5722,15,70,15,477473,128137,42562,65394,1.186937270739931,0.3378993546253572
5723,0.5723,16,65,16,477538,128072,42578,65378,1.18633517358924,0.33795812871543035
5724,0.5724,7,53,7,477591,128019,42585,65371,1.1858442328355996,0.3380267852525984
5725,0.5725,16,75,16,477666,127944,42601,65355,1.185149505354033,0.33810314590349666
5726,0.5726,20,62,20,477728,127882,42621,65335,1.1845751973026049,0.3381431240522314
5727,0.5727,13,64,13,477792,127818,42634,65322,1.1839823631850013,0.338210624417521
5728,0.5728,16,68,16,477860,127750,42650,65306,1.1833524769350476,0.3382749046908669
5729,0.5729,17,61,17,477921,127689,42667,65289,1.1827874319167069,0.3383235394708205
5730,0.573,14,76,14,477997,127613,42681,65275,1.1820834414020527,0.33840881755215463
5731,0.5731,24,61,24,478058,127552,42705,65251,1.181518396383712,0.33843353059859027
5732,0.5732,13,65,13,478123,127487,42718,65238,1.1809162992330209,0.33850304838500456
5733,0.5733,13,66,13,478189,127421,42731,65225,1.1803049390492424,0.3385743799507906
5734,0.5734,18,55,18,478244,127366,42749,65207,1.1797954722294268,0.33860925467225417
5735,0.5735,23,58,23,478302,127308,42772,65184,1.1792582163103487,0.3386322548469547
5736,0.5736,15,64,15,478366,127244,42787,65169,1.1786653821927453,0.33869333153165326
5737,0.5737,8,62,8,478428,127182,42795,65161,1.1780910741413169,0.338775000909833
5738,0.5738,24,61,24,478489,127121,42819,65137,1.177526029122976,0.33879994590602214
5739,0.5739,8,62,8,478551,127059,42827,65129,1.1769517210715477,0.3388817199825171
5740,0.574,12,59,12,478610,127000,42839,65117,1.176405202119382,0.33894449736358573
5741,0.5741,18,60,18,478670,126940,42857,65099,1.1758494201341287,0.33898843464088024
5742,0.5742,14,53,14,478723,126887,42871,65085,1.1753584793804883,0.3390338174317088
5743,0.5743,22,56,22,478779,126831,42893,65063,1.1748397495275853,0.3390569793740294
5744,0.5744,7,66,7,478845,126765,42900,65056,1.1742283893438068,0.33914951960421436
5745,0.5745,10,71,10,478916,126694,42910,65046,1.1735707139945903,0.33924063836445184
5746,0.5746,17,53,17,478969,126641,42927,65029,1.17307977324095,0.3392758386810664
5747,0.5747,12,60,12,479029,126581,42939,65017,1.1725239912556968,0.3393407029300932
5748,0.5748,20,62,20,479091,126519,42959,64997,1.1719496832042684,0.3393815660310366
5749,0.5749,19,60,19,479151,126459,42978,64978,1.171393901219015,0.3394223687166013
5750,0.575,17,66,17,479217,126393,42995,64961,1.1707825410352366,0.3394807529500298
5751,0.5751,22,68,22,479285,126325,43017,64939,1.170152654785283,0.3395254726451397
5752,0.5752,12,49,12,479334,126276,43029,64927,1.1696987661639928,0.33957103183527454
5753,0.5753,14,68,14,479402,126208,43043,64913,1.169068879914039,0.33964347193662653
5754,0.5754,20,68,20,479470,126140,43063,64893,1.1684389936640853,0.3396952359016505
5755,0.5755,14,66,14,479536,126074,43077,64879,1.1678276334803068,0.33976423517828996
5756,0.5756,13,69,13,479605,126005,43090,64866,1.1671884841972655,0.3398420923031786
5757,0.5757,13,65,13,479670,125940,43103,64853,1.1665863870465745,0.3399128898858973
5758,0.5758,19,56,19,479726,125884,43122,64834,1.1660676571936714,0.3399469373630177
5759,0.5759,16,65,16,479791,125819,43138,64818,1.1654655600429804,0.34000744871142535
5760,0.576,16,55,16,479846,125764,43154,64802,1.164956093223165,0.3400501663465676
5761,0.5761,19,61,19,479907,125703,43173,64783,1.164391048204824,0.3400932351983873
5762,0.5762,16,49,16,479956,125654,43189,64767,1.163937159583534,0.34012530130605345
5763,0.5763,12,59,12,480015,125595,43201,64755,1.1633906406313683,0.34018912529550827
5764,0.5764,11,59,11,480074,125536,43212,64744,1.1628441216792027,0.3402564641580828
5765,0.5765,9,56,9,480130,125480,43221,64735,1.1623253918262997,0.34032542123386694
5766,0.5766,13,59,13,480189,125421,43234,64722,1.1617788728741338,0.34038592007068363
5767,0.5767,10,56,10,480245,125365,43244,64712,1.1612601430212308,0.34045150123371054
5768,0.5768,19,61,19,480306,125304,43263,64693,1.16069509800289,0.34049484991868295
5769,0.5769,23,44,23,480350,125260,43286,64670,1.1602875245470377,0.3404938661612173
5770,0.577,14,72,14,480422,125188,43300,64656,1.1596205861647337,0.34057436632182214
5771,0.5771,11,70,11,480492,125118,43311,64645,1.158972173848605,0.3406617728429673
5772,0.5772,14,54,14,480546,125064,43325,64631,1.158471970061877,0.3407100872453149
5773,0.5773,15,69,15,480615,124995,43340,64616,1.1578328207788358,0.3407819166609532
5774,0.5774,20,52,20,480667,124943,43360,64596,1.157351143058283,0.3408058499833807
5775,0.5775,16,64,16,480731,124879,43376,64580,1.1567583089406794,0.3408653059501
5776,0.5776,19,59,19,480790,124820,43395,64561,1.1562117899885138,0.34090537065492316
5777,0.5777,10,55,10,480845,124765,43405,64551,1.1557023231686983,0.34096959580806696
5778,0.5778,17,67,17,480912,124698,43422,64534,1.1550816999518323,0.3410311152447789
5779,0.5779,21,59,21,480971,124639,43443,64513,1.1545351809996665,0.3410643292167146
5780,0.578,16,64,16,481035,124575,43459,64497,1.153942346882063,0.3411240162477786
5781,0.5781,18,69,18,481104,124506,43477,64479,1.1533031975990218,0.34118580839749185
5782,0.5782,15,60,15,481164,124446,43492,64464,1.1527474156137685,0.34124186120374783
5783,0.5783,17,61,17,481225,124385,43509,64447,1.1521823705954277,0.341292789357736
5784,0.5784,23,48,23,481273,124337,43532,64424,1.1517377450072253,0.34129931500680755
5785,0.5785,9,49,9,481322,124288,43541,64415,1.1512838563859351,0.3413565232137274
5786,0.5786,18,73,18,481395,124215,43559,64397,1.1506076549705435,0.3414257841494709
5787,0.5787,19,82,19,481477,124133,43578,64378,1.1498480862573641,0.34150792261459545
5788,0.5788,13,51,13,481528,124082,43591,64365,1.1493756715698988,0.34155491995096765
5789,0.5789,13,63,13,481591,124019,43604,64352,1.148792100485383,0.34162371065609887
5790,0.579,14,74,14,481665,123945,43618,64338,1.1481066360369039,0.34170902311945317
5791,0.5791,12,66,12,481731,123879,43630,64326,1.1474952758531254,0.34178688132621343
5792,0.5792,20,49,20,481780,123830,43650,64306,1.1470413872318352,0.34180592762682316
5793,0.5793,12,64,12,481844,123766,43662,64294,1.1464485531142317,0.3418802509837286
5794,0.5794,16,59,16,481903,123707,43678,64278,1.145902034162066,0.3419315370907253
5795,0.5795,20,59,20,481962,123648,43698,64258,1.1453555152099004,0.34196885676880995
5796,0.5796,17,62,17,482024,123586,43715,64241,1.144781207158472,0.34202217998477324
5797,0.5797,14,67,14,482091,123519,43729,64227,1.1441605839416058,0.3420951711354703
5798,0.5798,15,54,15,482145,123465,43744,64212,1.143660380154878,0.342141018878179
5799,0.5799,16,61,16,482206,123404,43760,64196,1.1430953351365372,0.34219616204690834
5800,0.58,20,73,20,482279,123331,43780,64176,1.1424191337211456,0.3422592223223666
5801,0.5801,20,60,20,482339,123271,43800,64156,1.1418633517358925,0.34229860158888525
5802,0.5802,14,62,14,482401,123209,43814,64142,1.141289043684464,0.3423627309168352
5803,0.5803,13,54,13,482455,123155,43827,64129,1.1407888398977362,0.3424157963307063
5804,0.5804,13,62,13,482517,123093,43840,64116,1.1402145318463077,0.34248353444545937
5805,0.5805,14,71,14,482588,123022,43854,64102,1.1395568564970915,0.34256428892071566
5806,0.5806,19,75,19,482663,122947,43873,64083,1.1388621290155247,0.34263487141100357
5807,0.5807,15,65,15,482728,122882,43888,64068,1.138260031864834,0.34270125702059373
5808,0.5808,11,74,11,482802,122808,43899,64057,1.1375745674163549,0.3427982768308672
5809,0.5809,12,77,12,482879,122731,43911,64045,1.1368613138686132,0.34289737439499723
5810,0.581,13,52,13,482931,122679,43924,64032,1.1363796361480603,0.34294712148721823
5811,0.5811,20,67,20,482998,122612,43944,64012,1.1357590129311943,0.34299982853223593
5812,0.5812,8,59,8,483057,122553,43952,64004,1.1352124939790285,0.3430801310055372
5813,0.5813,17,69,17,483126,122484,43969,63987,1.1345733446959874,0.3431471917885355
5814,0.5814,19,52,19,483178,122432,43988,63968,1.1340916669754344,0.34317596566523606
5815,0.5815,19,68,19,483246,122364,44007,63949,1.1334617807254808,0.3432342348628383
5816,0.5816,13,73,13,483319,122291,44020,63936,1.1327855793100894,0.34332293383880963
5817,0.5817,13,72,13,483391,122219,44033,63923,1.1321186409277855,0.3434098698842819
5818,0.5818,12,65,12,483456,122154,44045,63911,1.1315165437770944,0.3434874909305888
5819,0.5819,14,49,14,483505,122105,44059,63897,1.1310626551558043,0.343528564208987
5820,0.582,14,72,14,483577,122033,44073,63883,1.1303957167735004,0.343612168936509
5821,0.5821,20,60,20,483637,121973,44093,63863,1.129839934788247,0.3436524677672787
5822,0.5822,15,59,15,483696,121914,44108,63848,1.1292934158360814,0.3437086164016322
5823,0.5823,14,70,14,483766,121844,44122,63834,1.1286450035199527,0.343788709486315
5824,0.5824,15,54,15,483820,121790,44137,63819,1.1281447997332246,0.34383569762242133
5825,0.5825,17,65,17,483885,121725,44154,63802,1.1275427025825335,0.34389603669546753
5826,0.5826,13,65,13,483950,121660,44167,63789,1.1269406054318427,0.3439705795124266
5827,0.5827,19,56,19,484006,121604,44186,63770,1.1264218755789395,0.34400725020768824
5828,0.5828,28,61,28,484067,121543,44214,63742,1.1258568305605987,0.3440213724802332
5829,0.5829,14,53,14,484120,121490,44228,63728,1.1253658898069583,0.3440702307551102
5830,0.583,13,70,13,484190,121420,44241,63715,1.1247174774908295,0.3441542658060334
5831,0.5831,21,63,21,484253,121357,44262,63694,1.1241339064063136,0.3441970051499316
5832,0.5832,17,66,17,484319,121291,44279,63677,1.1235225462225351,0.3442595475974223
5833,0.5833,15,57,15,484376,121234,44294,63662,1.1229945533365444,0.3443124783662167
5834,0.5834,13,67,13,484443,121167,44307,63649,1.1223739301196785,0.3443911782529651
5835,0.5835,14,62,14,484505,121105,44321,63635,1.12179962206825,0.34445707480783805
5836,0.5836,18,51,18,484556,121054,44339,63617,1.1213272073807847,0.34448830623108123
5837,0.5837,14,62,14,484618,120992,44353,63603,1.1207528993293565,0.3445542945366884
5838,0.5838,15,67,15,484685,120925,44368,63588,1.1201322761124903,0.3446261239045487
5839,0.5839,15,71,15,484756,120854,44383,63573,1.1194746007632739,0.34470549323038385
5840,0.584,21,49,21,484805,120805,44404,63552,1.1190207121419837,0.34472246782058724
5841,0.5841,12,63,12,484868,120742,44416,63540,1.1184371410574678,0.34479764708435984
5842,0.5842,14,72,14,484940,120670,44430,63526,1.117770202675164,0.3448826250298595
5843,0.5843,20,54,20,484994,120616,44450,63506,1.117269998888436,0.3449126122896775
5844,0.5844,12,62,12,485056,120554,44462,63494,1.1166956908370076,0.34498609058506474
5845,0.5845,14,62,14,485118,120492,44476,63480,1.1161213827855794,0.34505250799034637
5846,0.5846,18,54,18,485172,120438,44494,63462,1.1156211789988515,0.345089722675367
5847,0.5847,18,52,18,485224,120386,44512,63444,1.1151395012782985,0.34512321166294946
5848,0.5848,11,68,11,485292,120318,44523,63433,1.114509615028345,0.3452117267389021
5849,0.5849,14,66,14,485358,120252,44537,63419,1.1138982548445664,0.34528586439884357
5850,0.585,21,67,21,485425,120185,44558,63398,1.1132776316277002,0.34533698654014805
5851,0.5851,8,52,8,485477,120133,44566,63390,1.1127959539071473,0.34540629784822613
5852,0.5852,11,59,11,485536,120074,44577,63379,1.1122494349549816,0.34547813336385885
5853,0.5853,17,58,17,485594,120016,44594,63362,1.1117121790359035,0.3455267262157947
5854,0.5854,15,71,15,485665,119945,44609,63347,1.1110545036866872,0.34560700958034174
5855,0.5855,12,59,12,485724,119886,44621,63335,1.1105079847345214,0.34567544113393117
5856,0.5856,16,49,16,485773,119837,44637,63319,1.1100540961132312,0.3457107602262552
5857,0.5857,20,58,20,485831,119779,44657,63299,1.109516840194153,0.34574880651962553
5858,0.5858,18,64,18,485895,119715,44675,63281,1.1089240060765497,0.34580537279503376
5859,0.5859,16,59,16,485954,119656,44691,63265,1.108377487124384,0.3458596880620596
5860,0.586,14,61,14,486015,119595,44705,63251,1.1078124421060431,0.34592498605383765
5861,0.5861,14,58,14,486073,119537,44719,63237,1.107275186186965,0.3459846586494797
5862,0.5862,16,66,16,486139,119471,44735,63221,1.1066638260031865,0.3460523722987323
5863,0.5863,16,57,16,486196,119414,44751,63205,1.106135833117196,0.3461030889447429
5864,0.5864,21,64,21,486260,119350,44772,63184,1.1055429989995924,0.34614921055803305
5865,0.5865,15,64,15,486324,119286,44787,63169,1.104950164881989,0.34621687539393275
5866,0.5866,6,64,6,486388,119222,44793,63163,1.1043573307643855,0.34631685719768623
5867,0.5867,25,59,25,486447,119163,44818,63138,1.1038108118122198,0.3463392959994734
5868,0.5868,16,62,16,486509,119101,44834,63122,1.1032365037607914,0.34639974097671533
5869,0.5869,15,80,15,486589,119021,44849,63107,1.1024954611137872,0.34649806729333216
5870,0.587,15,72,15,486661,118949,44864,63092,1.1018285227314832,0.346581264660159
5871,0.5871,18,55,18,486716,118894,44882,63074,1.1013190559116677,0.3466213839796008
5872,0.5872,11,55,11,486771,118839,44893,63063,1.1008095890918523,0.3466866774416994
5873,0.5873,17,45,17,486816,118794,44910,63046,1.1003927526029122,0.3467113946326441
5874,0.5874,18,66,18,486882,118728,44928,63028,1.0997813924191338,0.34677259622790996
5875,0.5875,12,78,12,486960,118650,44940,63016,1.0990588758383044,0.3468783371682098
5876,0.5876,18,69,18,487029,118581,44958,62998,1.0984197265552633,0.3469454066824908
5877,0.5877,12,64,12,487093,118517,44970,62986,1.0978268924376597,0.3470245670870454
5878,0.5878,16,64,16,487157,118453,44986,62970,1.0972340583200564,0.34708939880830986
5879,0.5879,13,67,13,487224,118386,44999,62957,1.0966134351031902,0.34717083096673157
5880,0.588,21,60,21,487284,118326,45020,62936,1.096057653117937,0.3472101157440611
5881,0.5881,17,74,17,487358,118252,45037,62919,1.0953721886694578,0.347290681179659
5882,0.5882,13,62,13,487420,118190,45050,62906,1.0947978806180296,0.34736272474267793
5883,0.5883,21,58,21,487478,118132,45071,62885,1.0942606246989515,0.34739831065590526
5884,0.5884,18,56,18,487534,118076,45089,62867,1.0937418948460484,0.3474409068049054
5885,0.5885,16,62,16,487596,118014,45105,62851,1.09316758679462,0.3475022807066044
5886,0.5886,15,62,15,487658,117952,45120,62836,1.0925932787431916,0.3475673164148063
5887,0.5887,12,52,12,487710,117900,45132,62824,1.0921116010226388,0.3476240012394591
5888,0.5888,19,69,19,487779,117831,45151,62805,1.0914724517395975,0.34768816847140105
5889,0.5889,11,54,11,487833,117777,45162,62794,1.0909722479528696,0.347752407640208
5890,0.589,13,56,13,487889,117721,45175,62781,1.0904535180999666,0.3478133206280263
5891,0.5891,13,72,13,487961,117649,45188,62768,1.0897865797176627,0.3479051308912131
5892,0.5892,14,64,14,488025,117585,45202,62754,1.0891937456000593,0.3479779748141001
5893,0.5893,22,42,22,488067,117543,45224,62732,1.088804698210382,0.3479794758008598
5894,0.5894,7,70,7,488137,117473,45231,62725,1.0881562858942533,0.3480893239658598
5895,0.5895,17,57,17,488194,117416,45248,62708,1.0876282930082626,0.3481379494126269
5896,0.5896,20,61,20,488255,117355,45268,62688,1.0870632479899218,0.3481834894997306
5897,0.5897,11,49,11,488304,117306,45279,62677,1.0866093593686317,0.34823844474200344
5898,0.5898,12,65,12,488369,117241,45291,62665,1.0860072622179406,0.34832078974575614
5899,0.5899,19,69,19,488438,117172,45310,62646,1.0853681129348993,0.34838558987420615
5900,0.59,15,55,15,488493,117117,45325,62631,1.084858646115084,0.3484378129381134
5901,0.5901,16,64,16,488557,117053,45341,62615,1.0842658119974804,0.34850390720662555
5902,0.5902,24,48,24,488605,117005,45365,62591,1.083821186409278,0.3485099890866166
5903,0.5903,16,55,16,488660,116950,45381,62575,1.0833117195894624,0.34855869656036764
5904,0.5904,7,59,7,488719,116891,45388,62568,1.0827652006372968,0.34864788057439305
5905,0.5905,11,53,11,488772,116838,45399,62557,1.0822742598836563,0.34871094512110146
5906,0.5906,11,74,11,488846,116764,45410,62546,1.0815887954351773,0.3488149015671184
5907,0.5907,10,66,10,488912,116698,45420,62536,1.0809774352513988,0.34890701541002267
5908,0.5908,15,57,15,488969,116641,45435,62521,1.080449442365408,0.34896350788671704
5909,0.5909,19,61,19,489030,116580,45454,62502,1.0798843973470673,0.34901330116929674
5910,0.591,14,70,14,489100,116510,45468,62488,1.0792359850309385,0.3490988726131018
5911,0.5911,11,63,11,489163,116447,45479,62477,1.0786524139464226,0.34918177550244794
5912,0.5912,25,65,25,489228,116382,45504,62452,1.0780503167957316,0.34921771027880605
5913,0.5913,17,60,17,489288,116322,45521,62435,1.0774945348104783,0.34927303546154836
5914,0.5914,14,61,14,489349,116261,45535,62421,1.0769294897921375,0.3493412878745481
5915,0.5915,16,71,16,489420,116190,45551,62405,1.076271814442921,0.3494218763123268
5916,0.5916,14,57,14,489477,116133,45565,62391,1.0757438215569306,0.34948242253142436
5917,0.5917,20,73,20,489550,116060,45585,62371,1.0750676201415392,0.3495524880766235
5918,0.5918,14,63,14,489613,115997,45599,62357,1.0744840490570233,0.34962490328223644
5919,0.5919,23,75,23,489688,115922,45622,62334,1.0737893215754566,0.3496880890404811
5920,0.592,18,60,18,489748,115862,45640,62316,1.0732335395902035,0.34974014749295645
5921,0.5921,17,59,17,489807,115803,45657,62299,1.0726870206380377,0.3497939383050162
5922,0.5922,14,62,14,489869,115741,45671,62285,1.0721127125866095,0.3498646265152281
5923,0.5923,19,58,19,489927,115683,45690,62266,1.0715754566675313,0.3499092436597003
5924,0.5924,12,71,12,489998,115612,45702,62254,1.0709177813183148,0.35000505998898046
5925,0.5925,14,64,14,490062,115548,45716,62240,1.0703249472007115,0.3500798704074516
5926,0.5926,20,50,20,490112,115498,45736,62220,1.0698617955463336,0.3501052228811938
5927,0.5927,11,67,11,490179,115431,45747,62209,1.0692411723294675,0.35019702769646477
5928,0.5928,12,61,12,490240,115370,45759,62197,1.0686761273111267,0.3502734179211227
5929,0.5929,14,65,14,490305,115305,45773,62183,1.0680740301604357,0.35035044622735056
5930,0.593,14,54,14,490359,115251,45787,62169,1.0675738263737078,0.3504058167061211
5931,0.5931,18,57,18,490416,115194,45805,62151,1.0670458334877173,0.3504525078237334
5932,0.5932,14,59,14,490475,115135,45819,62137,1.0664993145355515,0.3505178482783519
5933,0.5933,12,63,12,490538,115072,45831,62125,1.0659157434510356,0.3505984864303572
5934,0.5934,26,55,26,490593,115017,45857,62099,1.0654062766312202,0.3506120282752546
5935,0.5935,22,64,22,490657,114953,45879,62077,1.0648134425136166,0.350658080551319
5936,0.5936,17,66,17,490723,114887,45896,62060,1.0642020823298382,0.35072648872261186
5937,0.5937,10,78,10,490801,114809,45906,62050,1.0634795657490088,0.3508444580145766
5938,0.5938,12,66,12,490867,114743,45918,62038,1.0628682055652303,0.35093137837211014
5939,0.5939,18,51,18,490918,114692,45936,62020,1.062395790877765,0.35096654443388114
5940,0.594,14,55,14,490973,114637,45950,62006,1.0618863240579495,0.3510243825116195
5941,0.5941,13,58,13,491031,114579,45963,61993,1.0613490681388713,0.35109190585143735
5942,0.5942,16,50,16,491081,114529,45979,61977,1.0608859164844937,0.35113253940375966
5943,0.5943,13,60,13,491141,114469,45992,61964,1.0603301344992404,0.35120413981511395
5944,0.5944,15,56,15,491197,114413,46007,61949,1.0598114046463374,0.35126047561266033
5945,0.5945,14,53,14,491250,114360,46021,61935,1.059320463892697,0.3513145579851953
5946,0.5946,16,58,16,491308,114302,46037,61919,1.0587832079736188,0.3513712894603935
5947,0.5947,10,62,10,491370,114240,46047,61909,1.0582088999221906,0.35145814055146496
5948,0.5948,15,79,15,491449,114161,46062,61894,1.0574771203082738,0.35156059186049815
5949,0.5949,15,58,15,491507,114103,46077,61879,1.0569398643891956,0.35162118853064517
5950,0.595,27,65,27,491572,114038,46104,61852,1.0563377672385046,0.35165160043208826
5951,0.5951,16,67,16,491639,113971,46120,61836,1.0557171440216384,0.3517266092931453
5952,0.5952,29,59,29,491698,113912,46149,61807,1.0551706250694728,0.3517377176059504
5953,0.5953,9,75,9,491773,113837,46158,61798,1.0544758975879063,0.3518546986648447
5954,0.5954,15,78,15,491851,113759,46173,61783,1.053753381007077,0.35195565733556644
5955,0.5955,19,77,19,491928,113682,46192,61764,1.0530401274593353,0.3520399439143668
5956,0.5956,10,58,10,491986,113624,46202,61754,1.0525028715402571,0.3521194220483755
5957,0.5957,15,89,15,492075,113535,46217,61739,1.0516784615954649,0.35224277417072697
5958,0.5958,18,63,18,492138,113472,46235,61721,1.051094890510949,0.3523028888140508
5959,0.5959,19,70,19,492208,113402,46254,61702,1.0504464781948202,0.3523734466374269
5960,0.596,20,64,20,492272,113338,46274,61682,1.0498536440772166,0.3524282939092675
5961,0.5961,20,58,20,492330,113280,46294,61662,1.0493163881581384,0.3524711047089893
5962,0.5962,24,56,24,492386,113224,46318,61638,1.0487976583052354,0.35249511042993903
5963,0.5963,17,62,17,492448,113162,46335,61621,1.0482233502538072,0.35255717089190597
5964,0.5964,15,61,15,492509,113101,46350,61606,1.0476583052354662,0.35262468017881365
5965,0.5965,19,65,19,492574,113036,46369,61587,1.0470562080847752,0.3526854996191796
5966,0.5966,25,65,25,492639,112971,46394,61562,1.0464541109340844,0.3527241266694551
5967,0.5967,22,58,22,492697,112913,46416,61540,1.0459168550150062,0.35275976910686546
5968,0.5968,15,55,15,492752,112858,46431,61525,1.0454073881951906,0.352815354707741
5969,0.5969,17,57,17,492809,112801,46448,61508,1.0448793953092002,0.3528676086719561
5970,0.597,20,58,20,492867,112743,46468,61488,1.044342139390122,0.3529107908466346
5971,0.5971,19,61,19,492928,112682,46487,61469,1.043777094371781,0.35296380727070187
5972,0.5972,11,52,11,492980,112630,46498,61458,1.0432954166512283,0.3530283534764027
5973,0.5973,15,62,15,493042,112568,46513,61443,1.0427211085997998,0.35309836734459316
5974,0.5974,23,51,23,493093,112517,46536,61420,1.0422486939123345,0.353116358221655
5975,0.5975,12,58,12,493151,112459,46548,61408,1.0417114379932566,0.3531895069219576
5976,0.5976,18,55,18,493206,112404,46566,61390,1.041201971173441,0.353234288870732
5977,0.5977,12,71,12,493277,112333,46578,61378,1.0405442958242246,0.3533339857579543
5978,0.5978,7,42,7,493319,112291,46585,61371,1.0401552484345473,0.35339337333440823
5979,0.5979,19,77,19,493396,112214,46604,61352,1.0394419948868057,0.35347936807900165
5980,0.598,12,57,12,493453,112157,46616,61340,1.0389140020008152,0.35355078185789957
5981,0.5981,17,61,17,493514,112096,46633,61323,1.0383489569824744,0.353611772643136
5982,0.5982,18,56,18,493570,112040,46651,61305,1.0378302271295714,0.3536588883440538
5983,0.5983,10,79,10,493649,111961,46661,61295,1.0370984475156546,0.35378284157547213
5984,0.5984,21,61,21,493710,111900,46682,61274,1.0365334024973136,0.35382909674662477
5985,0.5985,9,77,9,493787,111823,46691,61265,1.035820148949572,0.35395290256979106
5986,0.5986,14,67,14,493854,111756,46705,61251,1.035199525732706,0.3540376978966169
5987,0.5987,13,71,13,493925,111685,46718,61238,1.0345418503834896,0.3541344991701509
5988,0.5988,18,69,18,493994,111616,46736,61220,1.0339027011004482,0.35420861394616865
5989,0.5989,14,78,14,494072,111538,46750,61206,1.0331801845196191,0.35431621358773674
5990,0.599,15,55,15,494127,111483,46765,61191,1.0326707176998036,0.3543729802981341
5991,0.5991,13,70,13,494197,111413,46778,61178,1.0320223053836748,0.35446807770972993
5992,0.5992,10,67,10,494264,111346,46788,61168,1.0314016821668086,0.3545683248895742
5993,0.5993,16,60,16,494324,111286,46804,61152,1.0308459001815555,0.354631809693919
5994,0.5994,19,64,19,494388,111222,46823,61133,1.030253066063952,0.35469235009138117
5995,0.5995,17,65,17,494453,111157,46840,61116,1.029650968913261,0.35476249905672974
5996,0.5996,26,53,26,494506,111104,46866,61090,1.0291600281596205,0.35477426623459585
5997,0.5997,13,65,13,494571,111039,46879,61077,1.0285579310089297,0.35485951335146065
5998,0.5998,22,59,22,494630,110980,46901,61055,1.0280114120567638,0.35489871247129945
5999,0.5999,10,52,10,494682,110928,46911,61045,1.027529734336211,0.3549685124990551
6000,0.6,16,65,16,494747,110863,46927,61029,1.02692763718552,0.3550427012310055
6001,0.6001,18,61,18,494808,110802,46945,61011,1.0263625921671793,0.3551011855913115
6002,0.6002,22,63,22,494871,110739,46967,60989,1.0257790210826634,0.35514884002608776
6003,0.6003,16,69,16,494940,110670,46983,60973,1.025139871799622,0.35523149793466674
6004,0.6004,21,64,21,495004,110606,47004,60952,1.0245470376820185,0.35528509308805184
6005,0.6005,14,56,14,495060,110550,47018,60938,1.0240283078291155,0.35534847919387946
6006,0.6006,21,49,21,495109,110501,47039,60917,1.0235744192078253,0.35537108121667504
6007,0.6007,16,60,16,495169,110441,47055,60901,1.0230186372225722,0.35543532817406126
6008,0.6008,14,67,14,495236,110374,47069,60887,1.022398014005706,0.3555216891177793
6009,0.6009,13,67,13,495303,110307,47082,60874,1.02177739078884,0.3556118961800667
6010,0.601,9,60,9,495363,110247,47091,60865,1.0212216088035866,0.3557026976483239
6011,0.6011,21,53,21,495416,110194,47112,60844,1.0207306680499462,0.3557338135385119
6012,0.6012,16,68,16,495484,110126,47128,60828,1.0201007817999925,0.35581501456532166
6013,0.6013,13,46,13,495530,110080,47141,60815,1.0196746822779652,0.35586178647707656
6014,0.6014,17,68,17,495598,110012,47158,60798,1.0190447960280113,0.3559393478133599
6015,0.6015,27,58,27,495656,109954,47185,60771,1.0185075401089332,0.3559584126519256
6016,0.6016,19,57,19,495713,109897,47204,60752,1.0179795472229427,0.3560056021424093
6017,0.6017,14,54,14,495767,109843,47218,60738,1.0174793434362148,0.3560654469137829
6018,0.6018,15,74,15,495841,109769,47233,60723,1.0167938789877358,0.35616333904230113
6019,0.6019,15,47,15,495888,109722,47248,60708,1.0163585164326208,0.35620489350466467
6020,0.602,13,62,13,495950,109660,47261,60695,1.0157842083811923,0.3562854040092748
6021,0.6021,12,68,12,496018,109592,47273,60683,1.0151543221312387,0.356382322713258
6022,0.6022,18,67,18,496085,109525,47291,60665,1.0145336989143725,0.356454550796169
6023,0.6023,15,59,15,496144,109466,47306,60650,1.0139871799622069,0.3565214324343389
6024,0.6024,22,54,22,496198,109412,47328,60628,1.013486976175479,0.35655139967066574
6025,0.6025,12,57,12,496255,109355,47340,60616,1.0129589832894883,0.35662554200422425
6026,0.6026,9,57,9,496312,109298,47349,60607,1.0124309904034978,0.35671110326358846
6027,0.6027,17,49,17,496361,109249,47366,60590,1.0119771017822075,0.35674962758848083
6028,0.6028,26,56,26,496417,109193,47392,60564,1.0114583719293044,0.3567687930394623
6029,0.6029,15,70,15,496487,109123,47407,60549,1.0108099596131757,0.3568591164128436
6030,0.603,17,66,17,496553,109057,47424,60532,1.0101985994293972,0.3569335275283185
6031,0.6031,13,51,13,496604,109006,47437,60519,1.0097261847419319,0.35699159416015336
6032,0.6032,15,71,15,496675,108935,47452,60504,1.0090685093927156,0.3570842604123018
6033,0.6033,25,59,25,496734,108876,47477,60479,1.0085219904405498,0.357113755129757
6034,0.6034,12,63,12,496797,108813,47489,60467,1.007938419356034,0.35720108695652175
6035,0.6035,25,58,25,496855,108755,47514,60442,1.0074011634369557,0.3572285560618687
6036,0.6036,19,53,19,496908,108702,47533,60423,1.0069102226833153,0.3572682926829268
6037,0.6037,22,83,22,496991,108619,47555,60401,1.0061413909370485,0.35736007573068274
6038,0.6038,16,45,16,497036,108574,47571,60385,1.0057245544481086,0.35739439745737134
6039,0.6039,16,46,16,497082,108528,47587,60369,1.005298454926081,0.35743086022842324
6040,0.604,22,67,22,497149,108461,47609,60347,1.0046778317092149,0.35748898156485476
6041,0.6041,14,61,14,497210,108400,47623,60333,1.0041127866908741,0.3575649102428096
6042,0.6042,16,64,16,497274,108336,47639,60317,1.0035199525732705,0.35763965064362924
6043,0.6043,16,73,16,497347,108263,47655,60301,1.0028437511578792,0.35773356113998245
6044,0.6044,24,52,24,497399,108211,47679,60277,1.0023620734373264,0.3577524808888467
6045,0.6045,14,53,14,497452,108158,47693,60263,1.001871132683686,0.35781167431614824
6046,0.6046,12,54,12,497506,108104,47705,60251,1.0013709288969581,0.35788066882480474
6047,0.6047,21,60,21,497566,108044,47726,60230,1.0008151469117048,0.3579281410081177
6048,0.6048,16,53,16,497619,107991,47742,60214,1.0003242061580644,0.3579798460212241
6049,0.6049,10,61,10,497680,107930,47752,60204,0.9997591611397236,0.35807153817788195
6050,0.605,15,60,15,497740,107870,47767,60189,0.9992033791544703,0.3581420810548676
6051,0.6051,5,40,5,497780,107830,47772,60184,0.9988328578309682,0.3582082445510493
6052,0.6052,19,55,19,497835,107775,47791,60165,0.9983233910111526,0.3582529474812433
6053,0.6053,24,60,24,497895,107715,47815,60141,0.9977676090258994,0.3582892479267944
6054,0.6054,21,67,21,497962,107648,47836,60120,0.9971469858090333,0.35835200991845884
6055,0.6055,19,66,19,498028,107582,47855,60101,0.9965356256252548,0.35842035268930067
6056,0.6056,18,63,18,498091,107519,47873,60083,0.9959520545407389,0.3584861755826303
6057,0.6057,20,52,20,498143,107467,47893,60063,0.995470376820186,0.3585208619351758
6058,0.6058,17,52,17,498195,107415,47910,60046,0.9949886990996332,0.3585670693474899
6059,0.6059,22,53,22,498248,107362,47932,60024,0.9944977583459929,0.35859629837620827
6060,0.606,18,61,18,498309,107301,47950,60006,0.993932713327652,0.35865803582635514
6061,0.6061,18,65,18,498374,107236,47968,59988,0.993330616176961,0.35872841218963786
6062,0.6062,18,56,18,498430,107180,47986,59970,0.9928118863240579,0.3587795393359258
6063,0.6063,22,65,22,498495,107115,48008,59948,0.9922097891733669,0.35883469110455335
6064,0.6064,9,57,9,498552,107058,48017,59939,0.9916817962873763,0.35892261537632414
6065,0.6065,18,62,18,498614,106996,48035,59921,0.991107488235948,0.3589868018236609
6066,0.6066,17,68,17,498682,106928,48052,59904,0.9904776019859943,0.3590678047377002
6067,0.6067,24,64,24,498746,106864,48076,59880,0.9898847678683909,0.3591133713956724
6068,0.6068,19,57,19,498803,106807,48095,59861,0.9893567749824003,0.35916312669498646
6069,0.6069,13,52,13,498855,106755,48108,59848,0.9888750972618474,0.3592252240355816
6070,0.607,22,64,22,498919,106691,48130,59826,0.9882822631442439,0.3592786322117261
6071,0.6071,20,59,20,498978,106632,48150,59806,0.9877357441920782,0.3593289993871592
6072,0.6072,17,70,17,499048,106562,48167,59789,0.9870873318759494,0.35941473150146375
6073,0.6073,18,56,18,499104,106506,48185,59771,0.9865686020230464,0.35946643251922994
6074,0.6074,21,49,21,499153,106457,48206,59750,0.9861147134017563,0.35949147749493104
6075,0.6075,19,61,19,499214,106396,48225,59731,0.9855496683834155,0.35955022362409483
6076,0.6076,16,64,16,499278,106332,48241,59715,0.984956834265812,0.3596270935337585
6077,0.6077,14,63,14,499341,106269,48255,59701,0.984373263181296,0.35970958606977166
6078,0.6078,16,65,16,499406,106204,48271,59685,0.9837711660306051,0.35978877442145046
6079,0.6079,17,52,17,499458,106152,48288,59668,0.9832894883100523,0.35983596671089135
6080,0.608,25,43,25,499501,106109,48313,59643,0.9828911778872874,0.35983276219894783
6081,0.6081,15,60,15,499561,106049,48328,59628,0.9823353959020341,0.3599051165822655
6082,0.6082,13,73,13,499634,105976,48341,59615,0.9816591944866427,0.36001352730522795
6083,0.6083,13,59,13,499693,105917,48354,59602,0.981112675534477,0.36009159069351554
6084,0.6084,18,54,18,499747,105863,48372,59584,0.9806124717477491,0.36013950086734725
6085,0.6085,25,62,25,499809,105801,48397,59559,0.9800381636963207,0.360177793904209
6086,0.6086,15,55,15,499864,105746,48412,59544,0.9795286968765052,0.36023957892189484
6087,0.6087,14,74,14,499938,105672,48426,59530,0.9788432324280262,0.36034672703720294
6088,0.6088,13,56,13,499994,105616,48439,59517,0.9783245025751232,0.3604185716967535
6089,0.6089,21,70,21,500064,105546,48460,59496,0.9776760902589944,0.36049005707638054
6090,0.609,20,75,20,500139,105471,48480,59476,0.9769813627774279,0.36057642757976804
6091,0.6091,16,49,16,500188,105422,48496,59460,0.9765274741561377,0.3606215354010747
6092,0.6092,21,57,21,500245,105365,48517,59439,0.9759994812701471,0.36066478968957066
6093,0.6093,13,64,13,500309,105301,48530,59426,0.9754066471525437,0.36075446041025455
6094,0.6094,19,58,19,500367,105243,48549,59407,0.9748693912334655,0.360807774066201
6095,0.6095,14,63,14,500430,105180,48563,59393,0.9742858201489496,0.360891519265007
6096,0.6096,13,57,13,500487,105123,48576,59380,0.973757827262959,0.36096606140921444
6097,0.6097,24,75,24,500562,105048,48600,59356,0.9730630997813924,0.36103744434441987
6098,0.6098,10,68,10,500630,104980,48610,59346,0.9724332135314387,0.3611479619780193
6099,0.6099,25,55,25,500685,104925,48635,59321,0.9719237467116233,0.3611716571484237
6100,0.61,19,49,19,500734,104876,48654,59302,0.9714698580903331,0.3612055208371402
6101,0.6101,11,58,11,500792,104818,48665,59291,0.970932602171255,0.36129036189361946
6102,0.6102,22,60,22,500852,104758,48687,59269,0.9703768201860017,0.36133685307906627
6103,0.6103,15,62,15,500914,104696,48702,59254,0.9698025121345734,0.36141506556877095
6104,0.6104,20,66,20,500980,104630,48722,59234,0.9691911519507947,0.3614826929648977
6105,0.6105,17,60,17,501040,104570,48739,59217,0.9686353699655416,0.3615488408725967
6106,0.6106,17,56,17,501096,104514,48756,59200,0.9681166401126384,0.36160621571765394
6107,0.6107,17,50,17,501146,104464,48773,59183,0.9676534884582608,0.36165038161408397
6108,0.6108,16,42,16,501188,104422,48789,59167,0.9672644410685834,0.3616807976086412
6109,0.6109,16,49,16,501237,104373,48805,59151,0.9668105524472933,0.3617267190137228
6110,0.611,12,49,12,501286,104324,48817,59139,0.9663566638260032,0.3617882945987777
6111,0.6111,18,61,18,501347,104263,48835,59121,0.9657916188076624,0.3618530578269598
6112,0.6112,17,67,17,501414,104196,48852,59104,0.9651709955907962,0.36193508879363134
6113,0.6113,13,62,13,501476,104134,48865,59091,0.9645966875393679,0.36202174911931384
6114,0.6114,16,55,16,501531,104079,48881,59075,0.9640872207195524,0.36208122387437636
6115,0.6115,15,51,15,501582,104028,48896,59060,0.9636148060320872,0.3621357794564897
6116,0.6116,11,56,11,501638,103972,48907,59049,0.9630960761791841,0.36221713766938
6117,0.6117,23,66,23,501704,103906,48930,59026,0.9624847159954055,0.36227383202808533
6118,0.6118,16,64,16,501768,103842,48946,59010,0.9618918818778021,0.36235354800677916
6119,0.6119,14,55,14,501823,103787,48960,58996,0.9613824150579866,0.3624211373423515
6120,0.612,19,70,19,501893,103717,48979,58977,0.9607340027418578,0.3625026122659717
6121,0.6121,13,59,13,501952,103658,48992,58964,0.9601874837896921,0.3625831683290084
6122,0.6122,22,55,22,502007,103603,49014,58942,0.9596780169698766,0.36261958226952534
6123,0.6123,17,57,17,502064,103546,49031,58925,0.959150024083886,0.3626801090656179
6124,0.6124,8,55,8,502119,103491,49039,58917,0.9586405572640705,0.36277153834786463
6125,0.6125,13,67,13,502186,103424,49052,58904,0.9580199340472044,0.3628702380365679
6126,0.6126,14,56,14,502242,103368,49066,58890,0.9575012041943014,0.36294050216322155
6127,0.6127,13,65,13,502307,103303,49079,58877,0.9568991070436104,0.36303489949438894
6128,0.6128,15,56,15,502363,103247,49094,58862,0.9563803771907073,0.3631013700658199
6129,0.6129,18,67,18,502430,103180,49112,58844,0.9557597539738412,0.36318076334370214
6130,0.613,18,52,18,502482,103128,49130,58826,0.9552780762532884,0.36322659520604617
6131,0.6131,18,58,18,502540,103070,49148,58808,0.9547408203342103,0.3632859313804223
6132,0.6132,9,51,9,502591,103019,49157,58799,0.954268405646745,0.3633650150168708
6133,0.6133,20,65,20,502656,102954,49177,58779,0.9536663084960539,0.3634323236445252
6134,0.6134,15,62,15,502718,102892,49192,58764,0.9530920004446256,0.36351264413322115
6135,0.6135,13,49,13,502767,102843,49205,58751,0.9526381118233355,0.3635716672648737
6136,0.6136,19,57,19,502824,102786,49224,58732,0.9521101189373449,0.3636251067992422
6137,0.6137,16,62,16,502886,102724,49240,58716,0.9515358108859164,0.36370168483647175
6138,0.6138,19,63,19,502949,102661,49259,58697,0.9509522398014005,0.36376876262720165
6139,0.6139,9,71,9,503020,102590,49268,58688,0.9502945644521842,0.36389340145587123
6140,0.614,15,59,15,503079,102531,49283,58673,0.9497480455000186,0.36396739534999134
6141,0.6141,17,59,17,503138,102472,49300,58656,0.9492015265478528,0.3640335633781838
6142,0.6142,15,43,15,503181,102429,49315,58641,0.948803216125088,0.3640715216986403
6143,0.6143,13,49,13,503230,102380,49328,58628,0.9483493275037979,0.36413097485839213
6144,0.6144,15,65,15,503295,102315,49343,58613,0.9477472303531068,0.36421878106979516
6145,0.6145,15,75,15,503370,102240,49358,58598,0.9470525028715403,0.36432932515947725
6146,0.6146,16,56,16,503426,102184,49374,58582,0.9465337730186372,0.3643929686625281
6147,0.6147,9,49,9,503475,102135,49383,58573,0.946079884397347,0.3644684769893223
6148,0.6148,22,74,22,503549,102061,49405,58551,0.9453944199488681,0.3645493487410654
6149,0.6149,13,58,13,503607,102003,49418,58538,0.9448571640297899,0.3646295961779234
6150,0.615,30,65,30,503672,101938,49448,58508,0.9442550668790989,0.3646585143911347
6151,0.6151,10,40,10,503712,101898,49458,58498,0.9438845455555968,0.36470984313823285
6152,0.6152,20,45,20,503757,101853,49478,58478,0.9434677090666568,0.3647329586917065
6153,0.6153,13,60,13,503817,101793,49491,58465,0.9429119270814036,0.3648179810056284
6154,0.6154,10,48,10,503865,101745,49501,58455,0.9424673014932009,0.3648876404494382
6155,0.6155,9,59,9,503924,101686,49510,58446,0.9419207825410353,0.36498638623135915
6156,0.6156,15,49,15,503973,101637,49525,58431,0.941466893919745,0.3650386085913487
6157,0.6157,10,54,10,504027,101583,49535,58421,0.9409666901330171,0.3651221219469513
6158,0.6158,16,60,16,504087,101523,49551,58405,0.940410908147764,0.36519558801460655
6159,0.6159,16,53,16,504140,101470,49567,58389,0.9399199673941235,0.3652531293202134
6160,0.616,16,64,16,504204,101406,49583,58373,0.9393271332765201,0.36533587017067326
6161,0.6161,17,53,17,504257,101353,49600,58356,0.9388361925228796,0.36538955224815134
6162,0.6162,13,59,13,504316,101294,49613,58343,0.938289673570714,0.3654729166797171
6163,0.6163,30,48,30,504364,101246,49643,58313,0.9378450479825114,0.3654635589343127
6164,0.6164,10,55,10,504419,101191,49653,58303,0.9373355811626959,0.3655498012464419
6165,0.6165,15,46,15,504465,101145,49668,58288,0.9369094816406685,0.3655955793342658
6166,0.6166,21,46,21,504511,101099,49689,58267,0.9364833821186409,0.3656175093809219
6167,0.6167,16,58,16,504569,101041,49705,58251,0.9359461261995627,0.3656869145970921
6168,0.6168,16,54,16,504623,100987,49721,58235,0.9354459224128349,0.36574719573928227
6169,0.6169,12,48,12,504671,100939,49733,58223,0.9350012968246323,0.3658096781895176
6170,0.617,18,67,18,504738,100872,49751,58205,0.9343806736077661,0.36589198941393164
6171,0.6171,23,39,23,504777,100833,49774,58182,0.9340194153173516,0.3658900103763796
6172,0.6172,20,56,20,504833,100777,49794,58162,0.9335006854644485,0.365939133881552
6173,0.6173,20,57,20,504890,100720,49814,58142,0.9329726925784579,0.3659906082008284
6174,0.6174,9,53,9,504943,100667,49823,58133,0.9324817518248175,0.3660768261964735
6175,0.6175,10,56,10,504999,100611,49833,58123,0.9319630219719145,0.3661660387818615
6176,0.6176,10,69,10,505068,100542,49843,58113,0.9313238726888733,0.3662853361066465
6177,0.6177,28,60,28,505128,100482,49871,58085,0.93076809070362,0.3663120321378345
6178,0.6178,17,55,17,505183,100427,49888,58068,0.9302586238838045,0.36637117890154264
6179,0.6179,12,58,12,505241,100369,49900,58056,0.9297213679647264,0.3664573141865236
6180,0.618,9,63,9,505304,100306,49909,58047,0.9291377968802105,0.36656710008651555
6181,0.6181,14,43,14,505347,100263,49923,58033,0.9287394864574456,0.366610653459342
6182,0.6182,21,68,21,505415,100195,49944,58012,0.9281096002074919,0.3666841543041711
6183,0.6183,18,56,18,505471,100139,49962,57994,0.9275908703545889,0.36674191977639076
6184,0.6184,15,72,15,505543,100067,49977,57979,0.926923931972285,0.3668488920947066
6185,0.6185,16,54,16,505597,100013,49993,57963,0.9264237281855571,0.36691016356914974
6186,0.6186,23,52,23,505649,99961,50016,57940,0.9259420504650042,0.3669387780951356
6187,0.6187,19,60,19,505709,99901,50035,57921,0.925386268479751,0.3670020656182281
6188,0.6188,15,63,15,505772,99838,50050,57906,0.9248026973952351,0.36708844710416877
6189,0.6189,15,56,15,505828,99782,50065,57891,0.9242839675423321,0.36715861307896724
6190,0.619,19,54,19,505882,99728,50084,57872,0.9237837637556041,0.3672081218274112
6191,0.6191,17,59,17,505941,99669,50101,57855,0.9232372448034384,0.36727736725832255
6192,0.6192,22,46,22,505987,99623,50123,57833,0.922811145281411,0.36729626054262776
6193,0.6193,14,47,14,506034,99576,50137,57819,0.922375782726296,0.36734966167921473
6194,0.6194,23,49,23,506083,99527,50160,57796,0.9219218941050057,0.3673715858456805
6195,0.6195,14,65,14,506148,99462,50174,57782,0.9213197969543148,0.36746712116201574
6196,0.6196,21,62,21,506210,99400,50195,57761,0.9207454889028863,0.3675275672717786
6197,0.6197,26,54,26,506264,99346,50221,57735,0.9202452851161584,0.36754922619540237
6198,0.6198,16,71,16,506335,99275,50237,57719,0.9195876097669421,0.36765099303158083
6199,0.6199,23,64,23,506399,99211,50260,57696,0.9189947756493386,0.3677082603070609
6200,0.62,17,54,17,506453,99157,50277,57679,0.9184945718626107,0.3677663291591216
6201,0.6201,22,50,22,506503,99107,50299,57657,0.918031420208233,0.3677949018907402
6202,0.6202,15,51,15,506554,99056,50314,57642,0.9175590055207677,0.36785408875671677
6203,0.6203,18,65,18,506619,98991,50332,57624,0.9169569083700767,0.3679341059285509
6204,0.6204,14,65,14,506684,98926,50346,57610,0.9163548112193857,0.36803035723411864
6205,0.6205,18,51,18,506735,98875,50364,57592,0.9158823965319204,0.36807761380994075
6206,0.6206,14,55,14,506790,98820,50378,57578,0.9153729297121049,0.368150487857901
6207,0.6207,14,77,14,506867,98743,50392,57564,0.9146596761643633,0.36827525318763715
6208,0.6208,14,62,14,506929,98681,50406,57550,0.914085368112935,0.3683647931588481
6209,0.6209,16,67,16,506996,98614,50422,57534,0.9134647448960688,0.36845812946691603
6210,0.621,13,54,13,507050,98560,50435,57521,0.9129645411093409,0.3685330052985309
6211,0.6211,16,43,16,507093,98517,50451,57505,0.912566230686576,0.36856981707707887
6212,0.6212,13,63,13,507156,98454,50464,57492,0.9119826596020602,0.3686660767188642
6213,0.6213,17,58,17,507214,98396,50481,57475,0.911445403682982,0.3687344021658936
6214,0.6214,16,56,16,507270,98340,50497,57459,0.910926673830079,0.36880211041149175
6215,0.6215,26,69,26,507339,98271,50523,57433,0.9102875245470377,0.36886014489030466
6216,0.6216,23,61,23,507400,98210,50546,57410,0.9097224795286969,0.3689114509703123
6217,0.6217,26,51,26,507451,98159,50572,57384,0.9092500648412316,0.3689269205300142
6218,0.6218,15,55,15,507506,98104,50587,57369,0.9087405980214162,0.3689965460240685
6219,0.6219,18,52,18,507558,98052,50605,57351,0.9082589203008633,0.36904692959595375
6220,0.622,20,68,20,507626,97984,50625,57331,0.9076290340509097,0.36912725750893344
6221,0.6221,10,59,10,507685,97925,50635,57321,0.9070825150987439,0.36922690439689265
6222,0.6222,13,43,13,507728,97882,50648,57308,0.9066842046759791,0.3692763709001869
6223,0.6223,14,40,14,507768,97842,50662,57294,0.906313683352477,0.3693146658415842
6224,0.6224,21,71,21,507839,97771,50683,57273,0.9056560080032606,0.36939836433528545
6225,0.6225,23,48,23,507887,97723,50706,57250,0.9052113824150579,0.36941918914907756
6226,0.6226,14,65,14,507952,97658,50720,57236,0.904609285264367,0.36951721822665823
6227,0.6227,20,48,20,508000,97610,50740,57216,0.9041646596761643,0.3695503339232429
6228,0.6228,13,58,13,508058,97552,50753,57203,0.9036274037570862,0.36963587606216275
6229,0.6229,14,58,14,508116,97494,50767,57189,0.9030901478380081,0.3697174220825818
6230,0.623,20,58,20,508174,97436,50787,57169,0.90255289191893,0.3697745868503606
6231,0.6231,15,67,15,508241,97369,50802,57154,0.9019322687020638,0.3698737404787637
6232,0.6232,17,56,17,508297,97313,50819,57137,0.9014135388491608,0.3699384914211719
6233,0.6233,17,62,17,508359,97251,50836,57120,0.9008392307977324,0.37001768466875257
6234,0.6234,14,53,14,508412,97198,50850,57106,0.900348290044092,0.3700876192451265
6235,0.6235,20,58,20,508470,97140,50870,57086,0.8998110341250138,0.37014511171916537
6236,0.6236,14,49,14,508519,97091,50884,57072,0.8993571455037237,0.3702055616457905
6237,0.6237,19,60,19,508579,97031,50903,57053,0.8988013635184705,0.3702720593961735
6238,0.6238,13,64,13,508643,96967,50916,57040,0.898208529400867,0.3703727752634621
6239,0.6239,13,55,13,508698,96912,50929,57027,0.8976990625810516,0.3704519322588818
6240,0.624,19,68,19,508766,96844,50948,57008,0.8970691763310978,0.37053791955905674
6241,0.6241,16,49,16,508815,96795,50964,56992,0.8966152877098077,0.370590492044191
6242,0.6242,21,60,21,508875,96735,50985,56971,0.8960595057245544,0.37064916138602266
6243,0.6243,17,49,17,508924,96686,51002,56954,0.8956056171032643,0.3706977349648529
6244,0.6244,19,53,19,508977,96633,51021,56935,0.8951146763496239,0.3707478120441759
6245,0.6245,18,55,18,509032,96578,51039,56917,0.8946052095298085,0.3708068666731815
6246,0.6246,24,56,24,509088,96522,51063,56893,0.8940864796769054,0.37084378972069226
6247,0.6247,14,54,14,509142,96468,51077,56879,0.8935862758901775,0.37091694001186853
6248,0.6248,13,60,13,509202,96408,51090,56866,0.8930304939049243,0.37100878165898976
6249,0.6249,17,50,17,509252,96358,51107,56849,0.8925673422505466,0.37106006905689687
6250,0.625,17,63,17,509315,96295,51124,56832,0.8919837711660306,0.3711429075212079
6251,0.6251,16,46,16,509361,96249,51140,56816,0.8915576716440031,0.3711887106784699
6252,0.6252,17,60,17,509421,96189,51157,56799,0.8910018896587498,0.371264412895129
6253,0.6253,13,53,13,509474,96136,51170,56786,0.8905109489051095,0.3713396372006644
6254,0.6254,14,45,14,509519,96091,51184,56772,0.8900941124161695,0.3713913765921119
6255,0.6255,23,56,23,509575,96035,51207,56749,0.8895753825632665,0.37143287255209967
6256,0.6256,19,54,19,509629,95981,51226,56730,0.8890751787765386,0.37148600952125255
6257,0.6257,25,83,25,509712,95898,51251,56705,0.8883063470302716,0.37158509334678874
6258,0.6258,15,65,15,509777,95833,51266,56690,0.8877042498795805,0.3716816480137422
6259,0.6259,11,61,11,509838,95772,51277,56679,0.8871392048612398,0.37178503256784146
6260,0.626,16,42,16,509880,95730,51293,56663,0.8867501574715625,0.37182154035946535
6261,0.6261,20,60,20,509940,95670,51313,56643,0.8861943754863092,0.3718855252013945
6262,0.6262,27,53,27,509993,95617,51340,56616,0.8857034347326689,0.37190359514691296
6263,0.6263,23,59,23,510052,95558,51363,56593,0.8851569157805032,0.3719528626167426
6264,0.6264,23,50,23,510102,95508,51386,56570,0.8846937641261254,0.37198016807164747
6265,0.6265,15,54,15,510156,95454,51401,56555,0.8841935603393976,0.37205033912465707
6266,0.6266,15,55,15,510211,95399,51416,56540,0.8836840935195821,0.3721230230553051
6267,0.6267,14,61,14,510272,95338,51430,56526,0.8831190485012412,0.3722146130748564
6268,0.6268,9,59,9,510331,95279,51439,56517,0.8825725295490755,0.3723220638224986
6269,0.6269,18,52,18,510383,95227,51457,56499,0.8820908518285228,0.37237520266796725
6270,0.627,10,52,10,510435,95175,51467,56489,0.8816091741079699,0.37246149382846294
6271,0.6271,18,69,18,510504,95106,51485,56471,0.8809700248249287,0.37255652242754506
6272,0.6272,17,50,17,510554,95056,51502,56454,0.880506873170551,0.3726090687083361
6273,0.6273,21,52,21,510606,95004,51523,56433,0.8800251954499981,0.3726500128766418
6274,0.6274,13,66,13,510672,94938,51536,56420,0.8794138352662195,0.37275862524610526
6275,0.6275,14,66,14,510738,94872,51550,56406,0.878802475082441,0.37286320548923174
6276,0.6276,18,54,18,510792,94818,51568,56388,0.878302271295713,0.37292170945597397
6277,0.6277,12,56,12,510848,94762,51580,56376,0.87778354144281,0.37301009673278723
6278,0.6278,11,48,11,510896,94714,51591,56365,0.8773389158546074,0.3730829565988655
6279,0.6279,17,64,17,510960,94650,51608,56348,0.876746081737004,0.3731705055696102
6280,0.628,25,53,25,511013,94597,51633,56323,0.8762551409833635,0.37319772064670026
6281,0.6281,11,68,11,511081,94529,51644,56312,0.8756252547334099,0.37332025112535716
6282,0.6282,16,52,16,511133,94477,51660,56296,0.875143577012857,0.3733825021721396
6283,0.6283,15,55,15,511188,94422,51675,56281,0.8746341101930416,0.37345640100064365
6284,0.6284,16,52,16,511240,94370,51691,56265,0.8741524324724887,0.37351877053805554
6285,0.6285,17,56,17,511296,94314,51708,56248,0.8736337026195857,0.37358696085333615
6286,0.6286,18,65,18,511361,94249,51726,56230,0.8730316054688947,0.37367340293329965
6287,0.6287,11,51,11,511412,94198,51737,56219,0.8725591907814295,0.37375429638937085
6288,0.6288,16,51,16,511463,94147,51753,56203,0.8720867760939642,0.37381443298969075
6289,0.6289,17,58,17,511521,94089,51770,56186,0.8715495201748861,0.37388787223423725
6290,0.629,18,60,18,511581,94029,51788,56168,0.8709937381896328,0.37396219631550565
6291,0.6291,20,46,20,511627,93983,51808,56148,0.8705676386676053,0.3739933791155724
6292,0.6292,22,61,22,511688,93922,51830,56126,0.8700025936492645,0.374053636169759
6293,0.6293,13,50,13,511738,93872,51843,56113,0.8695394419948868,0.3741240790745741
6294,0.6294,20,39,20,511777,93833,51863,56093,0.8691781837044722,0.37413790803463043
6295,0.6295,9,70,9,511847,93763,51872,56084,0.8685297713883434,0.37427509392914105
6296,0.6296,12,51,12,511898,93712,51884,56072,0.8680573567008781,0.3743524007904716
6297,0.6297,16,48,16,511946,93664,51900,56056,0.8676127311126756,0.37440555703980766
6298,0.6298,17,58,17,512004,93606,51917,56039,0.8670754751935974,0.37447960172408035
6299,0.6299,20,49,20,512053,93557,51937,56019,0.8666215865723073,0.37451863935390706
6300,0.63,14,52,14,512105,93505,51951,56005,0.8661399088517544,0.37459032840612666
6301,0.6301,20,50,20,512155,93455,51971,55985,0.8656767571973767,0.37463195931477516
6302,0.6302,26,49,26,512204,93406,51997,55959,0.8652228685760865,0.3746460014059519
6303,0.6303,28,61,28,512265,93345,52025,55931,0.8646578235577458,0.3746817974758166
6304,0.6304,22,58,22,512323,93287,52047,55909,0.8641205676386676,0.37473524759376925
6305,0.6305,21,59,21,512382,93228,52068,55888,0.8635740486865019,0.37479546125164304
6306,0.6306,12,58,12,512440,93170,52080,55876,0.8630367927674237,0.3748909732565785
6307,0.6307,21,45,21,512485,93125,52101,55855,0.8626199562784839,0.3749160961202846
6308,0.6308,20,71,20,512556,93054,52121,55835,0.8619622809292675,0.37501091417095955
6309,0.6309,15,58,15,512614,92996,52136,55820,0.8614250250101894,0.37509407590581656
6310,0.631,7,50,7,512664,92946,52143,55813,0.8609618733558116,0.3751907447616615
6311,0.6311,9,55,9,512719,92891,52152,55804,0.8604524065359962,0.37529170449578
6312,0.6312,14,69,14,512788,92822,52166,55790,0.8598132572529549,0.37540710036874547
6313,0.6313,25,53,25,512841,92769,52191,55765,0.8593223164993146,0.37543592712779567
6314,0.6314,15,60,15,512901,92709,52206,55750,0.8587665345140613,0.3755245556012098
6315,0.6315,19,52,19,512953,92657,52225,55731,0.8582848567935085,0.3755761921449174
6316,0.6316,15,58,15,513011,92599,52240,55716,0.8577476008744304,0.37565991302295787
6317,0.6317,20,53,20,513064,92546,52260,55696,0.8572566601207899,0.37570998772277764
6318,0.6318,22,61,22,513125,92485,52282,55674,0.8566916151024492,0.375771974702853
6319,0.6319,22,52,22,513177,92433,52304,55652,0.8562099373818963,0.3758111895195327
6320,0.632,20,52,20,513229,92381,52324,55632,0.8557282596613435,0.37585887726078115
6321,0.6321,12,50,12,513279,92331,52336,55620,0.8552651080069658,0.37593527586836184
6322,0.6322,18,49,18,513328,92282,52354,55602,0.8548112193856756,0.3759838792567147
6323,0.6323,13,53,13,513381,92229,52367,55589,0.8543202786320353,0.37606380819656604
6324,0.6324,13,58,13,513439,92171,52380,55576,0.8537830227129571,0.37615653786540504
6325,0.6325,15,62,15,513501,92109,52395,55561,0.8532087146615288,0.37625110042662696
6326,0.6326,23,61,23,513562,92048,52418,55538,0.8526436696431879,0.3763094060412234
6327,0.6327,15,61,15,513623,91987,52433,55523,0.8520786246248472,0.37640159989153277
6328,0.6328,17,57,17,513680,91930,52450,55506,0.8515506317388566,0.37647521636506687
6329,0.6329,20,61,20,513741,91869,52470,55486,0.8509855867205157,0.3765464354789454
6330,0.633,17,60,17,513801,91809,52487,55469,0.8504298047352625,0.37662787381686336
6331,0.6331,14,65,14,513866,91744,52501,55455,0.8498277075845715,0.37673489629684986
6332,0.6332,31,61,31,513927,91683,52532,55424,0.8492626625662307,0.376759773498202
6333,0.6333,20,44,20,513971,91639,52552,55404,0.8488550891103783,0.37678774236107804
6334,0.6334,14,45,14,514016,91594,52566,55390,0.8484382526214383,0.37684373809394217
6335,0.6335,22,48,22,514064,91546,52588,55368,0.8479936270332358,0.3768735450671822
6336,0.6336,14,61,14,514125,91485,52602,55354,0.8474285820148949,0.37697069579607595
6337,0.6337,14,49,14,514174,91436,52616,55340,0.8469746933936048,0.377037117784924
6338,0.6338,19,48,19,514222,91388,52635,55321,0.8465300678054022,0.37707979742210773
6339,0.6339,21,65,21,514287,91323,52656,55300,0.8459279706547111,0.3771577446921697
6340,0.634,19,50,19,514337,91273,52675,55281,0.8454648190003334,0.37720567162956997
6341,0.6341,13,69,13,514406,91204,52688,55268,0.8448256697172922,0.3773280900103774
6342,0.6342,11,56,11,514462,91148,52699,55257,0.8443069398643892,0.3774256343704108
6343,0.6343,13,54,13,514516,91094,52712,55244,0.8438067360776613,0.3775096010605584
6344,0.6344,17,48,17,514564,91046,52729,55227,0.8433621104894586,0.37756113568464444
6345,0.6345,11,56,11,514620,90990,52740,55216,0.8428433806365556,0.3776589196065825
6346,0.6346,19,56,19,514676,90934,52759,55197,0.8423246507836526,0.3777227282369928
6347,0.6347,8,58,8,514734,90876,52767,55189,0.8417873948645744,0.3778386334850923
6348,0.6348,23,60,23,514794,90816,52790,55166,0.8412316128793212,0.3778959049745859
6349,0.6349,11,42,11,514836,90774,52801,55155,0.840842565489644,0.37795777398597946
6350,0.635,12,48,12,514884,90726,52813,55143,0.8403979399014413,0.3780309729963186
6351,0.6351,19,70,19,514954,90656,52832,55124,0.8397495275853125,0.3781314309233091
6352,0.6352,20,59,20,515013,90597,52852,55104,0.8392030086331468,0.3781991887495625
6353,0.6353,18,53,18,515066,90544,52870,55086,0.8387120678795065,0.3782599739064753
6354,0.6354,19,74,19,515140,90470,52889,55067,0.8380266034310274,0.37837113586235804
6355,0.6355,13,47,13,515187,90423,52902,55054,0.8375912408759124,0.3784378286602006
6356,0.6356,16,62,16,515249,90361,52918,55038,0.8370169328244841,0.37853080144980367
6357,0.6357,19,47,19,515296,90314,52937,55019,0.836581570269369,0.3785719692017642
6358,0.6358,11,64,11,515360,90250,52948,55008,0.8359887361517655,0.37869170716931255
6359,0.6359,13,42,13,515402,90208,52961,54995,0.8355996887620882,0.3787456182034806
6360,0.636,17,46,17,515448,90162,52978,54978,0.8351735892400608,0.37879288962381147
6361,0.6361,21,45,21,515493,90117,52999,54957,0.8347567527511208,0.3788204640390421
6362,0.6362,21,54,21,515547,90063,53020,54936,0.8342565489643929,0.3788715784246788
6363,0.6363,13,52,13,515599,90011,53033,54923,0.8337748712438401,0.37895179874977575
6364,0.6364,17,49,17,515648,89962,53050,54906,0.8333209826225499,0.3790070961150841
6365,0.6365,18,51,18,515699,89911,53068,54888,0.8328485679350847,0.37906339132176325
6366,0.6366,13,51,13,515750,89860,53081,54875,0.8323761532476194,0.3791411890696791
6367,0.6367,18,52,18,515802,89808,53099,54857,0.8318944755270666,0.37920022120070507
6368,0.6368,16,37,16,515839,89771,53115,54841,0.8315517433028271,0.37922855641302244
6369,0.6369,18,56,18,515895,89715,53133,54823,0.8310330134499241,0.3792981776418658
6370,0.637,16,59,16,515954,89656,53149,54807,0.8304864944977584,0.37938434062701176
6371,0.6371,14,65,14,516019,89591,53163,54793,0.8298843973470673,0.3794949578900709
6372,0.6372,17,56,17,516075,89535,53180,54776,0.8293656674941643,0.3795691250147251
6373,0.6373,10,50,10,516125,89485,53190,54766,0.8289025158397866,0.3796576800160831
6374,0.6374,16,66,16,516191,89419,53206,54750,0.828291155656008,0.3797626396798202
6375,0.6375,12,50,12,516241,89369,53218,54738,0.8278280040016303,0.3798427557301172
6376,0.6376,11,59,11,516300,89310,53229,54727,0.8272814850494646,0.3799509848164013
6377,0.6377,17,40,17,516340,89270,53246,54710,0.8269109637259624,0.379983331018197
6378,0.6378,16,53,16,516393,89217,53262,54694,0.8264200229723221,0.380054339140163
6379,0.6379,15,52,15,516445,89165,53277,54679,0.8259383452517692,0.38012708211673757
6380,0.638,15,66,15,516511,89099,53292,54664,0.8253269850679906,0.38023691770483364
6381,0.6381,16,39,16,516550,89060,53308,54648,0.8249657267775761,0.38027110529685193
6382,0.6382,22,60,22,516610,89000,53330,54626,0.8244099447923228,0.3803350368317714
6383,0.6383,14,51,14,516661,88949,53344,54612,0.8239375301048575,0.38040972130313944
6384,0.6384,9,55,9,516716,88894,53353,54603,0.823428063285042,0.3805166658536415
6385,0.6385,13,52,13,516768,88842,53366,54590,0.8229463855644893,0.3805984717496793
6386,0.6386,11,55,11,516823,88787,53377,54579,0.8224369187446737,0.38069695743760723
6387,0.6387,13,58,13,516881,88729,53390,54566,0.8218996628255956,0.38079486374262883
6388,0.6388,15,61,15,516942,88668,53405,54551,0.8213346178072548,0.380892200057255
6389,0.6389,20,59,20,517001,88609,53425,54531,0.8207880988550891,0.380962693866145
6390,0.639,11,51,11,517052,88558,53436,54520,0.8203156841676238,0.3810508953158417
6391,0.6391,14,57,14,517109,88501,53450,54506,0.8197876912816333,0.38114218185123805
6392,0.6392,17,66,17,517175,88435,53467,54489,0.8191763310978547,0.38124457753771235
6393,0.6393,13,54,13,517229,88381,53480,54476,0.8186761273111267,0.38133238133238134
6394,0.6394,17,53,17,517282,88328,53497,54459,0.8181851865574864,0.3814002675313579
6395,0.6395,16,60,16,517342,88268,53513,54443,0.8176294045722331,0.38149126556467267
6396,0.6396,17,45,17,517387,88223,53530,54426,0.8172125680832932,0.381537900721351
6397,0.6397,17,44,17,517431,88179,53547,54409,0.8168049946274408,0.38158190030016553
6398,0.6398,13,44,13,517475,88135,53560,54396,0.8163974211715884,0.38164329163480226
6399,0.6399,20,37,20,517512,88098,53580,54376,0.8160546889473489,0.3816556003200584
6400,0.64,16,60,16,517572,88038,53596,54360,0.8154989069620957,0.38174693464795856
6401,0.6401,13,57,13,517629,87981,53609,54347,0.8149709140761051,0.3818433477601034
6402,0.6402,21,44,21,517673,87937,53630,54326,0.8145633406202527,0.381870198154123
6403,0.6403,11,41,11,517714,87896,53641,54315,0.814183556263663,0.3819324806097981
6404,0.6404,25,61,25,517775,87835,53666,54290,0.8136185112453221,0.38198768689533863
6405,0.6405,17,52,17,517827,87783,53683,54273,0.8131368335247694,0.38205355634397703
6406,0.6406,19,63,19,517890,87720,53702,54254,0.8125532624402534,0.38214039190274274
6407,0.6407,9,43,9,517933,87677,53711,54245,0.8121549520174886,0.3822169924324629
6408,0.6408,22,54,22,517987,87623,53733,54223,0.8116547482307607,0.38226668358642474
6409,0.6409,14,58,14,518045,87565,53747,54209,0.8111174923116825,0.38236206920874066
6410,0.641,19,49,19,518094,87516,53766,54190,0.8106636036903924,0.38241147163846273
6411,0.6411,22,59,22,518153,87457,53788,54168,0.8101170847382266,0.3824748455428067
6412,0.6412,17,42,17,518195,87415,53805,54151,0.8097280373485494,0.3825141630052414
6413,0.6413,28,62,28,518257,87353,53833,54123,0.809153729297121,0.38255958607820406
6414,0.6414,13,51,13,518308,87302,53846,54110,0.8086813146096558,0.38264079427488473
6415,0.6415,20,48,20,518356,87254,53866,54090,0.8082366890214532,0.382683382386235
6416,0.6416,18,62,18,518418,87192,53884,54072,0.8076623809700249,0.3827726809378186
6417,0.6417,21,53,21,518471,87139,53905,54051,0.8071714402163844,0.3828245626460797
6418,0.6418,24,38,24,518509,87101,53929,54027,0.8068194449590574,0.3828226857887875
6419,0.6419,14,49,14,518558,87052,53943,54013,0.8063655563377672,0.38289441037819444
6420,0.642,13,56,13,518614,86996,53956,54000,0.8058468264848642,0.3829895883571165
6421,0.6421,21,52,21,518666,86944,53977,53979,0.8053651487643114,0.3830389645409195
6422,0.6422,17,55,17,518721,86889,53994,53962,0.8048556819444959,0.38311407089761523
6423,0.6423,24,51,24,518772,86838,54018,53938,0.8043832672570307,0.38314769562993695
6424,0.6424,27,49,27,518821,86789,54045,53911,0.8039293786357404,0.38316275764036956
6425,0.6425,14,57,14,518878,86732,54059,53897,0.80340138574975,0.38325665403295195
6426,0.6426,17,54,17,518932,86678,54076,53880,0.802901181963022,0.38332930178289387
6427,0.6427,21,45,21,518977,86633,54097,53859,0.802484345474082,0.38335990661389974
6428,0.6428,21,51,21,519028,86582,54118,53838,0.8020119307866168,0.38340692209087024
6429,0.6429,18,46,18,519074,86536,54136,53820,0.8015858312645893,0.3834535039471059
6430,0.643,12,68,12,519142,86468,54148,53808,0.8009559450146356,0.38358664347429355
6431,0.6431,13,55,13,519197,86413,54161,53795,0.8004464781948201,0.38367996120050213
6432,0.6432,22,53,22,519250,86360,54183,53773,0.7999555374411798,0.3837283152433759
6433,0.6433,24,45,24,519295,86315,54207,53749,0.7995387009522398,0.3837460018277359
6434,0.6434,16,54,16,519349,86261,54223,53733,0.7990384971655119,0.383823592439676
6435,0.6435,20,42,20,519391,86219,54243,53713,0.7986494497758346,0.38385072749621246
6436,0.6436,20,53,20,519444,86166,54263,53693,0.7981585090221942,0.38390807885084266
6437,0.6437,19,51,19,519495,86115,54282,53674,0.7976860943347289,0.38396440349383715
6438,0.6438,19,52,19,519547,86063,54301,53655,0.7972044166141762,0.3840235331167065
6439,0.6439,21,59,21,519606,86004,54322,53634,0.7966578976620105,0.384093155158338
6440,0.644,15,49,15,519655,85955,54337,53619,0.7962040090407203,0.3841618066402052
6441,0.6441,23,51,23,519706,85904,54360,53596,0.795731594353255,0.38420071684587814
6442,0.6442,12,55,12,519761,85849,54372,53584,0.7952221275334396,0.38429926918304846
6443,0.6443,16,53,16,519814,85796,54388,53568,0.7947311867797991,0.38437473092046726
6444,0.6444,18,51,18,519865,85745,54406,53550,0.7942587720923339,0.3844359094009117
6445,0.6445,12,54,12,519919,85691,54418,53538,0.793758568305606,0.3845319581409046
6446,0.6446,18,53,18,519972,85638,54436,53520,0.7932676275519657,0.38459880136248004
6447,0.6447,22,48,22,520020,85590,54458,53498,0.792823001963763,0.3846341884274704
6448,0.6448,16,38,16,520058,85552,54474,53482,0.792471006706436,0.3846684983529209
6449,0.6449,15,64,15,520122,85488,54489,53467,0.7918781725888325,0.38477924507934225
6450,0.645,22,56,22,520178,85432,54511,53445,0.7913594427359295,0.38483694204223884
6451,0.6451,12,56,12,520234,85376,54523,53433,0.7908407128830264,0.38493901692253385
6452,0.6452,23,56,23,520290,85320,54546,53410,0.7903219830301234,0.3849924313414546
6453,0.6453,32,56,32,520346,85264,54578,53378,0.7898032531772203,0.38500598664185454
6454,0.6454,19,53,19,520399,85211,54597,53359,0.78931231242358,0.3850689182362705
6455,0.6455,14,64,14,520463,85147,54611,53345,0.7887194783059766,0.38518470380960634
6456,0.6456,13,68,13,520531,85079,54624,53332,0.7880895920560228,0.38531619596708355
6457,0.6457,8,47,8,520578,85032,54632,53324,0.7876542295009078,0.38541154702362024
6458,0.6458,18,52,18,520630,84980,54650,53306,0.787172551780355,0.38547647628827214
6459,0.6459,14,37,14,520667,84943,54664,53292,0.7868298195561154,0.3855174159945021
6460,0.646,17,66,17,520733,84877,54681,53275,0.7862184593723369,0.38562597718455033
6461,0.6461,14,44,14,520777,84833,54695,53261,0.7858108859164845,0.3856865613277912
6462,0.6462,21,55,21,520832,84778,54716,53240,0.7853014190966691,0.3857467866510165
6463,0.6463,10,47,10,520879,84731,54726,53230,0.784866056541554,0.3858336776335341
6464,0.6464,17,50,17,520929,84681,54743,53213,0.7844029048871762,0.38589786357637024
6465,0.6465,17,45,17,520974,84636,54760,53196,0.7839860683982364,0.3859481107435138
6466,0.6466,22,60,22,521034,84576,54782,53174,0.7834302864129831,0.3860181488203267
6467,0.6467,12,53,12,521087,84523,54794,53162,0.7829393456593426,0.3861132294730726
6468,0.6468,13,53,13,521140,84470,54807,53149,0.7824484049057023,0.386203939862955
6469,0.6469,15,52,15,521192,84418,54822,53134,0.7819667271851495,0.3862830056996627
6470,0.647,17,37,17,521229,84381,54839,53117,0.78162399496091,0.38631107361561623
6471,0.6471,11,72,11,521301,84309,54850,53106,0.7809570565786061,0.38646435978604954
6472,0.6472,17,67,17,521368,84242,54867,53089,0.78033643336174,0.3865769564045991
6473,0.6473,21,51,21,521419,84191,54888,53068,0.7798640186742747,0.3866267421444131
6474,0.6474,20,58,20,521477,84133,54908,53048,0.7793267627551965,0.38670078217829
6475,0.6475,13,65,13,521542,84068,54921,53035,0.7787246656045055,0.38682596296215255
6476,0.6476,17,63,17,521605,84005,54938,53018,0.7781410945199896,0.3869277420579027
6477,0.6477,17,50,17,521655,83955,54955,53001,0.7776779428656119,0.386992902830106
6478,0.6478,12,49,12,521704,83906,54967,52989,0.7772240542443217,0.38707768727857117
6479,0.6479,21,48,21,521752,83858,54988,52968,0.7767794286561192,0.3871194071302238
6480,0.648,20,57,20,521809,83801,55008,52948,0.7762514357701286,0.38719113119657184
6481,0.6481,22,49,22,521858,83752,55030,52926,0.7757975471488384,0.3872313027700142
6482,0.6482,19,57,19,521915,83695,55049,52907,0.7752695542628478,0.387307652889416
6483,0.6483,29,55,29,521970,83640,55078,52878,0.7747600874430324,0.38733353843449214
6484,0.6484,20,57,20,522027,83583,55098,52858,0.7742320945570418,0.38740554525399257
6485,0.6485,24,45,24,522072,83538,55122,52834,0.7738152580681018,0.3874255712316311
6486,0.6486,22,45,22,522117,83493,55144,52812,0.7733984215791618,0.38745460548035654
6487,0.6487,10,53,10,522170,83440,55154,52802,0.7729074808255215,0.38756037051716796
6488,0.6488,10,47,10,522217,83393,55164,52792,0.7724721182704065,0.3876491537247127
6489,0.6489,20,43,20,522260,83350,55184,52772,0.7720738078476417,0.3876816385301421
6490,0.649,17,57,17,522317,83293,55201,52755,0.7715458149616511,0.38776755262848406
6491,0.6491,14,52,14,522369,83241,55215,52741,0.7710641372410982,0.38785280404759453
6492,0.6492,18,55,18,522424,83186,55233,52723,0.7705546704212828,0.3879286875777174
6493,0.6493,20,40,20,522464,83146,55253,52703,0.7701841490977805,0.3879528005358891
6494,0.6494,16,50,16,522514,83096,55269,52687,0.7697209974434028,0.38802353755624786
6495,0.6495,15,62,15,522576,83034,55284,52672,0.7691466893919745,0.38813317023565647
6496,0.6496,23,64,23,522640,82970,55307,52649,0.768553855274371,0.3882125660858729
6497,0.6497,12,41,12,522681,82929,55319,52637,0.7681740709177813,0.38827582137114025
6498,0.6498,17,58,17,522739,82871,55336,52620,0.7676368149987032,0.3883652788746116
6499,0.6499,18,51,18,522790,82820,55354,52602,0.7671644003112379,0.38843024028592105
6500,0.65,11,52,11,522842,82768,55365,52591,0.766682722590685,0.3885297615969385
6501,0.6501,15,58,15,522900,82710,55380,52576,0.766145466671607,0.38862853510341056
6502,0.6502,19,44,19,522944,82666,55399,52557,0.7657378932157546,0.3886690873593989
6503,0.6503,15,46,15,522990,82620,55414,52542,0.765311793693727,0.38873351977626847
6504,0.6504,22,55,22,523045,82565,55436,52520,0.7648023268739116,0.388792241921753
6505,0.6505,19,52,19,523097,82513,55455,52501,0.7643206491533587,0.388855970491949
6506,0.6506,17,48,17,523145,82465,55472,52484,0.7638760235651562,0.38891729468169456
6507,0.6507,14,60,14,523205,82405,55486,52470,0.763320241579903,0.38902687673772013
6508,0.6508,13,43,13,523248,82362,55499,52457,0.7629219311571381,0.3890920419228744
6509,0.6509,19,50,19,523298,82312,55518,52438,0.7624587795027604,0.3891502782931354
6510,0.651,13,54,13,523352,82258,55531,52425,0.7619585757160324,0.38924734376276143
6511,0.6511,21,52,21,523404,82206,55552,52404,0.7614768979954797,0.3893024292400267
6512,0.6512,12,51,12,523455,82155,55564,52392,0.7610044833080144,0.38939552721353876
6513,0.6513,24,40,24,523495,82115,55588,52368,0.7606339619845122,0.3894023779957318
6514,0.6514,12,41,12,523536,82074,55600,52356,0.7602541776279225,0.3894666369114037
6515,0.6515,11,50,11,523586,82024,55611,52345,0.7597910259735448,0.38956158042405614
6516,0.6516,12,43,12,523629,81981,55623,52333,0.7593927155507799,0.3896317584168441
6517,0.6517,16,53,16,523682,81928,55639,52317,0.7589017747971396,0.389712838466982
6518,0.6518,14,54,14,523736,81874,55653,52303,0.7584015710104116,0.38980600251906067
6519,0.6519,10,60,10,523796,81814,55663,52293,0.7578457890251584,0.389934902726927
6520,0.652,21,39,21,523835,81775,55684,52272,0.7574845307347438,0.38995277775705534
6521,0.6521,23,42,23,523877,81733,55707,52249,0.7570954833450665,0.38997029451717397
6522,0.6522,25,60,25,523937,81673,55732,52224,0.7565397013598133,0.3900311433415237
6523,0.6523,14,55,14,523992,81618,55746,52210,0.7560302345399977,0.39012762650566396
6524,0.6524,15,46,15,524038,81572,55761,52195,0.7556041350179703,0.3901933959795764
6525,0.6525,14,53,14,524091,81519,55775,52181,0.7551131942643299,0.39028421839940164
6526,0.6526,15,59,15,524150,81460,55790,52166,0.7545666753121643,0.39038809812461644
6527,0.6527,12,71,12,524221,81389,55802,52154,0.7539089999629479,0.3905408744748882
6528,0.6528,15,52,15,524273,81337,55817,52139,0.7534273222423951,0.3906245317510264
6529,0.6529,12,60,12,524333,81277,55829,52127,0.7528715402571418,0.39074540493538423
6530,0.653,15,38,15,524371,81239,55844,52112,0.7525195449998148,0.3907882205607757
6531,0.6531,19,53,19,524424,81186,55863,52093,0.7520286042461743,0.3908567741354602
6532,0.6532,18,64,18,524488,81122,55881,52075,0.7514357701285709,0.3909622589097352
6533,0.6533,19,62,19,524550,81060,55900,52056,0.7508614620771425,0.39105742360046875
6534,0.6534,11,53,11,524603,81007,55911,52045,0.7503705213235021,0.3911628536211406
6535,0.6535,15,53,15,524656,80954,55926,52030,0.7498795805698618,0.39125007519701616
6536,0.6536,15,42,15,524698,80912,55941,52015,0.7494905331801845,0.39130500199357543
6537,0.6537,17,57,17,524755,80855,55958,51998,0.748962540294194,0.39139500048926257
6538,0.6538,18,47,18,524802,80808,55976,51980,0.7485271777390788,0.3914510347320541
6539,0.6539,20,72,20,524874,80736,55996,51960,0.747860239356775,0.39157171278712244
6540,0.654,19,51,19,524925,80685,56015,51941,0.7473878246693098,0.391635124334595
6541,0.6541,17,41,17,524966,80644,56032,51924,0.74700804031272,0.3916782330577515
6542,0.6542,16,57,16,525023,80587,56048,51908,0.7464800474267294,0.39177327446318727
6543,0.6543,14,58,14,525081,80529,56062,51894,0.7459427915076513,0.3918805645544958
6544,0.6544,25,60,25,525141,80469,56087,51869,0.745387009522398,0.3919433571612084
6545,0.6545,12,57,12,525198,80412,56099,51857,0.7448590166364074,0.39205709576695974
6546,0.6546,18,50,18,525248,80362,56117,51839,0.7443958649820297,0.39212260119061126
6547,0.6547,25,49,25,525297,80313,56142,51814,0.7439419763607396,0.3921530043064627
6548,0.6548,21,44,21,525341,80269,56163,51793,0.7435344029048871,0.3921870030743136
6549,0.6549,20,50,20,525391,80219,56183,51773,0.7430712512505094,0.39224346930116977
6550,0.655,22,55,22,525446,80164,56205,51751,0.742561784430694,0.3923056513664102
6551,0.6551,19,65,19,525511,80099,56224,51732,0.7419596872800029,0.3924114965372333
6552,0.6552,18,66,18,525577,80033,56242,51714,0.7413483270962243,0.39252506698444745
6553,0.6553,15,52,15,525629,79981,56257,51699,0.7408666493756716,0.39261087484811663
6554,0.6554,19,54,19,525683,79927,56276,51680,0.7403664455889436,0.3926842797115655
6555,0.6555,12,52,12,525735,79875,56288,51668,0.7398847678683909,0.39278410861847457
6556,0.6556,20,42,20,525777,79833,56308,51648,0.7394957204787136,0.3928172131334565
6557,0.6557,19,50,19,525827,79783,56327,51629,0.7390325688243359,0.3928788847289441
6558,0.6558,18,43,18,525870,79740,56345,51611,0.738634258401571,0.3929243020608903
6559,0.6559,17,40,17,525910,79700,56362,51594,0.7382637370780688,0.3929654058829802
6560,0.656,17,54,17,525964,79646,56379,51577,0.7377635332913409,0.39304847473385
6561,0.6561,13,52,13,526016,79594,56392,51564,0.7372818555707881,0.3931441467542963
6562,0.6562,11,51,11,526067,79543,56403,51553,0.7368094408833228,0.3932461707451028
6563,0.6563,23,42,23,526109,79501,56426,51530,0.7364203934936455,0.39326571574665536
6564,0.6564,16,40,16,526149,79461,56442,51514,0.7360498721701434,0.39331170070624166
6565,0.6565,15,48,15,526197,79413,56457,51499,0.7356052465819408,0.3933863969689562
6566,0.6566,9,58,9,526255,79355,56466,51490,0.7350679906628627,0.3935190492567542
6567,0.6567,16,50,16,526305,79305,56482,51474,0.7346048390084849,0.3935953019980272
6568,0.6568,17,46,17,526351,79259,56499,51457,0.7341787394864574,0.3936549466017932
6569,0.6569,13,47,13,526398,79212,56512,51444,0.7337433769313424,0.39373622336517267
6570,0.657,25,59,25,526457,79153,56537,51419,0.7331968579791767,0.3937980577765524
6571,0.6571,11,48,11,526505,79105,56548,51408,0.7327522323909741,0.3938917962195337
6572,0.6572,19,47,19,526552,79058,56567,51389,0.7323168698358591,0.3939454337777028
6573,0.6573,10,53,10,526605,79005,56577,51379,0.7318259290822187,0.39405908700454045
6574,0.6574,15,57,15,526662,78948,56592,51364,0.7312979361962281,0.39416170421757013
6575,0.6575,25,46,25,526708,78902,56617,51339,0.7308718366742006,0.3941846269607881
6576,0.6576,20,59,20,526767,78843,56637,51319,0.7303253177220349,0.39427021711405785
6577,0.6577,15,53,15,526820,78790,56652,51304,0.7298343769683945,0.3943610005073255
6578,0.6578,16,62,16,526882,78728,56668,51288,0.7292600689169662,0.3944745262121585
6579,0.6579,16,41,16,526923,78687,56684,51272,0.7288802845603765,0.3945244269346486
6580,0.658,17,53,17,526976,78634,56701,51255,0.728389343806736,0.3946061637244108
6581,0.6581,15,53,15,527029,78581,56716,51240,0.7278984030530957,0.3946973139938839
6582,0.6582,27,55,27,527084,78526,56743,51213,0.7273889362332803,0.39473866763270876
6583,0.6583,24,60,24,527144,78466,56767,51189,0.726833154248027,0.39480930160811384
6584,0.6584,20,51,20,527195,78415,56787,51169,0.7263607395605617,0.39487128040498826
6585,0.6585,23,48,23,527243,78367,56810,51146,0.7259161139723591,0.3949101634584945
6586,0.6586,16,56,16,527299,78311,56826,51130,0.7253973841194561,0.3950062190496056
6587,0.6587,25,52,25,527351,78259,56851,51105,0.7249157063989032,0.3950480813827649
6588,0.6588,24,59,24,527410,78200,56875,51081,0.7243691874467375,0.3951160650056853
6589,0.6589,19,37,19,527447,78163,56894,51062,0.7240264552224981,0.3951402592377636
6590,0.659,19,52,19,527499,78111,56913,51043,0.7235447775019452,0.3952103690168326
6591,0.6591,18,52,18,527551,78059,56931,51025,0.7230630997813924,0.395285240618512
6592,0.6592,14,50,14,527601,78009,56945,51011,0.7225999481270147,0.39537281041698963
6593,0.6593,15,44,15,527645,77965,56960,50996,0.7221923746711624,0.39543738029326697
6594,0.6594,18,47,18,527692,77918,56978,50978,0.7217570121160473,0.39549714498510424
6595,0.6595,13,51,13,527743,77867,56991,50965,0.721284597428582,0.3955927098857427
6596,0.6596,17,43,17,527786,77824,57008,50948,0.7208862870058171,0.3956450159972665
6597,0.6597,23,52,23,527838,77772,57031,50925,0.7204046092852644,0.3956968693908949
6598,0.6598,11,51,11,527889,77721,57042,50914,0.7199321945977991,0.39580207564037784
6599,0.6599,27,62,27,527951,77659,57069,50887,0.7193578865463708,0.39586607128965506
6600,0.66,20,52,20,528003,77607,57089,50867,0.7188762088258179,0.39593225088344725
6601,0.6601,13,55,13,528058,77552,57102,50854,0.7183667420060025,0.3960406834571593
6602,0.6602,17,49,17,528107,77503,57119,50837,0.7179128533847123,0.3961118902914134
6603,0.6603,17,46,17,528153,77457,57136,50820,0.7174867538626848,0.3961739049089081
6604,0.6604,21,56,21,528209,77401,57157,50799,0.7169680240097818,0.39624804992199686
6605,0.6605,19,51,19,528260,77350,57176,50780,0.7164956093223165,0.396316241317412
6606,0.6606,16,51,16,528311,77299,57192,50764,0.7160231946348512,0.39639864754066356
6607,0.6607,12,42,12,528353,77257,57204,50752,0.7156341472451739,0.39647212305384777
6608,0.6608,15,49,15,528402,77208,57219,50737,0.7151802586238838,0.39655320645589903
6609,0.6609,23,63,23,528465,77145,57242,50714,0.7145966875393679,0.3966400488037604
6610,0.661,19,58,19,528523,77087,57261,50695,0.7140594316202897,0.3967303689095491
6611,0.6611,16,54,16,528577,77033,57277,50679,0.7135592278335618,0.3968225382109747
6612,0.6612,18,50,18,528627,76983,57295,50661,0.7130960761791841,0.39689292093635425
6613,0.6613,21,48,21,528675,76935,57316,50640,0.7126514505909816,0.3969429747207525
6614,0.6614,16,49,16,528724,76886,57332,50624,0.7121975619696913,0.39701984158105247
6615,0.6615,13,55,13,528779,76831,57345,50611,0.7116880951498759,0.39712967467553867
6616,0.6616,16,48,16,528827,76783,57361,50595,0.7112434695616733,0.3972035987376156
6617,0.6617,12,47,12,528874,76736,57373,50583,0.7108081070065583,0.39729341260927276
6618,0.6618,14,66,14,528940,76670,57387,50569,0.7101967468227797,0.39743317693474484
6619,0.6619,18,38,18,528978,76632,57405,50551,0.7098447515654526,0.39746664255442943
6620,0.662,16,53,16,529031,76579,57421,50535,0.7093538108118123,0.3975565240650125
6621,0.6621,11,60,11,529091,76519,57432,50524,0.708798028826559,0.39769211999086923
6622,0.6622,27,43,27,529134,76476,57459,50497,0.7083997184037941,0.3976987233506336
6623,0.6623,13,41,13,529175,76435,57472,50484,0.7080199340472044,0.3977655039828552
6624,0.6624,12,45,12,529220,76390,57484,50472,0.7076030975582644,0.3978496318834639
6625,0.6625,24,52,24,529272,76338,57508,50448,0.7071214198377117,0.3978988216364583
6626,0.6626,15,43,15,529315,76295,57523,50433,0.7067231094149469,0.3979625654946026
6627,0.6627,15,58,15,529373,76237,57538,50418,0.7061858534958687,0.3980735067703604
6628,0.6628,22,43,22,529416,76194,57560,50396,0.7057875430731039,0.39810411564894543
6629,0.6629,8,54,8,529470,76140,57568,50388,0.7052873392863759,0.3982359635811836
6630,0.663,21,49,21,529519,76091,57589,50367,0.7048334506650857,0.39829034145724274
6631,0.6631,10,58,10,529577,76033,57599,50357,0.7042961947460077,0.3984255083471794
6632,0.6632,18,49,18,529626,75984,57617,50339,0.7038423061247174,0.39849433594832295
6633,0.6633,26,49,26,529675,75935,57643,50313,0.7033884175034273,0.39852512515049743
6634,0.6634,12,37,12,529712,75898,57655,50301,0.7030456852791879,0.39858477483973725
6635,0.6635,14,51,14,529763,75847,57669,50287,0.7025732705917226,0.3986791824567523
6636,0.6636,21,58,21,529821,75789,57690,50266,0.7020360146726444,0.39876244496449964
6637,0.6637,18,49,18,529870,75740,57708,50248,0.7015821260513543,0.3988316347588659
6638,0.6638,19,38,19,529908,75702,57727,50229,0.7012301307940272,0.39886128117778785
6639,0.6639,15,60,15,529968,75642,57742,50214,0.700674348808774,0.3989797864225782
6640,0.664,11,48,11,530016,75594,57753,50203,0.7002297232205713,0.39907946930371946
6641,0.6641,19,63,19,530079,75531,57772,50184,0.6996461521360554,0.3991886409736308
6642,0.6642,20,48,20,530127,75483,57792,50164,0.6992015265478528,0.39924550526474967
6643,0.6643,17,53,17,530180,75430,57809,50147,0.6987105857942124,0.39933268034751584
6644,0.6644,20,40,20,530220,75390,57829,50127,0.6983400644707103,0.3993642295465953
6645,0.6645,14,50,14,530270,75340,57843,50113,0.6978769128163326,0.3994563701147043
6646,0.6646,14,42,14,530312,75298,57857,50099,0.6974878654266553,0.3995231145880683
6647,0.6647,26,43,26,530355,75255,57883,50073,0.6970895550038905,0.399535618536959
6648,0.6648,20,45,20,530400,75210,57903,50053,0.6966727185149505,0.399583276785643
6649,0.6649,14,40,14,530440,75170,57917,50039,0.6963021971914484,0.3996437955738006
6650,0.665,13,65,13,530505,75105,57930,50026,0.6957001000407573,0.39978902110588105
6651,0.6651,21,55,21,530560,75050,57951,50005,0.6951906332209419,0.399864059813682
6652,0.6652,10,54,10,530614,74996,57961,49995,0.6946904294342139,0.3999887991935419
6653,0.6653,17,45,17,530659,74951,57978,49978,0.694273592945274,0.40005122909812774
6654,0.6654,19,52,19,530711,74899,57997,49959,0.6937919152247212,0.4001265437537042
6655,0.6655,19,50,19,530761,74849,58016,49940,0.6933287635703435,0.4001955300547324
6656,0.6656,21,53,21,530814,74796,58037,49919,0.6928378228167031,0.4002646032955138
6657,0.6657,22,51,22,530865,74745,58059,49897,0.6923654081292379,0.40032252370789945
6658,0.6658,18,58,18,530923,74687,58077,49879,0.6918281522101597,0.4004222661079267
6659,0.6659,20,56,20,530979,74631,58097,49859,0.6913094223572567,0.4005060647441562
6660,0.666,14,68,14,531047,74563,58111,49845,0.6906795361073029,0.40065751398623883
6661,0.6661,13,52,13,531099,74511,58124,49832,0.6901978583867502,0.4007624072123079
6662,0.6662,20,49,20,531148,74462,58144,49812,0.68974396976546,0.40082398570899785
6663,0.6663,18,47,18,531195,74415,58162,49794,0.6893086072103449,0.4008888244813178
6664,0.6664,21,49,21,531244,74366,58183,49773,0.6888547185890548,0.4009457140785732
6665,0.6665,16,63,16,531307,74303,58199,49757,0.6882711475045389,0.4010720619055296
6666,0.6666,15,49,15,531356,74254,58214,49742,0.6878172588832487,0.401158101874254
6667,0.6667,19,35,19,531391,74219,58233,49723,0.6874930527251844,0.40117958399896725
6668,0.6668,26,61,26,531452,74158,58259,49697,0.6869280077068435,0.40125146340478784
6669,0.6669,22,47,22,531499,74111,58281,49675,0.6864926451517285,0.4012974003522208
6670,0.667,14,44,14,531543,74067,58295,49661,0.6860850716958761,0.40137236518815467
6671,0.6671,19,53,19,531596,74014,58314,49642,0.6855941309422358,0.4014524163809277
6672,0.6672,26,59,26,531655,73955,58340,49616,0.68504761199007,0.4015181555542967
6673,0.6673,13,55,13,531710,73900,58353,49603,0.6845381451702546,0.40163396840562576
6674,0.6674,18,51,18,531761,73849,58371,49585,0.6840657304827893,0.40171265615632645
6675,0.6675,13,45,13,531806,73804,58384,49572,0.6836488939938493,0.4017961353909999
6676,0.6676,19,52,19,531858,73752,58403,49553,0.6831672162732966,0.4018734033494181
6677,0.6677,13,48,13,531906,73704,58416,49540,0.6827225906850939,0.4019668300282367
6678,0.6678,16,55,16,531961,73649,58432,49524,0.6822131238652784,0.40206863517166913
6679,0.6679,12,60,12,532021,73589,58444,49512,0.6816573418800252,0.40220631838896514
6680,0.668,18,42,18,532063,73547,58462,49494,0.6812682944903479,0.40225615851626695
6681,0.6681,25,50,25,532113,73497,58487,49469,0.6808051428359702,0.40229819624936974
6682,0.6682,23,50,23,532163,73447,58510,49446,0.6803419911815926,0.40235001179888197
6683,0.6683,18,52,18,532215,73395,58528,49428,0.6798603134610397,0.4024327691067634
6684,0.6684,12,58,12,532273,73337,58540,49416,0.6793230575419615,0.4025644994419688
6685,0.6685,14,60,14,532333,73277,58554,49402,0.6787672755567082,0.40269320747642223
6686,0.6686,22,51,22,532384,73226,58576,49380,0.6782948608692431,0.40275353571603345
6687,0.6687,19,48,19,532432,73178,58595,49361,0.6778502352810404,0.40281869445645874
6688,0.6688,17,52,17,532484,73126,58612,49344,0.6773685575604876,0.4029068343267739
6689,0.6689,19,49,19,532533,73077,58631,49325,0.6769146689391975,0.402975441577752
6690,0.669,12,63,12,532596,73014,58643,49313,0.6763310978546815,0.40312441243552116
6691,0.6691,26,56,26,532652,72958,58669,49287,0.6758123680017785,0.40318213423861915
6692,0.6692,28,44,28,532696,72914,58697,49259,0.6754047945459262,0.40319055765185435
6693,0.6693,6,45,6,532741,72869,58703,49253,0.6749879580569862,0.4033098049491492
6694,0.6694,13,54,13,532795,72815,58716,49240,0.6744877542702582,0.40342468559256073
6695,0.6695,16,56,16,532851,72759,58732,49224,0.6739690244173552,0.403531639654706
6696,0.6696,19,61,19,532912,72698,58751,49205,0.6734039793990144,0.40364059949303954
6697,0.6697,15,58,15,532970,72640,58766,49190,0.6728667234799363,0.4037593367807601
6698,0.6698,20,44,20,533014,72596,58786,49170,0.6724591500240839,0.4038073025310842
6699,0.6699,16,44,16,533058,72552,58802,49154,0.6720515765682316,0.40387491167239087
6700,0.67,12,45,12,533103,72507,58814,49142,0.6716347400792916,0.403965507320241
6701,0.6701,21,65,21,533168,72442,58835,49121,0.6710326429286005,0.40407854363581025
6702,0.6702,20,47,20,533215,72395,58855,49101,0.6705972803734855,0.404136761704089
6703,0.6703,14,30,14,533245,72365,58869,49087,0.6703193893808589,0.4041679017224912
6704,0.6704,13,51,13,533296,72314,58882,49074,0.6698469746933936,0.4042738985731703
6705,0.6705,18,36,18,533332,72278,58900,49056,0.6695135055022416,0.40430547084906127
6706,0.6706,19,42,19,533374,72236,58919,49037,0.6691244581125644,0.40435216412556796
6707,0.6707,22,45,22,533419,72191,58941,49015,0.6687076216236244,0.4043941719056812
6708,0.6708,21,45,21,533464,72146,58962,48994,0.6682907851346845,0.4044411424797755
6709,0.6709,23,53,23,533517,72093,58985,48971,0.6677998443810441,0.4045050551774268
6710,0.671,13,56,13,533573,72037,58998,48958,0.6672811145281411,0.4046282904252242
6711,0.6711,16,53,16,533626,71984,59014,48942,0.6667901737745007,0.4047268577477135
6712,0.6712,21,44,21,533670,71940,59035,48921,0.6663826003186484,0.40477076972720727
6713,0.6713,17,41,17,533711,71899,59052,48904,0.6660028159620586,0.4048243835004098
6714,0.6714,16,42,16,533753,71857,59068,48888,0.6656137685723813,0.40488633069692326
6715,0.6715,21,45,21,533798,71812,59089,48867,0.6651969320834414,0.40493374986534525
6716,0.6716,22,49,22,533847,71763,59111,48845,0.6647430434621513,0.4049897187582913
6717,0.6717,12,41,12,533888,71722,59123,48833,0.6643632591055615,0.4050682261208577
6718,0.6718,18,39,18,533927,71683,59141,48815,0.6640020008151469,0.40511045826486747
6719,0.6719,22,47,22,533974,71636,59163,48793,0.6635666382600318,0.4051598867382441
6720,0.672,29,48,29,534022,71588,59192,48764,0.6631220126718292,0.4051781441106089
6721,0.6721,18,57,18,534079,71531,59210,48746,0.6625940197858387,0.40528114269561094
6722,0.6722,17,56,17,534135,71475,59227,48729,0.6620752899329356,0.4053858440650894
6723,0.6723,28,54,28,534189,71421,59255,48701,0.6615750861462077,0.40542948002863755
6724,0.6724,15,40,15,534229,71381,59270,48686,0.6612045648227055,0.405490267933737
6725,0.6725,17,48,17,534277,71333,59287,48669,0.6607599392345029,0.4055682405293245
6726,0.6726,21,38,21,534315,71295,59308,48648,0.6604079439771758,0.4055926565118431
6727,0.6727,12,48,12,534363,71247,59320,48636,0.6599633183889733,0.40569555316433525
6728,0.6728,16,49,16,534412,71198,59336,48620,0.6595094297676831,0.40578210285599825
6729,0.6729,11,41,11,534453,71157,59347,48609,0.6591296454110934,0.4058664395571364
6730,0.673,24,46,24,534499,71111,59371,48585,0.6587035458890659,0.4059032883304371
6731,0.6731,21,44,21,534543,71067,59392,48564,0.6582959724332136,0.40594829099480906
6732,0.6732,16,54,16,534597,71013,59408,48548,0.6577957686464856,0.4060521407482373
6733,0.6733,18,57,18,534654,70956,59426,48530,0.657267775760495,0.40615636978390773
6734,0.6734,25,48,25,534702,70908,59451,48505,0.6568231501722924,0.4061953053687622
6735,0.6735,22,58,22,534760,70850,59473,48483,0.6562858942532143,0.40628325777446306
6736,0.6736,24,60,24,534820,70790,59497,48459,0.6557301122679611,0.4063681875739
6737,0.6737,25,45,25,534865,70745,59522,48434,0.6553132757790211,0.40639710016026315
6738,0.6738,12,52,12,534917,70693,59534,48422,0.6548315980584682,0.4065147126726273
6739,0.6739,16,51,16,534968,70642,59550,48406,0.654359183371003,0.4066090988508837
6740,0.674,12,41,12,535009,70601,59562,48394,0.6539793990144133,0.4066893566956595
6741,0.6741,19,44,19,535053,70557,59581,48375,0.6535718255585609,0.4067450307738876
6742,0.6742,17,43,17,535096,70514,59598,48358,0.653173515135796,0.4068073221616529
6743,0.6743,14,42,14,535138,70472,59612,48344,0.6527844677461188,0.4068812281174253
6744,0.6744,20,59,20,535197,70413,59632,48324,0.6522379487939531,0.40698350135172695
6745,0.6745,20,51,20,535248,70362,59652,48304,0.6517655341064879,0.40705846662059897
6746,0.6746,18,48,18,535296,70314,59670,48286,0.6513209085182853,0.4071332209106239
6747,0.6747,21,44,21,535340,70270,59691,48265,0.6509133350624329,0.4071793141266293
6748,0.6748,18,60,18,535400,70210,59709,48247,0.6503575530771796,0.40729547430713253
6749,0.6749,8,50,8,535450,70160,59717,48239,0.6498944014228019,0.40742742759651684
6750,0.675,21,52,21,535502,70108,59738,48218,0.6494127237022491,0.40750130994033434
6751,0.6751,9,44,9,535546,70064,59747,48209,0.6490051502463967,0.4076078225799633
6752,0.6752,18,51,18,535597,70013,59765,48191,0.6485327355589314,0.40769347907008224
6753,0.6753,14,40,14,535637,69973,59779,48177,0.6481622142354293,0.4077613203554803
6754,0.6754,18,46,18,535683,69927,59797,48159,0.6477361147134018,0.40782988669274933
6755,0.6755,19,47,19,535730,69880,59816,48140,0.6473007521582868,0.4078969666158278
6756,0.6756,19,45,19,535775,69835,59835,48121,0.6468839156693468,0.40795720438129474
6757,0.6757,21,50,21,535825,69785,59856,48100,0.6464207640149691,0.40802476990287145
6758,0.6758,13,36,13,535861,69749,59869,48087,0.6460872948238171,0.40808411690824536
6759,0.6759,16,50,16,535911,69699,59885,48071,0.6456241431694394,0.40817695508193935
6760,0.676,15,33,15,535944,69666,59900,48056,0.6453184630775501,0.40821596642938446
6761,0.6761,15,46,15,535990,69620,59915,48041,0.6448923635555226,0.4083001164362023
6762,0.6762,20,41,20,536031,69579,59935,48021,0.6445125791989329,0.4083418367346939
6763,0.6763,19,49,19,536080,69530,59954,48002,0.6440586905776428,0.40841643126978183
6764,0.6764,14,44,14,536124,69486,59968,47988,0.6436511171217904,0.40849890188467236
6765,0.6765,21,42,21,536166,69444,59989,47967,0.6432620697321131,0.40853923397296676
6766,0.6766,21,64,21,536230,69380,60010,47946,0.6426692356145096,0.40865622283210884
6767,0.6767,9,55,9,536285,69325,60019,47937,0.6421597687946942,0.40880251061725026
6768,0.6768,14,54,14,536339,69271,60033,47923,0.6416595650079662,0.4089202518900285
6769,0.6769,17,44,17,536383,69227,60050,47906,0.6412519915521139,0.40898807338666304
6770,0.677,19,48,19,536431,69179,60069,47887,0.6408073659639112,0.40905984658226985
6771,0.6771,15,44,15,536475,69135,60084,47872,0.6403997925080588,0.40913791482560874
6772,0.6772,15,43,15,536518,69092,60099,47857,0.6400014820852941,0.40921256274102386
6773,0.6773,16,43,16,536561,69049,60115,47841,0.6396031716625292,0.4092822311574985
6774,0.6774,18,49,18,536610,69000,60133,47823,0.639149283041239,0.4093628823091343
6775,0.6775,18,43,18,536653,68957,60151,47805,0.6387509726184742,0.40942258611534577
6776,0.6776,20,48,20,536701,68909,60171,47785,0.6383063470302716,0.4094897766808919
6777,0.6777,19,59,19,536760,68850,60190,47766,0.6377598280781059,0.4096007408931879
6778,0.6778,24,44,24,536804,68806,60214,47742,0.6373522546222535,0.4096337989497889
6779,0.6779,19,56,19,536860,68750,60233,47723,0.6368335247693505,0.40973444489280775
6780,0.678,19,45,19,536905,68705,60252,47704,0.6364166882804105,0.4097964933982768
6781,0.6781,17,46,17,536951,68659,60269,47687,0.635990588758383,0.4098722775170612
6782,0.6782,16,51,16,537002,68608,60285,47671,0.6355181740709178,0.4099708459825076
6783,0.6783,23,39,23,537041,68569,60308,47648,0.6351569157805032,0.40999165354466216
6784,0.6784,22,40,22,537081,68529,60330,47626,0.634786394457001,0.41002109250570357
6785,0.6785,19,49,19,537130,68480,60349,47607,0.6343325058357109,0.4100975992143823
6786,0.6786,9,48,9,537178,68432,60358,47598,0.6338878802475082,0.4102214944410928
6787,0.6787,10,30,10,537208,68402,60368,47588,0.6336099892548817,0.41027674799551683
6788,0.6788,18,58,18,537266,68344,60386,47570,0.6330727333358035,0.4103904618941629
6789,0.6789,22,40,22,537306,68304,60408,47548,0.6327022120123013,0.4104201912785278
6790,0.679,18,32,18,537338,68272,60426,47530,0.6324057949534996,0.4104419612787344
6791,0.6791,26,47,26,537385,68225,60452,47504,0.6319704323983846,0.4104761987055967
6792,0.6792,17,50,17,537435,68175,60469,47487,0.6315072807440069,0.4105669969393578
6793,0.6793,10,56,10,537491,68119,60479,47477,0.6309885508911037,0.4107149036298834
6794,0.6794,14,53,14,537544,68066,60493,47463,0.6304976101374634,0.41083191233369976
6795,0.6795,23,54,23,537598,68012,60516,47440,0.6299974063507355,0.41090669715552786
6796,0.6796,17,52,17,537650,67960,60533,47423,0.6295157286301827,0.411005087404557
6797,0.6797,14,28,14,537678,67932,60547,47409,0.6292563637037312,0.4110333706140921
6798,0.6798,21,49,21,537727,67883,60568,47388,0.628802475082441,0.41110079725169385
6799,0.6799,19,40,19,537767,67843,60587,47369,0.6284319537589388,0.41114640836024025
6800,0.68,18,43,18,537810,67800,60605,47351,0.628033643336174,0.4112078922458337
6801,0.6801,26,43,26,537853,67757,60631,47325,0.6276353329134091,0.4112285153195113
6802,0.6802,17,50,17,537903,67707,60648,47308,0.6271721812590314,0.4113202625744468
6803,0.6803,16,65,16,537968,67642,60664,47292,0.6265700841083405,0.4114709311430908
6804,0.6804,25,42,25,538010,67600,60689,47267,0.6261810367186632,0.41149329224233244
6805,0.6805,15,54,15,538064,67546,60704,47252,0.6256808329319352,0.41160995836164394
6806,0.6806,23,50,23,538114,67496,60727,47229,0.6252176812775575,0.411671388101983
6807,0.6807,18,46,18,538160,67450,60745,47211,0.6247915817555301,0.41174418503239985
6808,0.6808,17,46,17,538206,67404,60762,47194,0.6243654822335025,0.4118221958498403
6809,0.6809,14,50,14,538256,67354,60776,47180,0.6239023305791248,0.4119300818970786
6810,0.681,24,36,24,538292,67318,60800,47156,0.6235688613879729,0.4119363348882716
6811,0.6811,15,45,15,538337,67273,60815,47141,0.623152024899033,0.41202125613998286
6812,0.6812,21,54,21,538391,67219,60836,47120,0.622651821112305,0.4121078547127402
6813,0.6813,16,52,16,538443,67167,60852,47104,0.6221701433917523,0.41221307243307576
6814,0.6814,24,53,24,538496,67114,60876,47080,0.6216792026381118,0.4122808553864476
6815,0.6815,15,31,15,538527,67083,60891,47065,0.6213920486123976,0.412315590286295
6816,0.6816,15,41,15,538568,67042,60906,47050,0.6210122642558079,0.4123864951092101
6817,0.6817,15,34,15,538602,67008,60921,47035,0.6206973211308311,0.41243215278447604
6818,0.6818,24,48,24,538650,66960,60945,47011,0.6202526955426285,0.4124821226452343
6819,0.6819,16,42,16,538692,66918,60961,46995,0.6198636481529513,0.41255168418003213
6820,0.682,27,56,27,538748,66862,60988,46968,0.6193449183000481,0.4126153035227971
6821,0.6821,22,55,22,538803,66807,61010,46946,0.6188354514802327,0.41270120348474326
6822,0.6822,18,51,18,538854,66756,61028,46928,0.6183630367927674,0.41279335702473524
6823,0.6823,17,43,17,538897,66713,61045,46911,0.6179647263700025,0.4128617193550658
6824,0.6824,14,47,14,538944,66666,61059,46897,0.6175293638148875,0.41296020710971004
6825,0.6825,17,59,17,539003,66607,61076,46880,0.6169828448627218,0.4130869615021985
6826,0.6826,15,58,15,539061,66549,61091,46865,0.6164455889436437,0.413220590050611
6827,0.6827,18,46,18,539107,66503,61109,46847,0.6160194894216162,0.4132951036612263
6828,0.6828,13,46,13,539153,66457,61122,46834,0.6155933898995887,0.41339559188285036
6829,0.6829,8,40,8,539193,66417,61130,46826,0.6152228685760865,0.41350017219607393
6830,0.683,12,47,12,539240,66370,61142,46814,0.6147875060209715,0.41360969748374327
6831,0.6831,15,54,15,539294,66316,61157,46799,0.6142873022342435,0.4137293904433541
6832,0.6832,18,45,18,539339,66271,61175,46781,0.6138704657453037,0.41380072886813146
6833,0.6833,23,55,23,539394,66216,61198,46758,0.6133609989254881,0.4138828402995379
6834,0.6834,26,59,26,539453,66157,61224,46732,0.6128144799733225,0.413964159484095
6835,0.6835,16,49,16,539502,66108,61240,46716,0.6123605913520324,0.414060838119549
6836,0.6836,19,51,19,539553,66057,61259,46697,0.6118881766645671,0.41414938716143107
6837,0.6837,12,45,12,539598,66012,61271,46685,0.6114713401756271,0.4142523758396408
6838,0.6838,23,46,23,539644,65966,61294,46662,0.6110452406535997,0.41430194978158186
6839,0.6839,25,52,25,539696,65914,61319,46637,0.6105635629330468,0.41436326643032934
6840,0.684,18,51,18,539747,65863,61337,46619,0.6100911482455815,0.41445742429899896
6841,0.6841,22,51,22,539798,65812,61359,46597,0.6096187335581162,0.4145308649663283
6842,0.6842,16,34,16,539832,65778,61375,46581,0.6093037904331394,0.4145729314073639
6843,0.6843,17,63,17,539895,65715,61392,46564,0.6087202193486235,0.41471691055317556
6844,0.6844,14,42,14,539937,65673,61406,46550,0.6083311719589463,0.4147991053527352
6845,0.6845,28,47,28,539984,65626,61434,46522,0.6078958094038311,0.41482683596675823
6846,0.6846,11,43,11,540027,65583,61445,46511,0.6074974989810663,0.414928542116438
6847,0.6847,12,47,12,540074,65536,61457,46499,0.6070621364259513,0.4150399428749944
6848,0.6848,22,48,22,540122,65488,61479,46477,0.6066175108377487,0.41510293395257447
6849,0.6849,17,57,17,540179,65431,61496,46460,0.6060895179517581,0.41522553199095547
6850,0.685,19,47,19,540226,65384,61515,46441,0.605654155396643,0.41530069304717193
6851,0.6851,23,48,23,540274,65336,61538,46418,0.6052095298084404,0.4153587343629758
6852,0.6852,25,37,25,540311,65299,61563,46393,0.6048667975842009,0.41536546932636176
6853,0.6853,14,48,14,540359,65251,61577,46379,0.6044221719959983,0.41547075159007435
6854,0.6854,19,43,19,540402,65208,61596,46360,0.6040238615732335,0.41553133514986373
6855,0.6855,21,47,21,540449,65161,61617,46339,0.6035884990181185,0.4155964125560538
6856,0.6856,23,53,23,540502,65108,61640,46316,0.6030975582644781,0.4156734635267088
6857,0.6857,22,47,22,540549,65061,61662,46294,0.6026621957093631,0.4157334650442279
6858,0.6858,17,42,17,540591,65019,61679,46277,0.6022731483196858,0.41580110695802186
6859,0.6859,22,55,22,540646,64964,61701,46255,0.6017636814998704,0.41589116967424633
6860,0.686,22,53,22,540699,64911,61723,46233,0.6012727407462299,0.41597387173396677
6861,0.6861,16,64,16,540763,64847,61739,46217,0.6006799066286265,0.416129438882086
6862,0.6862,21,41,21,540804,64806,61760,46196,0.6003001222720368,0.416172681573305
6863,0.6863,19,43,19,540847,64763,61779,46177,0.5999018118492719,0.41623400036055525
6864,0.6864,12,45,12,540892,64718,61791,46165,0.599484975360332,0.4163397454975064
6865,0.6865,13,34,13,540926,64684,61804,46152,0.5991700322353551,0.41639900393373996
6866,0.6866,19,57,19,540983,64627,61823,46133,0.5986420393493646,0.41651318165402673
6867,0.6867,18,52,18,541035,64575,61841,46115,0.5981603616288117,0.41661396693468244
6868,0.6868,18,40,18,541075,64535,61859,46097,0.5977898403053096,0.4166696796586883
6869,0.6869,15,45,15,541120,64490,61874,46082,0.5973730038163696,0.4167601201027385
6870,0.687,16,56,16,541176,64434,61890,46066,0.5968542739634666,0.4168868778280543
6871,0.6871,19,45,19,541221,64389,61909,46047,0.5964374374745267,0.41695642725198306
6872,0.6872,19,46,19,541267,64343,61928,46028,0.5960113379524992,0.4170298357358364
6873,0.6873,21,40,21,541307,64303,61949,46007,0.595640816628997,0.4170700752424984
6874,0.6874,15,43,15,541350,64260,61964,45992,0.5952425062062322,0.41715343032325947
6875,0.6875,8,42,8,541392,64218,61972,45984,0.5948534588165549,0.4172701039908532
6876,0.6876,17,44,17,541436,64174,61989,45967,0.5944458853607025,0.41734685539444893
6877,0.6877,13,49,13,541485,64125,62002,45954,0.5939919967394124,0.41746382143733135
6878,0.6878,13,49,13,541534,64076,62015,45941,0.5935381081181222,0.4175809193124699
6879,0.6879,19,39,19,541573,64037,62034,45922,0.5931768498277076,0.41762838876308445
6880,0.688,18,51,18,541624,63986,62052,45904,0.5927044351402423,0.41772681772681775
6881,0.6881,10,40,10,541664,63946,62062,45894,0.5923339138167402,0.4178259286234523
6882,0.6882,14,34,14,541698,63912,62076,45880,0.5920189706917633,0.4178810842320023
6883,0.6883,17,45,17,541743,63867,62093,45863,0.5916021342028234,0.4179622710288891
6884,0.6884,23,41,23,541784,63826,62116,45840,0.5912223498462337,0.41799646198457135
6885,0.6885,13,46,13,541830,63780,62129,45827,0.5907962503242061,0.4181028583940807
6886,0.6886,21,35,21,541865,63745,62150,45806,0.5904720441661417,0.4181248916029977
6887,0.6887,16,44,16,541909,63701,62166,45790,0.5900644707102893,0.418207889232905
6888,0.6888,13,43,13,541952,63658,62179,45777,0.5896661602875245,0.41830310229816786
6889,0.6889,18,46,18,541998,63612,62197,45759,0.5892400607654971,0.4183833008750034
6890,0.689,13,53,13,542051,63559,62210,45746,0.5887491200118566,0.41851699373313206
6891,0.6891,12,48,12,542099,63511,62222,45734,0.5883044944236541,0.4186370085587441
6892,0.6892,17,43,17,542142,63468,62239,45717,0.5879061840008892,0.4187113614507487
6893,0.6893,30,42,30,542184,63426,62269,45687,0.587517136611212,0.4187127106760881
6894,0.6894,19,48,19,542232,63378,62288,45668,0.5870725110230094,0.41879573757863653
6895,0.6895,20,50,20,542282,63328,62308,45648,0.5866093593686317,0.41888122155336954
6896,0.6896,13,49,13,542331,63279,62321,45635,0.5861554707473415,0.41900031217290706
6897,0.6897,23,46,23,542377,63233,62344,45612,0.585729371225314,0.41905461895355783
6898,0.6898,12,47,12,542424,63186,62356,45600,0.585294008670199,0.419171584578898
6899,0.6899,18,35,18,542459,63151,62374,45582,0.5849698025121346,0.41921035932053746
6900,0.69,18,43,18,542502,63108,62392,45564,0.5845714920893698,0.419280035335689
6901,0.6901,18,42,18,542544,63066,62410,45546,0.5841824446996925,0.4193459286266711
6902,0.6902,17,46,17,542590,63020,62427,45529,0.583756345177665,0.419432698596947
6903,0.6903,15,47,15,542637,62973,62442,45514,0.5833209826225499,0.419534137730788
6904,0.6904,12,40,12,542677,62933,62454,45502,0.5829504612990477,0.41962465993452297
6905,0.6905,20,48,20,542725,62885,62474,45482,0.5825058357108451,0.4197034152463388
6906,0.6906,15,54,15,542779,62831,62489,45467,0.5820056319241173,0.41983231453951136
6907,0.6907,13,57,13,542836,62774,62502,45454,0.5814776390381267,0.4199837380345197
6908,0.6908,14,61,14,542897,62713,62516,45440,0.5809125940197858,0.4201455345667712
6909,0.6909,23,51,23,542948,62662,62539,45417,0.5804401793323206,0.42022039434117636
6910,0.691,16,48,16,542996,62614,62555,45401,0.5799955537441179,0.42032125167800766
6911,0.6911,16,53,16,543049,62561,62571,45385,0.5795046129904776,0.4204417023326478
6912,0.6912,20,54,20,543103,62507,62591,45365,0.5790044092037496,0.42054471966775436
6913,0.6913,9,49,9,543152,62458,62600,45356,0.5785505205824595,0.4206874802901293
6914,0.6914,14,47,14,543199,62411,62614,45342,0.5781151580273445,0.420795708704166
6915,0.6915,16,50,16,543249,62361,62630,45326,0.5776520063729668,0.42090503031935145
6916,0.6916,21,48,21,543297,62313,62651,45305,0.5772073807847642,0.42097976174989316
6917,0.6917,20,51,20,543348,62262,62671,45285,0.5767349660972989,0.42107171748165917
6918,0.6918,18,44,18,543392,62218,62689,45267,0.5763273926414465,0.42114713680978744
6919,0.6919,12,43,12,543435,62175,62701,45255,0.5759290822186817,0.42125104719352136
6920,0.692,9,49,9,543484,62126,62710,45246,0.5754751935973915,0.42139477703684386
6921,0.6921,18,50,18,543534,62076,62728,45228,0.5750120419430138,0.4214940729143368
6922,0.6922,14,39,14,543573,62037,62742,45214,0.5746507836525993,0.42157182683611344
6923,0.6923,18,45,18,543618,61992,62760,45196,0.5742339471636593,0.4216516774265776
6924,0.6924,22,54,22,543672,61938,62782,45174,0.5737337433769314,0.42174546269325563
6925,0.6925,21,35,21,543707,61903,62803,45153,0.5734095372188669,0.42176991481094006
6926,0.6926,22,50,22,543757,61853,62825,45131,0.5729463855644893,0.42184812682270245
6927,0.6927,26,48,26,543805,61805,62851,45105,0.5725017599762866,0.4218969226452156
6928,0.6928,13,50,13,543855,61755,62864,45092,0.5720386083219089,0.4220240156485442
6929,0.6929,17,41,17,543896,61714,62881,45075,0.5716588239653192,0.4220940359025742
6930,0.693,28,35,28,543931,61679,62909,45047,0.5713346178072548,0.4220808425313419
6931,0.6931,20,28,20,543959,61651,62929,45027,0.5710752528808033,0.42208327865164325
6932,0.6932,14,43,14,544002,61608,62943,45013,0.5706769424580385,0.42217761979347407
6933,0.6933,22,40,22,544042,61568,62965,44991,0.5703064211345363,0.42221680008258333
6934,0.6934,17,38,17,544080,61530,62982,44974,0.5699544258772092,0.4222752197100578
6935,0.6935,20,33,20,544113,61497,63002,44954,0.56964874578532,0.4222975829254775
6936,0.6936,23,49,23,544162,61448,63025,44931,0.5691948571640298,0.42236719653315036
6937,0.6937,19,45,19,544207,61403,63044,44912,0.5687780206750899,0.4224427409114424
6938,0.6938,19,35,19,544242,61368,63063,44893,0.5684538145170255,0.42247861397878805
6939,0.6939,17,40,17,544282,61328,63080,44876,0.5680832931935232,0.4225452901962261
6940,0.694,11,49,11,544331,61279,63091,44865,0.5676294045722331,0.422680509496533
6941,0.6941,19,51,19,544382,61228,63110,44846,0.5671569898847678,0.42278032317061676
6942,0.6942,18,34,18,544416,61194,63128,44828,0.566842046759791,0.42281790571768124
6943,0.6943,15,52,15,544468,61142,63143,44813,0.5663603690392383,0.42294370251521873
6944,0.6944,17,49,17,544517,61093,63160,44796,0.565906480417948,0.42304677539687785
6945,0.6945,15,41,15,544558,61052,63175,44781,0.5655266960613583,0.42312889174454094
6946,0.6946,17,46,17,544604,61006,63192,44764,0.5651005965393309,0.4232201947622199
6947,0.6947,20,50,20,544654,60956,63212,44744,0.5646374448849532,0.4233112582781457
6948,0.6948,16,40,16,544694,60916,63228,44728,0.5642669235614509,0.42338419597894816
6949,0.6949,9,44,9,544738,60872,63237,44719,0.5638593501055986,0.42351147351573526
6950,0.695,14,29,14,544767,60843,63251,44705,0.5635907221460595,0.42355136999279946
6951,0.6951,17,48,17,544815,60795,63268,44688,0.5631460965578569,0.42365120445948634
6952,0.6952,12,50,12,544865,60745,63280,44676,0.5626829449034791,0.42378653209512335
6953,0.6953,16,51,16,544916,60694,63296,44660,0.562210530216014,0.4239041707006853
6954,0.6954,21,33,21,544949,60661,63317,44639,0.5619048501241246,0.4239221272554606
6955,0.6955,16,38,16,544987,60623,63333,44623,0.5615528548667976,0.4239876099804268
6956,0.6956,22,64,22,545051,60559,63355,44601,0.5609600207491942,0.424125142639787
6957,0.6957,25,40,25,545091,60519,63380,44576,0.5605894994256919,0.4241495789523764
6958,0.6958,16,60,16,545151,60459,63396,44560,0.5600337174404387,0.424304173530504
6959,0.6959,16,53,16,545204,60406,63412,44544,0.5595427766867983,0.42443068127679845
6960,0.696,21,61,21,545265,60345,63433,44523,0.5589777316684575,0.424562306900103
6961,0.6961,17,38,17,545303,60307,63450,44506,0.5586257364111304,0.42462289983112783
6962,0.6962,13,42,13,545345,60265,63463,44493,0.5582366890214532,0.42472173962847704
6963,0.6963,18,47,18,545392,60218,63481,44475,0.5578013264663382,0.4248135023353997
6964,0.6964,23,38,23,545430,60180,63504,44452,0.5574493312090111,0.4248413487269669
6965,0.6965,16,38,16,545468,60142,63520,44436,0.557097335951684,0.42490772437797625
6966,0.6966,16,43,16,545511,60099,63536,44420,0.5566990255289191,0.4249944986079086
6967,0.6967,23,41,23,545552,60058,63559,44397,0.5563192411723294,0.4250347039394955
6968,0.6968,12,41,12,545593,60017,63571,44385,0.5559394568157398,0.42513553380203445
6969,0.6969,23,44,23,545637,59973,63594,44362,0.5555318833598873,0.4251880960368045
6970,0.697,11,46,11,545683,59927,63605,44351,0.5551057838378599,0.4253150233030937
6971,0.6971,9,37,9,545720,59890,63614,44342,0.5547630516136204,0.425416378847187
6972,0.6972,18,47,18,545767,59843,63632,44324,0.5543276890585053,0.42550903837107723
6973,0.6973,23,42,23,545809,59801,63655,44301,0.553938641668828,0.4255537837889762
6974,0.6974,23,46,23,545855,59755,63678,44278,0.5535125421468006,0.42561494910268854
6975,0.6975,17,46,17,545901,59709,63695,44261,0.553086442624773,0.4257093392324709
6976,0.6976,14,52,14,545953,59657,63709,44247,0.5526047649042203,0.4258450107791808
6977,0.6977,24,44,24,545997,59613,63733,44223,0.5521971914483679,0.4258927539581648
6978,0.6978,19,49,19,546046,59564,63752,44204,0.5517433028270777,0.42598874412150184
6979,0.6979,18,47,18,546093,59517,63770,44186,0.5513079402719626,0.426082176986201
6980,0.698,10,43,10,546136,59474,63780,44176,0.5509096298491978,0.42620356970574047
6981,0.6981,11,48,11,546184,59426,63791,44165,0.5504650042609952,0.4263401260727283
6982,0.6982,22,46,22,546230,59380,63813,44143,0.5500389047389678,0.42640765820155907
6983,0.6983,16,43,16,546273,59337,63829,44127,0.5496405943162029,0.4264961725817676
6984,0.6984,14,44,14,546317,59293,63843,44113,0.5492330208603505,0.4266000038682475
6985,0.6985,12,46,12,546363,59247,63855,44101,0.548806921338323,0.4267233037891396
6986,0.6986,14,48,14,546411,59199,63869,44087,0.5483622957501204,0.42684390914547954
6987,0.6987,14,37,14,546448,59162,63883,44073,0.5480195635258809,0.4269191650118661
6988,0.6988,17,51,17,546499,59111,63900,44056,0.5475471488384156,0.4270357769441779
6989,0.6989,16,44,16,546543,59067,63916,44040,0.5471395753825633,0.4271290988972621
6990,0.699,14,35,14,546578,59032,63930,44026,0.5468153692244989,0.42719633604378116
6991,0.6991,16,30,16,546608,59002,63946,44010,0.5465374782318723,0.42723177882188484
6992,0.6992,15,46,15,546654,58956,63961,43995,0.5461113787098447,0.42733921962875543
6993,0.6993,12,49,12,546703,58907,63973,43983,0.5456574900885546,0.42747594518417725
6994,0.6994,26,37,26,546740,58870,63999,43957,0.545314757864315,0.42748499907611814
6995,0.6995,19,48,19,546788,58822,64018,43938,0.5448701322761125,0.4275788244453095
6996,0.6996,22,47,22,546835,58775,64040,43916,0.5444347697209975,0.4276518877019408
6997,0.6997,9,37,9,546872,58738,64049,43907,0.5440920374967579,0.42775585756734374
6998,0.6998,21,46,21,546918,58692,64070,43886,0.5436659379747304,0.42783052896332546
6999,0.6999,15,52,15,546970,58640,64085,43871,0.5431842602541777,0.4279638282720879
7000,0.7,8,49,8,547019,58591,64093,43863,0.5427303716328875,0.42812384094325256
7001,0.7001,20,40,20,547059,58551,64113,43843,0.5423598503093853,0.42817938551086976
7002,0.7002,20,46,20,547105,58505,64133,43823,0.5419337507873578,0.42826010476116017
7003,0.7003,15,53,15,547158,58452,64148,43808,0.5414428100337174,0.42839820066497164
7004,0.7004,19,43,19,547201,58409,64167,43789,0.5410444996109526,0.4284721814516918
7005,0.7005,20,37,20,547238,58372,64187,43769,0.540701767386713,0.4285154834983014
7006,0.7006,20,43,20,547281,58329,64207,43749,0.5403034569639483,0.42858402398166107
7007,0.7007,17,55,17,547336,58274,64224,43732,0.5397939901441328,0.4287198792227908
7008,0.7008,15,39,15,547375,58235,64239,43717,0.5394327318537182,0.42879982736974265
7009,0.7009,14,54,14,547429,58181,64253,43703,0.5389325280669902,0.4289486082211142
7010,0.701,17,40,17,547469,58141,64270,43686,0.5385620067434881,0.42902177222151294
7011,0.7011,23,39,23,547508,58102,64293,43663,0.5382007484530735,0.4290571414533484
7012,0.7012,16,42,16,547550,58060,64309,43647,0.5378117010633962,0.4291445033281878
7013,0.7013,26,36,26,547586,58024,64335,43621,0.5374782318722442,0.42915047469132767
7014,0.7014,18,45,18,547631,57979,64353,43603,0.5370613953833043,0.42923943218286703
7015,0.7015,19,39,19,547670,57940,64372,43584,0.5367001370928897,0.42929750600843153
7016,0.7016,19,47,19,547717,57893,64391,43565,0.5362647745377747,0.42938950107433616
7017,0.7017,14,49,14,547766,57844,64405,43551,0.5358108859164845,0.42951822081956703
7018,0.7018,27,51,27,547817,57793,64432,43524,0.5353384712290192,0.42958239979470375
7019,0.7019,14,47,14,547864,57746,64446,43510,0.5349031086739042,0.4297029311843249
7020,0.702,11,43,11,547907,57703,64457,43499,0.5345047982511394,0.42982352127428314
7021,0.7021,24,59,24,547966,57644,64481,43475,0.5339582792989737,0.429938982782662
7022,0.7022,9,39,9,548005,57605,64490,43466,0.533597021008559,0.4300541203708284
7023,0.7023,16,39,16,548044,57566,64506,43450,0.5332357627181444,0.4301298804149838
7024,0.7024,21,54,21,548098,57512,64527,43429,0.5327355589314166,0.43024142816100497
7025,0.7025,16,45,16,548143,57467,64543,43413,0.5323187224424766,0.43034298176050756
7026,0.7026,20,36,20,548179,57431,64563,43393,0.5319852532513246,0.4303836388161549
7027,0.7027,19,48,19,548227,57383,64582,43374,0.531540627663122,0.4304812568853777
7028,0.7028,19,52,19,548279,57331,64601,43355,0.5310589499425692,0.43059611068073017
7029,0.7029,17,42,17,548321,57289,64618,43338,0.5306699025528919,0.4306796386655669
7030,0.703,14,31,14,548352,57258,64632,43324,0.5303827485271777,0.4307331331649798
7031,0.7031,24,42,24,548394,57216,64656,43300,0.5299937011375004,0.4307771897011421
7032,0.7032,17,31,17,548425,57185,64673,43283,0.5297065471117863,0.430813791455986
7033,0.7033,15,47,15,548472,57138,64688,43268,0.5292711845566712,0.4309304224847121
7034,0.7034,17,47,17,548519,57091,64705,43251,0.5288358220015562,0.43103585736780214
7035,0.7035,14,45,14,548564,57046,64719,43237,0.5284189855126162,0.43114984593600114
7036,0.7036,16,37,16,548601,57009,64735,43221,0.5280762532883767,0.4312181981442682
7037,0.7037,17,43,17,548644,56966,64752,43204,0.5276779428656119,0.4313067784765898
7038,0.7038,17,38,17,548682,56928,64769,43187,0.5273259476082849,0.4313739199920092
7039,0.7039,14,55,14,548737,56873,64783,43173,0.5268164807884693,0.43153149551206443
7040,0.704,13,52,13,548789,56821,64796,43160,0.5263348030679166,0.43168201958372093
7041,0.7041,14,50,14,548839,56771,64810,43146,0.5258716514135389,0.43181840927970216
7042,0.7042,11,43,11,548882,56728,64821,43135,0.525473340990774,0.4319417602114897
7043,0.7043,14,51,14,548933,56677,64835,43121,0.5250009263033087,0.43208280727068676
7044,0.7044,16,46,16,548979,56631,64851,43105,0.5245748267812813,0.43219098419828345
7045,0.7045,23,54,23,549033,56577,64874,43082,0.5240746229945533,0.4322941229592912
7046,0.7046,16,38,16,549071,56539,64890,43066,0.5237226277372263,0.43236785301942676
7047,0.7047,20,40,20,549111,56499,64910,43046,0.5233521064137241,0.4324275453312572
7048,0.7048,18,39,18,549150,56460,64928,43028,0.5229908481233095,0.43249437118044387
7049,0.7049,25,48,25,549198,56412,64953,43003,0.5225462225351069,0.43256047880098575
7050,0.705,18,41,18,549239,56371,64971,42985,0.5221664381785172,0.4326361769797496
7051,0.7051,21,51,21,549290,56320,64992,42964,0.5216940234910519,0.4327384069940776
7052,0.7052,18,34,18,549324,56286,65010,42946,0.521379080366075,0.4327837794259916
7053,0.7053,19,45,19,549369,56241,65029,42927,0.5209622438771351,0.43287149080348497
7054,0.7054,13,34,13,549403,56207,65042,42914,0.5206473007521583,0.43294559175149566
7055,0.7055,16,51,16,549454,56156,65058,42898,0.520174886064693,0.4330769075453793
7056,0.7056,20,43,20,549497,56113,65078,42878,0.5197765756419281,0.43315048842824094
7057,0.7057,14,40,14,549537,56073,65092,42864,0.519406054318426,0.4332453985869796
7058,0.7058,14,47,14,549584,56026,65106,42850,0.518970691763311,0.43337109106355437
7059,0.7059,22,47,22,549631,55979,65128,42828,0.5185353292081959,0.43345107128037486
7060,0.706,19,40,19,549671,55939,65147,42809,0.5181648078846938,0.43351764086361244
7061,0.7061,17,39,17,549710,55900,65164,42792,0.5178035495942791,0.4335913751874519
7062,0.7062,9,34,9,549744,55866,65173,42783,0.5174886064693023,0.4336891402852538
7063,0.7063,19,54,19,549798,55812,65192,42764,0.5169884026825744,0.43381756208407724
7064,0.7064,26,47,26,549845,55765,65218,42738,0.5165530401274593,0.43387511040272886
7065,0.7065,15,50,15,549895,55715,65233,42723,0.5160898884730816,0.43400922408013165
7066,0.7066,16,34,16,549929,55681,65249,42707,0.5157749453481048,0.43406716266211326
7067,0.7067,13,41,13,549970,55640,65262,42694,0.5153951609915151,0.4341733276384567
7068,0.7068,14,47,14,550017,55593,65276,42680,0.5149597984364,0.43430036734403143
7069,0.7069,24,40,24,550057,55553,65300,42656,0.5145892771128978,0.43433901169953876
7070,0.707,22,39,22,550096,55514,65322,42634,0.5142280188224833,0.43438480661857604
7071,0.7071,21,54,21,550150,55460,65343,42613,0.5137278150357553,0.43450287031089085
7072,0.7072,19,39,19,550189,55421,65362,42594,0.5133665567453407,0.43456613783604553
7073,0.7073,13,42,13,550231,55379,65375,42581,0.5129775093556634,0.4346774193548387
7074,0.7074,17,38,17,550269,55341,65392,42564,0.5126255140983363,0.43474796997089016
7075,0.7075,21,43,21,550312,55298,65413,42543,0.5122272036755715,0.43481771445508527
7076,0.7076,19,48,19,550360,55250,65432,42524,0.5117825780873689,0.43492134923394765
7077,0.7077,16,38,16,550398,55212,65448,42508,0.5114305828300418,0.4349979533360622
7078,0.7078,17,46,17,550444,55166,65465,42491,0.5110044833080144,0.4351044983974523
7079,0.7079,13,50,13,550494,55116,65478,42478,0.5105413316536367,0.4352521671414226
7080,0.708,14,43,14,550537,55073,65492,42464,0.5101430212308719,0.4353629904549043
7081,0.7081,15,40,15,550577,55033,65507,42449,0.5097724999073696,0.4354547506206274
7082,0.7082,18,48,18,550625,54985,65525,42431,0.509327874319167,0.4355649995893898
7083,0.7083,15,40,15,550665,54945,65540,42416,0.5089573529956649,0.4356569879109705
7084,0.7084,14,40,14,550705,54905,65554,42402,0.5085868316721628,0.4357548788884664
7085,0.7085,20,41,20,550746,54864,65574,42382,0.508207047315573,0.43582255311272444
7086,0.7086,14,40,14,550786,54824,65588,42368,0.5078365259920709,0.4359206519055066
7087,0.7087,23,40,23,550826,54784,65611,42345,0.5074660046685687,0.43596660111810065
7088,0.7088,12,44,12,550870,54740,65623,42333,0.5070584312127163,0.43609448559331637
7089,0.7089,17,38,17,550908,54702,65640,42316,0.5067064359553892,0.4361664845698736
7090,0.709,15,42,15,550950,54660,65655,42301,0.506317388565712,0.4362681903033178
7091,0.7091,12,40,12,550990,54620,65667,42289,0.5059468672422098,0.43637845814114273
7092,0.7092,12,33,12,551023,54587,65679,42277,0.5056411871503205,0.43645730095804425
7093,0.7093,24,36,24,551059,54551,65703,42253,0.5053077179591685,0.4364798975248957
7094,0.7094,13,52,13,551111,54499,65716,42240,0.5048260402386158,0.43663879097365077
7095,0.7095,20,47,20,551158,54452,65736,42220,0.5043906776835007,0.4367345249917246
7096,0.7096,21,29,21,551187,54423,65757,42199,0.5041220497239616,0.43674318478193375
7097,0.7097,13,44,13,551231,54379,65770,42186,0.5037144762681093,0.4368663594470046
7098,0.7098,22,36,22,551267,54343,65792,42164,0.5033810070769573,0.43690095019014163
7099,0.7099,16,37,16,551304,54306,65808,42148,0.5030382748527178,0.4369751384079458
7100,0.71,27,48,27,551352,54258,65835,42121,0.5025936492645152,0.4370350387532554
7101,0.7101,21,48,21,551400,54210,65856,42100,0.5021490236763125,0.4371301007164365
7102,0.7102,21,48,21,551448,54162,65877,42079,0.50170439808811,0.43722529898899637
7103,0.7103,19,42,19,551490,54120,65896,42060,0.5013153506984327,0.43730505302557704
7104,0.7104,15,36,15,551526,54084,65911,42045,0.5009818815072807,0.4373810192553756
7105,0.7105,17,44,17,551570,54040,65928,42028,0.5005743080514283,0.43748178373651997
7106,0.7106,11,37,11,551607,54003,65939,42017,0.5002315758271888,0.4375859196000833
7107,0.7107,14,39,14,551646,53964,65953,42003,0.49987031753677424,0.43768170308543564
7108,0.7108,24,50,24,551696,53914,65977,41979,0.49940716588239653,0.43776918023213374
7109,0.7109,13,52,13,551748,53862,65990,41966,0.49892548816184373,0.4379304587385733
7110,0.711,10,53,10,551801,53809,66000,41956,0.49843454740820337,0.43811413355610085
7111,0.7111,20,47,20,551848,53762,66020,41936,0.4979991848530883,0.43821187485631885
7112,0.7112,16,52,16,551900,53710,66036,41920,0.49751750713253545,0.4383561643835616
7113,0.7113,20,50,20,551950,53660,66056,41900,0.4970543554781578,0.43846797823357053
7114,0.7114,21,51,21,552001,53609,66077,41879,0.4965819407906925,0.4385786695710456
7115,0.7115,21,36,21,552037,53573,66098,41858,0.49624847159954055,0.4386205740273077
7116,0.7116,16,29,16,552066,53544,66114,41842,0.49597984364000147,0.43865976139056045
7117,0.7117,24,39,24,552105,53505,66138,41818,0.49561858534958686,0.4386979008214177
7118,0.7118,17,42,17,552147,53463,66155,41801,0.4952295379599096,0.43879114880752434
7119,0.7119,20,50,20,552197,53413,66175,41781,0.4947663863055319,0.4389037124188499
7120,0.712,15,31,15,552228,53382,66190,41766,0.4944792322798177,0.4389582545087653
7121,0.7121,20,46,20,552274,53336,66210,41746,0.4940531327577902,0.4390526072232389
7122,0.7122,18,42,18,552316,53294,66228,41728,0.49366408536811296,0.43914040958935824
7123,0.7123,14,41,14,552357,53253,66242,41714,0.4932843010115232,0.4392473174892331
7124,0.7124,14,55,14,552412,53198,66256,41700,0.49277483419170776,0.439419165841219
7125,0.7125,15,38,15,552450,53160,66271,41685,0.49242283893438066,0.4395065633401866
7126,0.7126,15,45,15,552495,53115,66286,41670,0.49200600244544074,0.4396265231840481
7127,0.7127,15,47,15,552542,53068,66301,41655,0.4915706398903257,0.4397559198927399
7128,0.7128,11,42,11,552584,53026,66312,41644,0.4911815925006484,0.43988591950987643
7129,0.7129,17,46,17,552630,52980,66329,41627,0.4907554929786209,0.43999915439660914
7130,0.713,12,41,12,552671,52939,66341,41615,0.4903757086220312,0.4401188738710155
7131,0.7131,16,37,16,552708,52902,66357,41599,0.4900329763977917,0.44019640003809485
7132,0.7132,20,39,20,552747,52863,66377,41579,0.4896717181073771,0.4402596302492535
7133,0.7133,23,52,23,552799,52811,66400,41556,0.4891900403868243,0.44036580584314433
7134,0.7134,16,38,16,552837,52773,66416,41540,0.4888380451294972,0.44044829450871037
7135,0.7135,16,43,16,552880,52730,66432,41524,0.48843973470673235,0.4405542470346086
7136,0.7136,17,45,17,552925,52685,66449,41507,0.48802289821779243,0.44066375063699675
7137,0.7137,22,43,22,552968,52642,66471,41485,0.4876245877950276,0.44073432702625176
7138,0.7138,35,40,35,553008,52602,66506,41450,0.4872540664715254,0.4407136477693191
7139,0.7139,12,38,12,553046,52564,66518,41438,0.4869020712141984,0.4408204080764239
7140,0.714,18,32,18,553078,52532,66536,41420,0.48660565415539664,0.4408634196185286
7141,0.7141,21,44,21,553122,52488,66557,41399,0.48619808069954423,0.44094496575670755
7142,0.7142,19,44,19,553166,52444,66576,41380,0.4857905072436919,0.44103854024556616
7143,0.7143,18,40,18,553206,52404,66594,41362,0.4854199859201897,0.4411193822920888
7144,0.7144,15,40,15,553246,52364,66609,41347,0.4850494645966875,0.44121821344345913
7145,0.7145,16,43,16,553289,52321,66625,41331,0.4846511541739227,0.4413253320804681
7146,0.7146,18,41,18,553330,52280,66643,41313,0.484271369817333,0.4414112166508179
7147,0.7147,16,60,16,553390,52220,66659,41297,0.48371558783207974,0.44159885368435686
7148,0.7148,23,45,23,553435,52175,66682,41274,0.4832987513431398,0.44167406820832755
7149,0.7149,18,43,18,553478,52132,66700,41256,0.482900440920375,0.4417698205336874
7150,0.715,21,40,21,553518,52092,66721,41235,0.4825299195968728,0.44183355299109583
7151,0.7151,13,44,13,553562,52048,66734,41222,0.4821223461410204,0.44196418998606196
7152,0.7152,20,42,20,553604,52006,66754,41202,0.48173329875134313,0.4420436014076045
7153,0.7153,16,46,16,553650,51960,66770,41186,0.48130719922931564,0.44216606188134755
7154,0.7154,16,41,16,553691,51919,66786,41170,0.48092741487272594,0.4422649292612446
7155,0.7155,19,44,19,553735,51875,66805,41151,0.48051984141687354,0.44236020037408896
7156,0.7156,30,34,30,553769,51841,66835,41121,0.4802048982918967,0.44234203222822227
7157,0.7157,8,46,8,553815,51795,66843,41113,0.47977879876986923,0.44251302363628536
7158,0.7158,16,41,16,553856,51754,66859,41097,0.4793990144132795,0.4426123574328763
7159,0.7159,19,52,19,553908,51702,66878,41078,0.4789173366927267,0.442746281526191
7160,0.716,17,44,17,553952,51658,66895,41061,0.4785097632368743,0.44285421542510167
7161,0.7161,17,31,17,553983,51627,66912,41044,0.4782226092111601,0.4429001521511584
7162,0.7162,20,30,20,554013,51597,66932,41024,0.47794471821853346,0.44292331112814587
7163,0.7163,20,34,20,554047,51563,66952,41004,0.47762977509355664,0.44296563570170794
7164,0.7164,27,41,27,554088,51522,66979,40977,0.4772499907369669,0.4429993837771219
7165,0.7165,16,28,16,554116,51494,66995,40961,0.4769906258105154,0.4430371532096696
7166,0.7166,12,37,12,554153,51457,67007,40949,0.4766478935862759,0.4431422202021514
7167,0.7167,22,33,22,554186,51424,67029,40927,0.4763422134943866,0.4431679137204795
7168,0.7168,18,34,18,554220,51390,67047,40909,0.4760272703694098,0.4432225701253535
7169,0.7169,20,32,20,554252,51358,67067,40889,0.47573085331060805,0.44325560722841933
7170,0.717,17,43,17,554295,51315,67084,40872,0.4753325428878432,0.4433596927983338
7171,0.7171,28,40,28,554335,51275,67112,40844,0.47496202156434103,0.44338301544741043
7172,0.7172,19,42,19,554377,51233,67131,40825,0.47457297417466376,0.4434704208216559
7173,0.7173,19,36,19,554413,51197,67150,40806,0.4742395049835118,0.44352901535819483
7174,0.7174,21,40,21,554453,51157,67171,40785,0.4738689836600096,0.4435948750299102
7175,0.7175,22,35,22,554488,51122,67193,40763,0.47354477750194524,0.44363062523806934
7176,0.7176,12,31,12,554519,51091,67205,40751,0.47325762347623107,0.44370767187125715
7177,0.7177,20,42,20,554561,51049,67225,40731,0.4728685760865538,0.44378949662235784
7178,0.7178,20,45,20,554606,51004,67245,40711,0.47245173959761383,0.443885951043995
7179,0.7179,25,42,25,554648,50962,67270,40686,0.47206269220793656,0.4439376745810056
7180,0.718,23,48,23,554696,50914,67293,40663,0.471618066619734,0.44403070640007863
7181,0.7181,25,43,25,554739,50871,67318,40638,0.47121975619696915,0.4440874668065436
7182,0.7182,18,28,18,554767,50843,67336,40620,0.47096039127051764,0.44411401331686035
7183,0.7183,19,47,19,554814,50796,67355,40601,0.4705250287154026,0.4442268345788155
7184,0.7184,19,47,19,554861,50749,67374,40582,0.4700896661602875,0.44433981890048285
7185,0.7185,20,45,20,554906,50704,67394,40562,0.4696728296713476,0.44443713978918764
7186,0.7186,14,37,14,554943,50667,67408,40548,0.4693300974471081,0.4445321493175465
7187,0.7187,15,47,15,554990,50620,67423,40533,0.468894734891993,0.4446699505227475
7188,0.7188,20,40,20,555030,50580,67443,40513,0.4685242135684909,0.4447432843357887
7189,0.7189,15,40,15,555070,50540,67458,40498,0.4681536922449887,0.4448472066609548
7190,0.719,13,31,13,555101,50509,67471,40485,0.46786653821927454,0.4449194452381476
7191,0.7191,24,37,24,555138,50472,67495,40461,0.467523805995035,0.4449539771040216
7192,0.7192,15,52,15,555190,50420,67510,40446,0.4670421282744822,0.44511698545110384
7193,0.7193,13,38,13,555228,50382,67523,40433,0.4666901330171551,0.44522380663987227
7194,0.7194,16,48,16,555276,50334,67539,40417,0.46624550742895254,0.4453614836200152
7195,0.7195,18,46,18,555322,50288,67557,40399,0.46581940790692505,0.4454773010464565
7196,0.7196,20,45,20,555367,50243,67577,40379,0.4654025714179851,0.44557612941669794
7197,0.7197,16,29,16,555396,50214,67593,40363,0.46513394345844605,0.445620852975921
7198,0.7198,28,36,28,555432,50178,67621,40335,0.4648004742672941,0.4456265950747407
7199,0.7199,22,31,22,555463,50147,67643,40313,0.46451332024157993,0.44564448374972365
7200,0.72,18,40,18,555503,50107,67661,40295,0.46414279891807775,0.4457312891307714
7201,0.7201,18,47,18,555550,50060,67679,40277,0.4637074363629627,0.4458527513643358
7202,0.7202,19,37,19,555587,50023,67698,40258,0.46336470413872316,0.44591885335784937
7203,0.7203,19,31,19,555618,49992,67717,40239,0.463077550113009,0.44595538118828343
7204,0.7204,17,39,17,555657,49953,67734,40222,0.4627162918225944,0.44604380371499863
7205,0.7205,20,39,20,555696,49914,67754,40202,0.46235503353217977,0.4461138976430379
7206,0.7206,17,28,17,555724,49886,67771,40185,0.46209566860572826,0.4461480387694152
7207,0.7207,14,37,14,555761,49849,67785,40171,0.46175293638148873,0.4462452788269273
7208,0.7208,19,43,19,555804,49806,67804,40152,0.46135462595872395,0.44634162609217637
7209,0.7209,14,42,14,555846,49764,67818,40138,0.46096557856904663,0.4464639273875998
7210,0.721,19,41,19,555887,49723,67837,40119,0.46058579421245693,0.4465506110727722
7211,0.7211,17,38,17,555925,49685,67854,40102,0.4602337989551299,0.4466348135030684
7212,0.7212,16,44,16,555969,49641,67870,40086,0.4598262254992775,0.4467551573105085
7213,0.7213,12,41,12,556010,49600,67882,40074,0.4594464411426878,0.4468853848384147
7214,0.7214,21,45,21,556055,49555,67903,40053,0.4590296046537478,0.446980180341041
7215,0.7215,21,44,21,556099,49511,67924,40032,0.45862203119789546,0.4470701227343288
7216,0.7216,23,49,23,556148,49462,67947,40009,0.45816814257660526,0.4471728269495144
7217,0.7217,21,32,21,556180,49430,67968,39988,0.45787172551780353,0.4472030239996421
7218,0.7218,12,51,12,556231,49379,67980,39976,0.4573993108303383,0.44738402999272564
7219,0.7219,18,35,18,556266,49344,67998,39958,0.4570751046722739,0.4474479854874471
7220,0.722,18,39,18,556305,49305,68016,39940,0.4567138463818593,0.44753207462602945
7221,0.7221,17,40,17,556345,49265,68033,39923,0.4563433250583571,0.44762748351796205
7222,0.7222,23,34,23,556379,49231,68056,39900,0.45602838193338024,0.44765569779313596
7223,0.7223,14,34,14,556413,49197,68070,39886,0.4557134388084034,0.4477397483245962
7224,0.7224,23,52,23,556465,49145,68093,39863,0.45523176108785063,0.4478586194499371
7225,0.7225,31,45,31,556510,49100,68124,39832,0.45481492459891065,0.4478927720055773
7226,0.7226,22,40,22,556550,49060,68146,39810,0.4544444032754085,0.44795769100933946
7227,0.7227,19,42,19,556592,49018,68165,39791,0.4540553558857312,0.4480514362283102
7228,0.7228,21,43,21,556635,48975,68186,39770,0.45365704546296637,0.44813792326328244
7229,0.7229,25,43,25,556678,48932,68211,39745,0.4532587350402016,0.44819964590592826
7230,0.723,18,31,18,556709,48901,68229,39727,0.45297158101448737,0.4482443471589114
7231,0.7231,14,43,14,556752,48858,68243,39713,0.45257327059172253,0.4483747502004042
7232,0.7232,16,39,16,556791,48819,68259,39697,0.4522120123013079,0.4484725925256451
7233,0.7233,22,28,22,556819,48791,68281,39675,0.4519526473748564,0.44847738114077723
7234,0.7234,16,41,16,556860,48750,68297,39659,0.4515728630182667,0.4485855512447828
7235,0.7235,17,30,17,556890,48720,68314,39642,0.45129497202564006,0.44863176478576766
7236,0.7236,19,33,19,556923,48687,68333,39623,0.4509892919337508,0.44868078360321595
7237,0.7237,26,32,26,556955,48655,68359,39597,0.4506928748749491,0.4486810497212528
7238,0.7238,14,48,14,557003,48607,68373,39583,0.45024824928674645,0.44883773670484184
7239,0.7239,21,47,21,557050,48560,68394,39562,0.4498128867316314,0.44894577971448674
7240,0.724,14,39,14,557089,48521,68408,39548,0.4494516284412168,0.4490569894060339
7241,0.7241,12,40,12,557129,48481,68420,39536,0.44908110711771465,0.44918595271368034
7242,0.7242,15,39,15,557168,48442,68435,39521,0.44871984882730004,0.44929117924581924
7243,0.7243,21,33,21,557201,48409,68456,39500,0.44841416873541073,0.4493282826559283
7244,0.7244,17,47,17,557248,48362,68473,39483,0.4479788061802957,0.44946212078092096
7245,0.7245,18,37,18,557285,48325,68491,39465,0.44763607395605615,0.4495386718305046
7246,0.7246,14,37,14,557322,48288,68505,39451,0.4472933417318167,0.44964041076374245
7247,0.7247,20,47,20,557369,48241,68525,39431,0.4468579791767016,0.44975590838580165
7248,0.7248,21,43,21,557412,48198,68546,39410,0.4464596687539368,0.4498447630353392
7249,0.7249,19,27,19,557439,48171,68565,39391,0.44620956686057284,0.44986409629748064
7250,0.725,22,41,22,557480,48130,68587,39369,0.4458297825039831,0.44993657070366516
7251,0.7251,15,35,15,557515,48095,68602,39354,0.4455055763459187,0.4500222987112488
7252,0.7252,12,41,12,557556,48054,68614,39342,0.445125791989329,0.4501579019634766
7253,0.7253,16,34,16,557590,48020,68630,39326,0.4448108488643521,0.45023240903991024
7254,0.7254,20,53,20,557643,47967,68650,39306,0.44431990811071176,0.450379842562992
7255,0.7255,7,43,7,557686,47924,68657,39299,0.4439215976879469,0.45055776572692985
7256,0.7256,10,46,10,557732,47878,68667,39289,0.44349549816591943,0.4507325019789599
7257,0.7257,19,33,19,557765,47845,68686,39270,0.4431898180740302,0.45078344716753715
7258,0.7258,25,43,25,557808,47802,68711,39245,0.44279150765126535,0.4508483922478661
7259,0.7259,22,36,22,557844,47766,68733,39223,0.4424580384601134,0.4508960903102691
7260,0.726,21,38,21,557882,47728,68754,39202,0.44210604320278635,0.4509605429656045
7261,0.7261,20,40,20,557922,47688,68774,39182,0.44173552187928417,0.45104178657764477
7262,0.7262,21,30,21,557952,47658,68795,39161,0.4414576308866575,0.4510648590746265
7263,0.7263,14,33,14,557985,47625,68809,39147,0.44115195079476827,0.45114783570737105
7264,0.7264,17,37,17,558022,47588,68826,39130,0.44080921857052874,0.45123273138218134
7265,0.7265,18,41,18,558063,47547,68844,39112,0.440429434213939,0.451332233236017
7266,0.7266,19,42,19,558105,47505,68863,39093,0.4400403868242617,0.4514307489780364
7267,0.7267,14,24,14,558129,47481,68877,39079,0.43981807403016043,0.45146719038817007
7268,0.7268,18,36,18,558165,47445,68895,39061,0.4394846048390085,0.4515409335768617
7269,0.7269,21,31,21,558196,47414,68916,39040,0.4391974508132943,0.45156962083882757
7270,0.727,24,51,24,558247,47363,68940,39016,0.438725036125829,0.45168385834519964
7271,0.7271,11,34,11,558281,47329,68951,39005,0.4384100930008522,0.4517918780549957
7272,0.7272,22,39,22,558320,47290,68973,38983,0.4380488347104376,0.4518563165764492
7273,0.7273,22,37,22,558357,47253,68995,38961,0.43770610248619807,0.4519103625861229
7274,0.7274,11,40,11,558397,47213,69006,38950,0.4373355811626959,0.4520501839536692
7275,0.7275,26,42,26,558439,47171,69032,38924,0.4369465337730186,0.45210523259190427
7276,0.7276,19,37,19,558476,47134,69051,38905,0.43660380154877915,0.45217866316437894
7277,0.7277,8,38,8,558514,47096,69059,38897,0.43625180629145205,0.45232751503029317
7278,0.7278,20,34,20,558548,47062,69079,38877,0.43593686316647523,0.45237901302086364
7279,0.7279,13,44,13,558592,47018,69092,38864,0.4355292897106228,0.4525278871009059
7280,0.728,28,46,28,558638,46972,69120,38836,0.43510319018859533,0.4525918329293306
7281,0.7281,15,47,15,558685,46925,69135,38821,0.43466782763348033,0.4527441513306743
7282,0.7282,24,40,24,558725,46885,69159,38797,0.43429730630997815,0.4528022221703508
7283,0.7283,13,38,13,558763,46847,69172,38784,0.4339453110526511,0.45292008735154327
7284,0.7284,13,34,13,558797,46813,69185,38771,0.43363036792767423,0.4530169190502898
7285,0.7285,18,40,18,558837,46773,69203,38753,0.43325984660417205,0.4531136730351004
7286,0.7286,19,28,19,558865,46745,69222,38734,0.43300048167772054,0.4531405374419448
7287,0.7287,16,46,16,558911,46699,69238,38718,0.43257438215569305,0.45328213353313745
7288,0.7288,17,41,17,558952,46658,69255,38701,0.43219459779910335,0.45339097224662894
7289,0.7289,10,41,10,558993,46617,69265,38691,0.4318148134425136,0.45354480236320155
7290,0.729,19,44,19,559037,46573,69284,38672,0.43140723998666125,0.453657105988621
7291,0.7291,14,52,14,559089,46521,69298,38658,0.4309255622661084,0.4538442573873842
7292,0.7292,19,29,19,559118,46492,69317,38639,0.4306569343065693,0.4538769660875592
7293,0.7293,11,32,11,559150,46460,69328,38628,0.4303605172477676,0.45397705904475366
7294,0.7294,17,49,17,559199,46411,69345,38611,0.42990662862647744,0.45412951941850344
7295,0.7295,13,31,13,559230,46380,69358,38598,0.4296194746007633,0.4542116783167408
7296,0.7296,19,42,19,559272,46338,69377,38579,0.429230427211086,0.4543142127018147
7297,0.7297,12,36,12,559308,46302,69389,38567,0.42889695801993405,0.4544297682310384
7298,0.7298,17,35,17,559343,46267,69406,38550,0.42857275186186966,0.4545079406251105
7299,0.7299,12,29,12,559372,46238,69418,38538,0.4283041239023306,0.4545862036425403
7300,0.73,24,38,24,559410,46200,69442,38514,0.42795212864500354,0.45463559742191373
7301,0.7301,20,37,20,559447,46163,69462,38494,0.427609396420764,0.45470545849723
7302,0.7302,21,35,21,559482,46128,69483,38473,0.4272851902626996,0.45475821798796706
7303,0.7303,19,43,19,559525,46085,69502,38454,0.4268868798399348,0.45486698446870677
7304,0.7304,18,35,18,559560,46050,69520,38436,0.4265626736818704,0.4549392798806903
7305,0.7305,10,40,10,559600,46010,69530,38426,0.4261921523583682,0.45509024586669194
7306,0.7306,21,39,21,559639,45971,69551,38405,0.4258308940679536,0.45516497582250875
7307,0.7307,16,43,16,559682,45928,69567,38389,0.42543258364518877,0.4552937130116109
7308,0.7308,17,42,17,559724,45886,69584,38372,0.4250435362555115,0.45541076218281945
7309,0.7309,16,31,16,559755,45855,69600,38356,0.42475638222979734,0.455474937953474
7310,0.731,17,50,17,559805,45805,69617,38339,0.4242932305754196,0.4556355771059137
7311,0.7311,11,39,11,559844,45766,69628,38328,0.423931972285005,0.45577567959664184
7312,0.7312,17,32,17,559876,45734,69645,38311,0.4236355552262033,0.45583913379737045
7313,0.7313,13,48,13,559924,45686,69658,38298,0.42319092963800065,0.45601543151076396
7314,0.7314,25,35,25,559959,45651,69683,38273,0.42286672347993626,0.45604356322386924
7315,0.7315,14,38,14,559997,45613,69697,38259,0.4225147282226092,0.45615938573063713
7316,0.7316,15,43,15,560040,45570,69712,38244,0.4221164177998444,0.45629608418641276
7317,0.7317,15,26,15,560066,45544,69727,38229,0.42187557893956795,0.4563403483222518
7318,0.7318,16,30,16,560096,45514,69743,38213,0.42159768794694136,0.4563999665579801
7319,0.7319,16,48,16,560144,45466,69759,38197,0.42115306235873873,0.45655785711724417
7320,0.732,21,40,21,560184,45426,69780,38176,0.4207825410352366,0.4566397933063802
7321,0.7321,12,38,12,560222,45388,69792,38164,0.4204305457779095,0.45676943699731903
7322,0.7322,13,36,13,560258,45352,69805,38151,0.42009707658675755,0.4568817886782511
7323,0.7323,16,37,16,560295,45315,69821,38135,0.4197543443625181,0.45698022768124624
7324,0.7324,18,37,18,560332,45278,69839,38117,0.41941161213827854,0.4570657713292164
7325,0.7325,13,36,13,560368,45242,69852,38104,0.4190781429471266,0.4571785088666523
7326,0.7326,19,49,19,560417,45193,69871,38085,0.41862425432583644,0.4573236629121737
7327,0.7327,18,39,18,560456,45154,69889,38067,0.41826299603542183,0.45742060297280734
7328,0.7328,14,22,14,560478,45132,69903,38053,0.4180592093074956,0.4574502614654084
7329,0.7329,20,43,20,560521,45089,69923,38033,0.4176608988847308,0.4575563629364067
7330,0.733,26,46,26,560567,45043,69949,38007,0.4172347993627033,0.4576399759181216
7331,0.7331,18,37,18,560604,45006,69967,37989,0.41689206713846383,0.457726369058377
7332,0.7332,12,47,12,560651,44959,69979,37977,0.41645670458334877,0.4579073020160124
7333,0.7333,19,40,19,560691,44919,69998,37958,0.4160861832598466,0.458004030068656
7334,0.7334,13,44,13,560735,44875,70011,37945,0.41567860980399424,0.4581622796425984
7335,0.7335,13,39,13,560774,44836,70024,37932,0.4153173515135796,0.4582930601198531
7336,0.7336,18,30,18,560804,44806,70042,37914,0.415039460520953,0.4583413926499033
7337,0.7337,17,43,17,560847,44763,70059,37897,0.41464115009818814,0.4584684248729736
7338,0.7338,23,28,23,560875,44735,70082,37874,0.4143817851717366,0.45847304773087677
7339,0.7339,24,40,24,560915,44695,70106,37850,0.41401126384823445,0.4585377672784542
7340,0.734,12,31,12,560946,44664,70118,37838,0.4137241098225203,0.45863130590773554
7341,0.7341,14,35,14,560981,44629,70132,37824,0.4133999036644559,0.4587340666804119
7342,0.7342,10,39,10,561020,44590,70142,37814,0.4130386453740413,0.45888549099558273
7343,0.7343,19,35,19,561055,44555,70161,37795,0.4127144392159769,0.4589556769884639
7344,0.7344,10,31,10,561086,44524,70171,37785,0.4124272851902627,0.4590627999368234
7345,0.7345,10,37,10,561123,44487,70181,37775,0.4120845529660232,0.4592035204590212
7346,0.7346,14,34,14,561157,44453,70195,37761,0.4117696098410463,0.4593013355389593
7347,0.7347,14,46,14,561203,44407,70209,37747,0.41134351031901883,0.4594663680405093
7348,0.7348,21,34,21,561237,44373,70230,37726,0.411028567194042,0.45951838633844505
7349,0.7349,19,46,19,561283,44327,70249,37707,0.4106024676720145,0.4596508764658556
7350,0.735,10,43,10,561326,44284,70259,37697,0.4102041572492497,0.45982605725716935
7351,0.7351,18,33,18,561359,44251,70277,37679,0.4098984771573604,0.45989259123642134
7352,0.7352,20,29,20,561388,44222,70297,37659,0.40962984919782136,0.4599235475873524
7353,0.7353,14,48,14,561436,44174,70311,37645,0.40918522360961873,0.4601009545460101
7354,0.7354,17,35,17,561471,44139,70328,37628,0.40886101745155434,0.46018564946738905
7355,0.7355,13,47,13,561518,44092,70341,37615,0.4084256548964393,0.4603644730561641
7356,0.7356,20,34,20,561552,44058,70361,37595,0.40811071177146246,0.4604239893206618
7357,0.7357,21,41,21,561593,44017,70382,37574,0.4077309274148727,0.46051647853317157
7358,0.7358,9,44,9,561637,43973,70391,37565,0.40732335395902036,0.46070543795530916
7359,0.7359,34,33,34,561670,43940,70425,37531,0.40701767386713106,0.46066698579862775
7360,0.736,19,39,19,561709,43901,70444,37512,0.40665641557671645,0.46076179479935636
7361,0.7361,21,35,21,561744,43866,70465,37491,0.40633220941865206,0.4608208267266492
7362,0.7362,15,36,15,561780,43830,70480,37476,0.4059987402275001,0.4609253929599292
7363,0.7363,21,35,21,561815,43795,70501,37455,0.4056745340694357,0.4609846153846154
7364,0.7364,20,50,20,561865,43745,70521,37435,0.405211382415058,0.4611357477211136
7365,0.7365,17,42,17,561907,43703,70538,37418,0.40482233502538073,0.4612615722192774
7366,0.7366,18,40,18,561947,43663,70556,37400,0.40445181370187855,0.46136955207677977
7367,0.7367,14,36,14,561983,43627,70570,37386,0.4041183445107266,0.4614814906249614
7368,0.7368,15,37,15,562020,43590,70585,37371,0.40377561228648706,0.4615926186682477
7369,0.7369,19,40,19,562060,43550,70604,37352,0.40340509096298494,0.4616943956886109
7370,0.737,21,33,21,562093,43517,70625,37331,0.40309941087109563,0.4617430239461706
7371,0.7371,13,33,13,562126,43484,70638,37318,0.4027937307792063,0.4618450038365387
7372,0.7372,16,34,16,562160,43450,70654,37302,0.4024787876542295,0.4619328313849812
7373,0.7373,14,38,14,562198,43412,70668,37288,0.40212679239690247,0.4620570012391574
7374,0.7374,18,34,18,562232,43378,70686,37270,0.4018118492719256,0.4621317329629997
7375,0.7375,17,40,17,562272,43338,70703,37253,0.4014413279484234,0.4622476455187304
7376,0.7376,15,30,15,562302,43308,70718,37238,0.4011634369557968,0.46231966826409754
7377,0.7377,15,35,15,562337,43273,70733,37223,0.4008392307977324,0.46242049294374876
7378,0.7378,18,44,18,562381,43229,70751,37205,0.40043165734188,0.46255314916577567
7379,0.7379,13,47,13,562428,43182,70764,37192,0.39999629478676496,0.4627367058999179
7380,0.738,19,34,19,562462,43148,70783,37173,0.39968135166178814,0.4628054929595
7381,0.7381,24,37,24,562499,43111,70807,37149,0.3993386194375486,0.46285821081485173
7382,0.7382,20,27,20,562526,43084,70827,37129,0.3990885175441847,0.46288008178225476
7383,0.7383,22,42,22,562568,43042,70849,37107,0.3986994701545074,0.46297520867384495
7384,0.7384,14,34,14,562602,43008,70863,37093,0.39838452702953053,0.46307786419645197
7385,0.7385,19,30,19,562632,42978,70882,37074,0.39810663603690394,0.4631239694198771
7386,0.7386,19,41,19,562673,42937,70901,37055,0.3977268516803142,0.46323382338233826
7387,0.7387,11,47,11,562720,42890,70912,37044,0.3972914891251992,0.46343233167363074
7388,0.7388,21,39,21,562759,42851,70933,37023,0.3969302308347845,0.46351754012569796
7389,0.7389,12,31,12,562790,42820,70945,37011,0.39664307680907035,0.4636168906815648
7390,0.739,15,33,15,562823,42787,70960,36996,0.3963373967171811,0.4637078074276475
7391,0.7391,15,25,15,562848,42762,70975,36981,0.39610582088999224,0.4637523042774914
7392,0.7392,23,23,23,562871,42739,70998,36958,0.39589277112897847,0.4637313826116416
7393,0.7393,19,37,19,562908,42702,71017,36939,0.39555003890473894,0.46381888725656384
7394,0.7394,22,28,22,562936,42674,71039,36917,0.39529067397828743,0.4638338505609931
7395,0.7395,17,44,17,562980,42630,71056,36900,0.3948831005224351,0.46397585816672954
7396,0.7396,14,34,14,563014,42596,71070,36886,0.3945681573974582,0.4640799174655897
7397,0.7397,16,33,16,563047,42563,71086,36870,0.39426247730556896,0.46416476779172383
7398,0.7398,14,32,14,563079,42531,71100,36856,0.3939660602467672,0.4642573721138222
7399,0.7399,14,29,14,563108,42502,71114,36842,0.39369743228722814,0.4643325267190966
7400,0.74,12,35,12,563143,42467,71126,36830,0.39337322612916376,0.46445641070910626
7401,0.7401,9,32,9,563175,42435,71135,36821,0.393076809070362,0.4645831230443121
7402,0.7402,19,41,19,563216,42394,71154,36802,0.39269702471377227,0.4646951866255872
7403,0.7403,12,41,12,563257,42353,71166,36790,0.3923172403571826,0.46485475657986175
7404,0.7404,19,37,19,563294,42316,71185,36771,0.39197450813294304,0.46494366962964834
7405,0.7405,20,52,20,563346,42264,71205,36751,0.39149283041239025,0.46511421881921156
7406,0.7406,18,33,18,563379,42231,71223,36733,0.39118715032050094,0.4651866673420799
7407,0.7407,32,26,32,563405,42205,71255,36701,0.3909463114602245,0.46512305781562874
7408,0.7408,14,37,14,563442,42168,71269,36687,0.39060357923598504,0.4652463382157124
7409,0.7409,14,45,14,563487,42123,71283,36673,0.39018674274704507,0.46541702624498704
7410,0.741,19,45,19,563532,42078,71302,36654,0.38976990625810515,0.4655540313976528
7411,0.7411,14,38,14,563570,42040,71316,36640,0.3894179110007781,0.46568378240976105
7412,0.7412,15,30,15,563600,42010,71331,36625,0.38914002000815145,0.4657595218414192
7413,0.7413,21,28,21,563628,41982,71352,36604,0.38888065508169994,0.4657827093884407
7414,0.7414,13,27,13,563655,41955,71365,36591,0.388630553188336,0.46585440378886256
7415,0.7415,18,33,18,563688,41922,71383,36573,0.3883248730964467,0.46592776609975156
7416,0.7416,18,33,18,563721,41889,71401,36555,0.3880191930045574,0.4660012238029677
7417,0.7417,21,30,21,563751,41859,71422,36534,0.3877413020119308,0.46603650836171595
7418,0.7418,17,38,17,563789,41821,71439,36517,0.3873893067546037,0.46614669764354466
7419,0.7419,16,37,16,563826,41784,71455,36501,0.38704657453036423,0.466257903812991
7420,0.742,16,33,16,563859,41751,71471,36485,0.3867408944384749,0.46634541643233296
7421,0.7421,10,33,10,563892,41718,71481,36475,0.3864352143465856,0.4664739810468968
7422,0.7422,20,30,20,563922,41688,71501,36455,0.386157323353959,0.4665165145950373
7423,0.7423,17,26,17,563948,41662,71518,36438,0.3859164844936826,0.4665556978233035
7424,0.7424,19,37,19,563985,41625,71537,36419,0.3855737522694431,0.4666470196299523
7425,0.7425,16,26,16,564011,41599,71553,36403,0.3853329134091667,0.4666931617138022
7426,0.7426,13,49,13,564060,41550,71566,36390,0.38487902478787656,0.46689761354888376
7427,0.7427,17,48,17,564108,41502,71583,36373,0.3844343991996739,0.46706902086677365
7428,0.7428,15,46,15,564154,41456,71598,36358,0.38400829967764644,0.46724239854010846
7429,0.7429,22,33,22,564187,41423,71620,36336,0.3837026195857572,0.4672899600046297
7430,0.743,14,36,14,564223,41387,71634,36322,0.38336915039460523,0.467410467256045
7431,0.7431,10,42,10,564265,41345,71644,36312,0.3829801030049279,0.46759467916607644
7432,0.7432,14,29,14,564294,41316,71658,36298,0.3827114750453889,0.46767335789934805
7433,0.7433,24,27,24,564321,41289,71682,36274,0.3824613731520249,0.4676714412799918
7434,0.7434,20,34,20,564355,41255,71702,36254,0.38214643002704807,0.4677392302829349
7435,0.7435,17,43,17,564398,41212,71719,36237,0.38174811960428323,0.4678820901496469
7436,0.7436,16,38,16,564436,41174,71735,36221,0.3813961243469562,0.46800180890238385
7437,0.7437,24,31,24,564467,41143,71759,36197,0.38110897032124197,0.46802430824928887
7438,0.7438,21,34,21,564501,41109,71780,36176,0.38079402719626515,0.4680856569838908
7439,0.7439,16,36,16,564537,41073,71796,36160,0.3804605580051132,0.46819364779304184
7440,0.744,15,34,15,564571,41039,71811,36145,0.3801456148801364,0.46829653814262023
7441,0.7441,19,38,19,564609,41001,71830,36126,0.3797936196228093,0.4683962814578552
7442,0.7442,14,38,14,564647,40963,71844,36112,0.37944162436548223,0.4685306519623743
7443,0.7443,22,29,22,564676,40934,71866,36090,0.37917299640594315,0.4685552555047777
7444,0.7444,15,34,15,564710,40900,71881,36075,0.37885805328096633,0.4686586554075999
7445,0.7445,18,33,18,564743,40867,71899,36057,0.37855237318907703,0.4687353751754979
7446,0.7446,18,45,18,564788,40822,71917,36039,0.3781355367001371,0.46888539051014166
7447,0.7447,14,25,14,564813,40797,71931,36025,0.37790396087294825,0.4689411887219807
7448,0.7448,25,35,25,564848,40762,71956,36000,0.37757975471488386,0.46898204840936925
7449,0.7449,16,38,16,564886,40724,71972,35984,0.37722775945755677,0.4691036137039161
7450,0.745,18,23,18,564909,40701,71990,35966,0.37701470969654305,0.4691196994795675
7451,0.7451,22,30,22,564939,40671,72012,35944,0.3767368187039164,0.4691509495529596
7452,0.7452,19,30,19,564969,40641,72031,35925,0.3764589277112898,0.4692030405140663
7453,0.7453,14,33,14,565002,40608,72045,35911,0.3761532476194005,0.4693082763758021
7454,0.7454,21,32,21,565034,40576,72066,35890,0.37585683056059876,0.4693589307666152
7455,0.7455,15,34,15,565068,40542,72081,35875,0.37554188743562195,0.4694636010311842
7456,0.7456,16,28,16,565096,40514,72097,35859,0.3752825225091704,0.469524570201511
7457,0.7457,16,35,16,565131,40479,72113,35843,0.374958316351106,0.4696286784937502
7458,0.7458,14,35,14,565166,40444,72127,35829,0.3746341101930416,0.4697468304642534
7459,0.7459,19,42,19,565208,40402,72146,35810,0.37424506280336434,0.46987351073321787
7460,0.746,23,24,23,565232,40378,72169,35787,0.37402275000926305,0.4698614849340248
7461,0.7461,13,32,13,565264,40346,72182,35774,0.3737263329504613,0.46996847083552284
7462,0.7462,20,48,20,565312,40298,72202,35754,0.3732817073622587,0.47012570346604954
7463,0.7463,16,27,16,565339,40271,72218,35738,0.37303160546889474,0.4701811627570419
7464,0.7464,25,37,25,565376,40234,72243,35713,0.3726888732446552,0.47023582234979655
7465,0.7465,21,33,21,565409,40201,72264,35692,0.37238319315276597,0.4702937029765591
7466,0.7466,15,31,15,565440,40170,72279,35677,0.37209603912705175,0.47038116207628516
7467,0.7467,12,41,12,565481,40129,72291,35665,0.37171625477046205,0.47055175871441013
7468,0.7468,14,38,14,565519,40091,72305,35651,0.37136425951313495,0.4706899738586253
7469,0.7469,14,29,14,565548,40062,72319,35637,0.37109563155359593,0.4707724012206238
7470,0.747,14,40,14,565588,40022,72333,35623,0.37072511023009375,0.47092339216075085
7471,0.7471,25,41,25,565629,39981,72358,35598,0.370345325873504,0.4710038502758703
7472,0.7472,21,33,21,565662,39948,72379,35577,0.37003964578161475,0.4710625620655412
7473,0.7473,16,38,16,565700,39910,72395,35561,0.36968765052428765,0.4711876084853785
7474,0.7474,12,51,12,565751,39859,72407,35549,0.3692152358368224,0.4714221302779546
7475,0.7475,21,38,21,565789,39821,72428,35528,0.3688632405794954,0.47151256154693494
7476,0.7476,13,32,13,565821,39789,72441,35515,0.36856682352069364,0.4716216934027409
7477,0.7477,16,29,16,565850,39760,72457,35499,0.36829819556115456,0.4716910934240423
7478,0.7478,14,34,14,565884,39726,72471,35485,0.3679832524361777,0.4718059858265413
7479,0.7479,20,33,20,565917,39693,72491,35465,0.36767757234428844,0.47187258841374174
7480,0.748,20,27,20,565944,39666,72511,35445,0.36742747045092444,0.4719015856532332
7481,0.7481,15,29,15,565973,39637,72526,35430,0.36715884249138536,0.4719783659930462
7482,0.7482,15,34,15,566007,39603,72541,35415,0.36684389936640854,0.47208669919219387
7483,0.7483,11,28,11,566035,39575,72552,35404,0.36658453443995703,0.4721855452860134
7484,0.7484,19,47,19,566082,39528,72571,35385,0.366149171884842,0.47234792359136596
7485,0.7485,15,31,15,566113,39497,72586,35370,0.3658620178591278,0.47243778968036654
7486,0.7486,20,45,20,566158,39452,72606,35350,0.36544518137018783,0.4725809470335018
7487,0.7487,19,38,19,566196,39414,72625,35331,0.3650931861128608,0.4726871362632952
7488,0.7488,10,23,10,566219,39391,72635,35321,0.3648801363518471,0.47276207302709067
7489,0.7489,7,36,7,566255,39355,72642,35314,0.3645466671606951,0.47294057774980247
7490,0.749,19,33,19,566288,39322,72661,35295,0.3642409870688058,0.4730155326534168
7491,0.7491,16,32,16,566320,39290,72677,35279,0.3639445700100041,0.4731054459627996
7492,0.7492,18,38,18,566358,39252,72695,35261,0.36359257475267703,0.4732194382188343
7493,0.7493,16,24,16,566382,39228,72711,35245,0.3633702619585757,0.4732587649215152
7494,0.7494,18,31,18,566413,39197,72729,35227,0.3630831079328615,0.47332849618402667
7495,0.7495,16,39,16,566452,39158,72745,35211,0.3627218496424469,0.4734634054511961
7496,0.7496,17,37,17,566489,39121,72762,35194,0.36237911741820744,0.47357868532597724
7497,0.7497,21,36,21,566525,39085,72783,35173,0.3620456482270555,0.4736594037006114
7498,0.7498,19,38,19,566563,39047,72802,35154,0.3616936529697284,0.4737671999029663
7499,0.7499,20,34,20,566597,39013,72822,35134,0.36137870984475157,0.4738425020567252
7500,0.75,18,36,18,566633,38977,72840,35116,0.3610452406535996,0.47394490707624204
7501,0.7501,16,30,16,566663,38947,72856,35100,0.360767349660973,0.4740232554998852
7502,0.7502,8,31,8,566694,38916,72864,35092,0.3604801956352588,0.47416495513998486
7503,0.7503,17,50,17,566744,38866,72881,35075,0.3600170439808811,0.4743646961766814
7504,0.7504,19,38,19,566782,38828,72900,35056,0.35966504872355404,0.47447349899843
7505,0.7505,15,38,15,566820,38790,72915,35041,0.359313053466227,0.47461093578578106
7506,0.7506,19,42,19,566862,38748,72934,35022,0.35892400607654973,0.47474583163887757
7507,0.7507,11,37,11,566899,38711,72945,35011,0.3585812738523102,0.474905726920051
7508,0.7508,19,41,19,566940,38670,72964,34992,0.3582014894957205,0.4750346175775841
7509,0.7509,16,32,16,566972,38638,72980,34976,0.35790507243691877,0.47512701388322875
7510,0.751,15,32,15,567004,38606,72995,34961,0.35760865537811704,0.4752266641292971
7511,0.7511,17,41,17,567045,38565,73012,34944,0.3572288710215273,0.47537036281271683
7512,0.7512,16,43,16,567088,38522,73028,34928,0.35683056059876245,0.47553437712729746
7513,0.7513,23,29,23,567117,38493,73051,34905,0.35656193263922337,0.47555791710945805
7514,0.7514,14,35,14,567152,38458,73065,34891,0.356237726481159,0.475684740078256
7515,0.7515,23,34,23,567186,38424,73088,34868,0.35592278335618216,0.47574087212792665
7516,0.7516,19,33,19,567219,38391,73107,34849,0.35561710326429286,0.4758192244675041
7517,0.7517,15,22,15,567241,38369,73122,34834,0.35541331653636665,0.47585481469338686
7518,0.7518,19,36,19,567277,38333,73141,34815,0.3550798473452147,0.47595286268934217
7519,0.7519,11,35,11,567312,38298,73152,34804,0.3547556411871503,0.4761018850373451
7520,0.752,8,33,8,567345,38265,73160,34796,0.35444996109526106,0.4762595639260344
7521,0.7521,21,32,21,567377,38233,73181,34775,0.3541535440364593,0.47631766381766383
7522,0.7522,15,32,15,567409,38201,73196,34760,0.3538571269776576,0.47641890873206233
7523,0.7523,17,37,17,567446,38164,73213,34743,0.35351439475341806,0.476538603974927
7524,0.7524,20,31,20,567477,38133,73233,34723,0.3532272407277039,0.476597672120347
7525,0.7525,27,40,27,567517,38093,73260,34696,0.3528567194042017,0.4766654302161041
7526,0.7526,12,25,12,567542,38068,73272,34684,0.35262514357701286,0.4767429074114801
7527,0.7527,11,33,11,567575,38035,73283,34673,0.35231946348512355,0.47688012323265666
7528,0.7528,20,32,20,567607,38003,73303,34653,0.3520230464263218,0.4769461572340894
7529,0.7529,13,22,13,567629,37981,73316,34640,0.35181925969839567,0.47699701188361493
7530,0.753,16,32,16,567661,37949,73332,34624,0.35152284263959394,0.4770920314717595
7531,0.7531,14,28,14,567689,37921,73346,34610,0.35126347771314237,0.4771752767782052
7532,0.7532,15,47,15,567736,37874,73361,34595,0.35082811515802736,0.4773765334142875
7533,0.7533,16,45,16,567781,37829,73377,34579,0.3504112786690874,0.47755772842779803
7534,0.7534,16,38,16,567819,37791,73393,34563,0.35005928341176035,0.47769300937059456
7535,0.7535,9,31,9,567850,37760,73402,34554,0.3497721293860462,0.4778327847996239
7536,0.7536,20,38,20,567888,37722,73422,34534,0.3494201341287191,0.47793954827280777
7537,0.7537,19,45,19,567933,37677,73441,34515,0.34900329763977916,0.4781000664893617
7538,0.7538,19,40,19,567973,37637,73460,34496,0.348632776316277,0.47822771824269056
7539,0.7539,13,28,13,568001,37609,73473,34483,0.34837341138982547,0.4783193696942795
7540,0.754,11,35,11,568036,37574,73484,34472,0.3480492052317611,0.4784720872775727
7541,0.7541,14,34,14,568070,37540,73498,34458,0.34773426210678426,0.4785966276841023
7542,0.7542,13,29,13,568099,37511,73511,34445,0.3474656341472452,0.47869531380287955
7543,0.7543,14,29,14,568128,37482,73525,34431,0.3471970061877061,0.4787868674648534
7544,0.7544,18,34,18,568162,37448,73543,34413,0.3468820630627293,0.4788828432668624
7545,0.7545,26,28,26,568190,37420,73569,34387,0.3466226981362777,0.4788808890498141
7546,0.7546,17,37,17,568227,37383,73586,34370,0.34627996591203825,0.47900436218694686
7547,0.7547,18,38,18,568265,37345,73604,34352,0.3459279706547112,0.47912743908392263
7548,0.7548,21,34,21,568299,37311,73625,34331,0.34561302752973433,0.47920214399374667
7549,0.7549,18,37,18,568336,37274,73643,34313,0.34527029530549486,0.47931887074468826
7550,0.755,21,28,21,568364,37246,73664,34292,0.3450109303790433,0.47935363023847466
7551,0.7551,13,26,13,568390,37220,73677,34279,0.3447700915187669,0.4794332787871159
7552,0.7552,11,34,11,568424,37186,73688,34268,0.34445514839379004,0.4795812690682117
7553,0.7553,20,34,20,568458,37152,73708,34248,0.3441402052688132,0.4796638655462185
7554,0.7554,18,41,18,568499,37111,73726,34230,0.3437604209122235,0.4798082449082575
7555,0.7555,21,37,21,568536,37074,73747,34209,0.343417688687984,0.47990404444257395
7556,0.7556,21,30,21,568566,37044,73768,34188,0.34313979769535735,0.47995283018867924
7557,0.7557,15,30,15,568596,37014,73783,34173,0.34286190670273076,0.48004551392810485
7558,0.7558,20,36,20,568632,36978,73803,34153,0.3425284375115788,0.48014227270810195
7559,0.7559,16,45,16,568677,36933,73819,34137,0.3421116010226389,0.4803292528493035
7560,0.756,13,47,13,568724,36886,73832,34124,0.3416762384675238,0.4805520349246585
7561,0.7561,11,25,11,568749,36861,73843,34113,0.34144466264033496,0.4806407980387184
7562,0.7562,19,29,19,568778,36832,73862,34094,0.3411760346807959,0.4806981924823055
7563,0.7563,16,36,16,568814,36796,73878,34078,0.3408425654896439,0.48082512628044133
7564,0.7564,15,43,15,568857,36753,73893,34063,0.3404442550668791,0.48100711703569815
7565,0.7565,21,33,21,568890,36720,73914,34042,0.34013857497498984,0.4810774144314745
7566,0.7566,22,39,22,568929,36681,73936,34020,0.33977731668457517,0.48118131285271776
7567,0.7567,21,44,21,568973,36637,73957,33999,0.3393697432287228,0.4813268021971799
7568,0.7568,15,40,15,569013,36597,73972,33984,0.33899922190522064,0.4814893526586475
7569,0.7569,18,35,18,569048,36562,73990,33966,0.33867501574715625,0.48159596188747733
7570,0.757,15,29,15,569077,36533,74005,33951,0.33840638778761717,0.4816837863912377
7571,0.7571,17,43,17,569120,36490,74022,33934,0.33800807736485233,0.48185277746222877
7572,0.7572,14,22,14,569142,36468,74036,33920,0.33780429063692613,0.4819003239188498
7573,0.7573,10,30,10,569172,36438,74046,33910,0.33752639964429954,0.4820321828623415
7574,0.7574,16,36,16,569208,36402,74062,33894,0.3371929304531476,0.48216114714919767
7575,0.7575,20,24,20,569232,36378,74082,33874,0.3369706176590463,0.4821784433183397
7576,0.7576,16,32,16,569264,36346,74098,33858,0.33667420060024456,0.4822802119537348
7577,0.7577,16,30,16,569294,36316,74114,33842,0.3363963096076179,0.4823683685395821
7578,0.7578,13,21,13,569315,36295,74127,33829,0.33620178591277927,0.4824168615595231
7579,0.7579,24,29,24,569344,36266,74151,33805,0.3359331579532402,0.4824392401992265
7580,0.758,13,32,13,569376,36234,74164,33792,0.33563674089443846,0.4825636192271442
7581,0.7581,21,20,21,569396,36214,74185,33771,0.3354514802326874,0.48254625991283845
7582,0.7582,10,29,10,569425,36185,74195,33761,0.3351828522731483,0.48267234723929886
7583,0.7583,25,35,25,569460,36150,74220,33736,0.3348586461150839,0.4827290158257734
7584,0.7584,16,38,16,569498,36112,74236,33720,0.3345066508577569,0.48287318134952456
7585,0.7585,17,27,17,569525,36085,74253,33703,0.3342565489643929,0.4829340287728549
7586,0.7586,18,34,18,569559,36051,74271,33685,0.33394160583941607,0.4830360215670529
7587,0.7587,14,31,14,569590,36020,74285,33671,0.3336544518137019,0.48314703476776055
7588,0.7588,20,51,20,569641,35969,74305,33651,0.3331820371262366,0.483352484918127
7589,0.7589,17,43,17,569684,35926,74322,33634,0.3327837267034718,0.4835250143760782
7590,0.759,10,35,10,569719,35891,74332,33624,0.3324595205454074,0.48369416672660576
7591,0.7591,26,29,26,569748,35862,74358,33598,0.3321908925858683,0.4837028505614742
7592,0.7592,17,36,17,569784,35826,74375,33581,0.33185742339471636,0.48382727966919764
7593,0.7593,19,36,19,569820,35790,74394,33562,0.3315239542035644,0.4839370169569731
7594,0.7594,13,32,13,569852,35758,74407,33549,0.33122753714476266,0.48406365879348406
7595,0.7595,19,34,19,569886,35724,74426,33530,0.33091259401978584,0.48415975972507
7596,0.7596,17,33,17,569919,35691,74443,33513,0.33060691392789654,0.48426391538061386
7597,0.7597,26,40,26,569959,35651,74469,33487,0.33023639260439436,0.48435014029911194
7598,0.7598,17,34,17,569993,35617,74486,33470,0.32992144947941754,0.48446162085486416
7599,0.7599,11,30,11,570023,35587,74497,33459,0.3296435584867909,0.484589983489268
7600,0.76,19,37,19,570060,35550,74516,33440,0.3293008262625514,0.4847079286853167
7601,0.7601,11,30,11,570090,35520,74527,33429,0.32902293526992477,0.4848366183700996
7602,0.7602,11,29,11,570119,35491,74538,33418,0.3287543073103857,0.4849584234279992
7603,0.7603,25,29,25,570148,35462,74563,33393,0.32848567935084666,0.4849756735168107
7604,0.7604,17,47,17,570195,35415,74580,33376,0.3280503167957316,0.4851797473506709
7605,0.7605,16,28,16,570223,35387,74596,33360,0.3277909518692801,0.48525753851077136
7606,0.7606,14,34,14,570257,35353,74610,33346,0.3274760087443032,0.4853928004774451
7607,0.7607,21,34,21,570291,35319,74631,33325,0.3271610656193264,0.4854757881242352
7608,0.7608,25,29,25,570320,35290,74656,33300,0.3268924376597873,0.4854935121737863
7609,0.7609,20,41,20,570361,35249,74676,33280,0.3265126533031976,0.48563381925899984
7610,0.761,18,47,18,570408,35202,74694,33262,0.32607729074808256,0.4858319700864688
7611,0.7611,14,24,14,570432,35178,74708,33248,0.3258549779539813,0.48589717358898665
7612,0.7612,25,34,25,570466,35144,74733,33223,0.3255400348290044,0.48595082422806324
7613,0.7613,13,48,13,570514,35096,74746,33210,0.3250954092408018,0.48619447779111646
7614,0.7614,21,28,21,570542,35068,74767,33189,0.3248360443143503,0.48623584394274577
7615,0.7615,13,30,13,570572,35038,74780,33176,0.32455815332172366,0.4863517752953939
7616,0.7616,21,32,21,570604,35006,74801,33155,0.32426173626292193,0.4864218541394639
7617,0.7617,17,31,17,570635,34975,74818,33138,0.32397458223720776,0.4865150558630511
7618,0.7618,21,32,21,570667,34943,74839,33117,0.32367816517840603,0.4865853658536585
7619,0.7619,15,33,15,570700,34910,74854,33102,0.3233724850865167,0.4867082279597718
7620,0.762,17,29,17,570729,34881,74871,33085,0.32310385712697764,0.4867875114027602
7621,0.7621,15,23,15,570752,34858,74886,33070,0.3228908073659639,0.48683900600635965
7622,0.7622,25,27,25,570779,34831,74911,33045,0.32264070547259993,0.4868436560787318
7623,0.7623,16,45,16,570824,34786,74927,33029,0.32222386898366,0.4870456388704564
7624,0.7624,16,41,16,570865,34745,74943,33013,0.3218440846270703,0.4872192213465569
7625,0.7625,13,23,13,570888,34722,74956,33000,0.32163103486605654,0.4872862585275095
7626,0.7626,27,22,27,570910,34700,74983,32973,0.32142724813813034,0.4872401105315266
7627,0.7627,16,30,16,570940,34670,74999,32957,0.32114935714550374,0.48733494018661183
7628,0.7628,18,32,18,570972,34638,75017,32939,0.320852940086702,0.48742915488997735
7629,0.7629,24,43,24,571015,34595,75041,32915,0.3204546296639372,0.48755739890386607
7630,0.763,16,33,16,571048,34562,75057,32899,0.32014894957204787,0.48767436000059294
7631,0.7631,19,29,19,571077,34533,75076,32880,0.3198803216125088,0.48773975346001514
7632,0.7632,12,30,12,571107,34503,75088,32868,0.3196024306198822,0.48786569889121434
7633,0.7633,12,33,12,571140,34470,75100,32856,0.3192967505279929,0.4880135460297656
7634,0.7634,20,30,20,571170,34440,75120,32836,0.31901885953536624,0.48807895832094655
7635,0.7635,19,34,19,571204,34406,75139,32817,0.3187039164103894,0.4881811284828109
7636,0.7636,11,36,11,571240,34370,75150,32806,0.31837044721923746,0.48835893771585087
7637,0.7637,14,26,14,571266,34344,75164,32792,0.31812960835896104,0.488441372735939
7638,0.7638,17,24,17,571290,34320,75181,32775,0.31790729556485975,0.48848647440196735
7639,0.7639,14,51,14,571341,34269,75195,32761,0.3174348808773945,0.4887513053856482
7640,0.764,17,35,17,571376,34234,75212,32744,0.3171106747193301,0.4888769446683986
7641,0.7641,15,38,15,571414,34196,75227,32729,0.31675867946200303,0.48903997011580125
7642,0.7642,7,25,7,571439,34171,75234,32722,0.3165271036348142,0.489169270327239
7643,0.7643,22,37,22,571476,34134,75256,32700,0.3161843714105747,0.4892719274620702
7644,0.7644,16,38,16,571514,34096,75272,32684,0.3158323761532476,0.4894279724468404
7645,0.7645,21,31,21,571545,34065,75293,32663,0.31554522212753344,0.48949466490828436
7646,0.7646,11,38,11,571583,34027,75304,32652,0.3151932268702064,0.48968940745962
7647,0.7647,18,21,18,571604,34006,75322,32634,0.31499870317536777,0.48970588235294116
7648,0.7648,17,35,17,571639,33971,75339,32617,0.3146744970173033,0.4898330029434733
7649,0.7649,23,25,23,571664,33946,75362,32594,0.31444292119011447,0.48984069732491736
7650,0.765,18,26,18,571690,33920,75380,32576,0.3142020823298381,0.4898941289701636
7651,0.7651,19,36,19,571726,33884,75399,32557,0.31386861313868614,0.490013696362186
7652,0.7652,17,22,17,571748,33862,75416,32540,0.31366482641075993,0.49004548055781455
7653,0.7653,17,27,17,571775,33835,75433,32523,0.313414724517396,0.49011422887971307
7654,0.7654,17,19,17,571794,33816,75450,32506,0.31323872688873244,0.49012394077380056
7655,0.7655,23,29,23,571823,33787,75473,32483,0.31297009892919336,0.4901614606911121
7656,0.7656,17,31,17,571854,33756,75490,32466,0.3126829449034792,0.4902600344296457
7657,0.7657,14,40,14,571894,33716,75504,32452,0.312312423579977,0.4904485551928425
7658,0.7658,15,29,15,571923,33687,75519,32437,0.31204379562043794,0.4905480612183171
7659,0.7659,13,43,13,571966,33644,75532,32424,0.3116454851976731,0.49076708845431977
7660,0.766,16,40,16,572006,33604,75548,32408,0.311274963874171,0.4909410410228443
7661,0.7661,22,23,22,572029,33581,75570,32386,0.3110619141131572,0.4909424409174284
7662,0.7662,21,29,21,572058,33552,75591,32365,0.3107932861536181,0.4909962528634495
7663,0.7663,12,25,12,572083,33527,75603,32353,0.31056171032642926,0.49108986035215546
7664,0.7664,15,41,15,572124,33486,75618,32338,0.31018192596983957,0.49127977637335923
7665,0.7665,15,32,15,572156,33454,75633,32323,0.30988550891103783,0.4914027699651854
7666,0.7666,19,33,19,572189,33421,75652,32304,0.30957982881914853,0.4915024724229745
7667,0.7667,18,36,18,572225,33385,75670,32286,0.30924635962799657,0.4916325318633796
7668,0.7668,12,39,12,572264,33346,75682,32274,0.30888510133758196,0.4918317586101798
7669,0.7669,17,37,17,572301,33309,75699,32257,0.3085423691133425,0.49197754933959675
7670,0.767,21,34,21,572335,33275,75720,32236,0.3082274259883656,0.49207003404008487
7671,0.7671,18,41,18,572376,33234,75738,32218,0.3078476416317759,0.4922385870561633
7672,0.7672,15,42,15,572418,33192,75753,32203,0.30745859424209865,0.49243825980579553
7673,0.7673,20,33,20,572451,33159,75773,32183,0.30715291415020934,0.492531602950629
7674,0.7674,14,29,14,572480,33130,75787,32169,0.30688428619067026,0.4926415412180891
7675,0.7675,23,50,23,572530,33080,75810,32146,0.30642113453629255,0.49284027841658234
7676,0.7676,16,34,16,572564,33046,75826,32130,0.30610619141131573,0.49297287345034985
7677,0.7677,16,33,16,572597,33013,75842,32114,0.3058005113194264,0.4930981006341456
7678,0.7678,16,40,16,572637,32973,75858,32098,0.30542998999592424,0.4932765748182754
7679,0.7679,18,28,18,572665,32945,75876,32080,0.30517062506947273,0.4933487120338331
7680,0.768,15,40,15,572705,32905,75891,32065,0.3048001037459706,0.4935354779128829
7681,0.7681,18,33,18,572738,32872,75909,32047,0.3044944236540813,0.49364592800258783
7682,0.7682,7,28,7,572766,32844,75916,32040,0.3042350587276298,0.4938043277233216
7683,0.7683,18,30,18,572796,32814,75934,32022,0.30395716773500314,0.49389228206551916
7684,0.7684,14,28,14,572824,32786,75948,32008,0.30369780280855163,0.4939963576874402
7685,0.7685,12,35,12,572859,32751,75960,31996,0.30337359665048724,0.49416961403617155
7686,0.7686,19,26,19,572885,32725,75979,31977,0.3031327577902108,0.49421965317919075
7687,0.7687,17,33,17,572918,32692,75996,31960,0.3028270776983215,0.4943389222297841
7688,0.7688,13,33,13,572951,32659,76009,31947,0.30252139760643226,0.49448967588149706
7689,0.7689,16,30,16,572981,32629,76025,31931,0.3022435066138056,0.49459417596034694
7690,0.769,16,29,16,573010,32600,76041,31915,0.30197487865426653,0.4946911570952492
7691,0.7691,19,39,19,573049,32561,76060,31896,0.3016136203638519,0.4948415222551468
7692,0.7692,12,31,12,573080,32530,76072,31884,0.30132646633813776,0.4949855621448753
7693,0.7693,15,24,15,573104,32506,76087,31869,0.30110415354403647,0.495052427184466
7694,0.7694,22,30,22,573134,32476,76109,31847,0.3008262625514098,0.4951106136218771
7695,0.7695,19,41,19,573175,32435,76128,31828,0.3004464781948201,0.49527722017335013
7696,0.7696,20,36,20,573211,32399,76148,31808,0.30011300900366816,0.49539769807030387
7697,0.7697,20,25,20,573236,32374,76168,31788,0.2998814331764793,0.49543343411988405
7698,0.7698,14,35,14,573271,32339,76182,31774,0.2995572270184149,0.4955937173428166
7699,0.7699,25,24,25,573295,32315,76207,31749,0.29933491422431363,0.49558254245754246
7700,0.77,20,28,20,573323,32287,76227,31729,0.29907554929786206,0.49564171457135714
7701,0.7701,14,30,14,573353,32257,76241,31715,0.29879765830523547,0.49576377165009694
7702,0.7702,15,25,15,573378,32232,76256,31700,0.2985660824780466,0.49583932928736785
7703,0.7703,17,32,17,573410,32200,76273,31683,0.2982696654192449,0.49595354006543213
7704,0.7704,16,35,16,573445,32165,76289,31667,0.2979454592611805,0.49609913522997867
7705,0.7705,22,33,22,573478,32132,76311,31645,0.2976397791692912,0.4961820091882654
7706,0.7706,17,29,17,573507,32103,76328,31628,0.2973711512097521,0.4962733991307213
7707,0.7707,13,31,13,573538,32072,76341,31615,0.29708399718403794,0.49641214062524536
7708,0.7708,17,41,17,573579,32031,76358,31598,0.29670421282744824,0.49659746342076727
7709,0.7709,13,36,13,573615,31995,76371,31585,0.2963707436362963,0.49677571563384715
7710,0.771,22,29,22,573644,31966,76393,31563,0.2961021156767572,0.4968282201829086
7711,0.7711,18,36,18,573680,31930,76411,31545,0.29576864648560525,0.49696730996455296
7712,0.7712,15,27,15,573707,31903,76426,31530,0.2955185445922413,0.4970598899626377
7713,0.7713,20,29,20,573736,31874,76446,31510,0.2952499166327022,0.4971286128991544
7714,0.7714,10,27,10,573763,31847,76456,31500,0.29499981473933823,0.4972611173378376
7715,0.7715,14,29,14,573792,31818,76470,31486,0.2947311867797992,0.49737773284468595
7716,0.7716,19,30,19,573822,31788,76489,31467,0.29445329578717255,0.49746265117382027
7717,0.7717,13,31,13,573853,31757,76502,31454,0.2941661417614584,0.4976032652544652
7718,0.7718,20,31,20,573884,31726,76522,31434,0.29387898773574417,0.49768841038632045
7719,0.7719,18,37,18,573921,31689,76540,31416,0.2935362555115047,0.4978369384359401
7720,0.772,19,27,19,573948,31662,76559,31397,0.2932861536181407,0.49789879319367575
7721,0.7721,13,45,13,573993,31617,76572,31384,0.2928693171292008,0.4981508230028095
7722,0.7722,22,39,22,574032,31578,76594,31362,0.29250805883878617,0.4982840800762631
7723,0.7723,18,26,18,574058,31552,76612,31344,0.29226721997850974,0.49834647672348004
7724,0.7724,20,18,20,574076,31534,76632,31324,0.29210048538293376,0.49832956823316044
7725,0.7725,19,36,19,574112,31498,76651,31305,0.29176701619178186,0.4984634491982867
7726,0.7726,13,29,13,574141,31469,76664,31292,0.2914983882322428,0.49858988862510156
7727,0.7727,16,30,16,574171,31439,76680,31276,0.2912204972396161,0.4987004703818863
7728,0.7728,20,27,20,574198,31412,76700,31256,0.2909703953462522,0.49875534563094404
7729,0.7729,17,30,17,574228,31382,76717,31239,0.29069250435362554,0.4988582105044634
7730,0.773,16,23,16,574251,31359,76733,31223,0.2904794545926118,0.4989134255856317
7731,0.7731,20,24,20,574275,31335,76753,31203,0.29025714179851053,0.498944641657872
7732,0.7732,13,35,13,574310,31300,76766,31190,0.2899329356404461,0.4991198591774684
7733,0.7733,12,35,12,574345,31265,76778,31178,0.2896087294823817,0.4993033646685777
7734,0.7734,11,28,11,574373,31237,76789,31167,0.2893493645559302,0.49943913851676175
7735,0.7735,15,31,15,574404,31206,76804,31152,0.289062210530216,0.49956701626094485
7736,0.7736,18,32,18,574436,31174,76822,31134,0.2887657934714143,0.4996790139307954
7737,0.7737,16,28,16,574464,31146,76838,31118,0.2885064285449628,0.499775150970063
7738,0.7738,17,30,17,574494,31116,76855,31101,0.28822853755233613,0.49987945416847485
7739,0.7739,19,43,19,574537,31073,76874,31082,0.2878302271295713,0.5000723996460462
7740,0.774,18,24,18,574561,31049,76892,31064,0.28760791433547,0.5001207476695699
7741,0.7741,27,21,27,574582,31028,76919,31037,0.28741339064063137,0.5000725046322404
7742,0.7742,16,37,16,574619,30991,76935,31021,0.28707065841639184,0.5002418886667097
7743,0.7743,21,26,21,574645,30965,76956,31000,0.2868298195561155,0.5002824174937465
7744,0.7744,13,26,13,574671,30939,76969,30987,0.28658898069583905,0.5003875593450247
7745,0.7745,15,23,15,574694,30916,76984,30972,0.2863759309348253,0.500452430196484
7746,0.7746,17,43,17,574737,30873,77001,30955,0.2859776205120605,0.5006631299734748
7747,0.7747,9,25,9,574762,30848,77010,30946,0.28574604468487164,0.50079295724504
7748,0.7748,17,21,17,574783,30827,77027,30929,0.285551520990033,0.500825830688516
7749,0.7749,10,29,10,574812,30798,77037,30919,0.2852828930304939,0.5009802809598652
7750,0.775,22,29,22,574841,30769,77059,30897,0.28501426507095484,0.5010378490578277
7751,0.7751,13,28,13,574869,30741,77072,30884,0.28475490014450333,0.5011602434077079
7752,0.7752,17,27,17,574896,30714,77089,30867,0.28450479825113933,0.5012422662834316
7753,0.7753,15,33,15,574929,30681,77104,30852,0.2841991181592501,0.5013894983179757
7754,0.7754,12,38,12,574967,30643,77116,30840,0.283847122901923,0.5016020688645642
7755,0.7755,15,33,15,575000,30610,77131,30825,0.28354144281003374,0.5017498168796288
7756,0.7756,27,29,27,575029,30581,77158,30798,0.28327281485049466,0.5017677055670506
7757,0.7757,24,39,24,575068,30542,77182,30774,0.28291155656008005,0.5018918389979777
7758,0.7758,17,19,17,575087,30523,77199,30757,0.2827355589314165,0.5019092689295039
7759,0.7759,22,30,22,575117,30493,77221,30735,0.2824576679387899,0.5019762200300516
7760,0.776,15,28,15,575145,30465,77236,30720,0.28219830301233834,0.5020838440794312
7761,0.7761,19,31,19,575176,30434,77255,30701,0.28191114898662417,0.5021836918295576
7762,0.7762,15,28,15,575204,30406,77270,30686,0.28165178406017266,0.5022916257447784
7763,0.7763,14,27,14,575231,30379,77284,30672,0.2814016821668087,0.502399633093643
7764,0.7764,17,32,17,575263,30347,77301,30655,0.281105265108007,0.5025245073932002
7765,0.7765,15,28,15,575291,30319,77316,30640,0.2808459001815555,0.502632917206647
7766,0.7766,13,34,13,575325,30285,77329,30627,0.2805309570565786,0.5028073286052009
7767,0.7767,20,31,20,575356,30254,77349,30607,0.28024380303086444,0.5029000509357389
7768,0.7768,10,23,10,575379,30231,77359,30597,0.28003075326985066,0.5030084829354903
7769,0.7769,20,39,20,575418,30192,77379,30577,0.27966949497943605,0.5031677335483552
7770,0.777,22,33,22,575451,30159,77401,30555,0.2793638148875468,0.5032611918173733
7771,0.7771,26,28,26,575479,30131,77427,30529,0.27910444996109524,0.5032805802835476
7772,0.7772,20,32,20,575511,30099,77447,30509,0.2788080329022935,0.5033823917634636
7773,0.7773,22,29,22,575540,30070,77469,30487,0.2785394049427545,0.5034430371385636
7774,0.7774,9,33,9,575573,30037,77478,30478,0.27823372485086517,0.5036437246963563
7775,0.7775,17,30,17,575603,30007,77495,30461,0.2779558338582385,0.5037540517298406
7776,0.7776,9,21,9,575624,29986,77504,30452,0.2777613101633999,0.5038551904430987
7777,0.7777,17,32,17,575656,29954,77521,30435,0.27746489310459815,0.5039825133716406
7778,0.7778,18,24,18,575680,29930,77539,30417,0.27724258031049687,0.5040349975972294
7779,0.7779,18,26,18,575706,29904,77557,30399,0.27700174145022044,0.5041042734192329
7780,0.778,27,33,27,575739,29871,77584,30372,0.2766960613583312,0.5041581594542105
7781,0.7781,13,26,13,575765,29845,77597,30359,0.27645522249805476,0.5042688193475516
7782,0.7782,16,28,16,575793,29817,77613,30343,0.27619585757160325,0.5043716755319149
7783,0.7783,19,31,19,575824,29786,77632,30324,0.2759087035458891,0.5044751289302944
7784,0.7784,15,28,15,575852,29758,77647,30309,0.2756493386194375,0.5045865450247224
7785,0.7785,17,29,17,575881,29729,77664,30292,0.2753807106598985,0.5046900251578614
7786,0.7786,14,37,14,575918,29692,77678,30278,0.27503797843565897,0.504885776221444
7787,0.7787,14,36,14,575954,29656,77692,30264,0.274704509244507,0.5050734312416555
7788,0.7788,12,38,12,575992,29618,77704,30252,0.27435251398717997,0.5052948054117254
7789,0.7789,27,39,27,576031,29579,77731,30225,0.27399125569676536,0.5054009765233095
7790,0.779,20,27,20,576058,29552,77751,30205,0.27374115380340136,0.5054637950365648
7791,0.7791,11,24,11,576082,29528,77762,30194,0.2735188410093001,0.5055758347007803
7792,0.7792,25,38,25,576120,29490,77787,30169,0.27316684575197303,0.5056906753381719
7793,0.7793,16,21,16,576141,29469,77803,30153,0.2729723220571344,0.505736137667304
7794,0.7794,23,34,23,576175,29435,77826,30130,0.2726573789321575,0.5058339628976748
7795,0.7795,12,28,12,576203,29407,77838,30118,0.272398014005706,0.5059722805543889
7796,0.7796,15,22,15,576225,29385,77853,30103,0.2721942272777798,0.5060348305540613
7797,0.7797,15,30,15,576255,29355,77868,30088,0.2719163362851532,0.5061655703783456
7798,0.7798,24,36,24,576291,29319,77892,30064,0.27158286709400126,0.5062728390280047
7799,0.7799,12,28,12,576319,29291,77904,30052,0.27132350216754975,0.5064118767167147
7800,0.78,24,35,24,576354,29256,77928,30028,0.27099929600948536,0.5065110316442885
7801,0.7801,29,35,29,576389,29221,77957,29999,0.27067508985142097,0.5065687267814928
7802,0.7802,16,39,16,576428,29182,77973,29983,0.27031383156100636,0.5067692047663315
7803,0.7803,14,27,14,576455,29155,77987,29969,0.27006372966764236,0.5068838373587714
7804,0.7804,17,28,17,576483,29127,78004,29952,0.26980436474119085,0.5069821764078607
7805,0.7805,18,26,18,576509,29101,78022,29934,0.2695635258809144,0.5070551367832642
7806,0.7806,18,34,18,576543,29067,78040,29916,0.2692485827559376,0.5071969889629215
7807,0.7807,13,39,13,576582,29028,78053,29903,0.268887324465523,0.5074239364680728
7808,0.7808,26,29,26,576611,28999,78079,29877,0.2686186965059839,0.5074563489367484
7809,0.7809,20,38,20,576649,28961,78099,29857,0.26826670124865687,0.5076167159713013
7810,0.781,14,37,14,576686,28924,78113,29843,0.26792396902441734,0.5078190140725237
7811,0.7811,22,30,22,576716,28894,78135,29821,0.26764607803179075,0.507894064549093
7812,0.7812,11,35,11,576751,28859,78146,29810,0.26732187187372636,0.5081047912867102
7813,0.7813,21,26,21,576777,28833,78167,29789,0.26708103301344993,0.5081539353826209
7814,0.7814,18,34,18,576811,28799,78185,29771,0.26676608988847306,0.5082977633600819
7815,0.7815,19,21,19,576832,28778,78204,29752,0.2665715661936344,0.5083205193917649
7816,0.7816,8,20,8,576852,28758,78212,29744,0.26638630553188336,0.5084270623226557
7817,0.7817,14,28,14,576880,28730,78226,29730,0.26612694060543185,0.5085528566541225
7818,0.7818,22,30,22,576910,28700,78248,29708,0.2658490496128052,0.5086289549376798
7819,0.7819,13,29,13,576939,28671,78261,29695,0.2655804216532661,0.5087722304081144
7820,0.782,18,32,18,576971,28639,78279,29677,0.2652840045944644,0.5088997873653885
7821,0.7821,23,28,23,576999,28611,78302,29654,0.2650246396680129,0.5089504848536858
7822,0.7822,17,26,17,577025,28585,78319,29637,0.2647838008077365,0.5090343856274261
7823,0.7823,12,19,12,577044,28566,78331,29625,0.26460780317907295,0.5090993452595762
7824,0.7824,17,26,17,577070,28540,78348,29608,0.2643669643187965,0.5091834628878036
7825,0.7825,21,32,21,577102,28508,78369,29587,0.2640705472599948,0.5092865134693175
7826,0.7826,19,30,19,577132,28478,78388,29568,0.2637926562673682,0.5093891051924336
7827,0.7827,13,32,13,577164,28446,78401,29555,0.26349623920856646,0.5095601799968966
7828,0.7828,13,25,13,577189,28421,78414,29542,0.2632646633813776,0.5096699618722288
7829,0.7829,18,33,18,577222,28388,78432,29524,0.2629589832894883,0.5098079845282497
7830,0.783,16,36,16,577258,28352,78448,29508,0.26262551409833634,0.5099896301417214
7831,0.7831,15,43,15,577301,28309,78463,29493,0.2622272036755715,0.5102418601432477
7832,0.7832,17,27,17,577328,28282,78480,29476,0.26197710178220757,0.5103362304788946
7833,0.7833,15,31,15,577359,28251,78495,29461,0.2616899477564934,0.5104830884391461
7834,0.7834,15,32,15,577391,28219,78510,29446,0.26139353069769167,0.5106390358102836
7835,0.7835,18,28,18,577419,28191,78528,29428,0.26113416577124016,0.5107343063919888
7836,0.7836,21,28,21,577447,28163,78549,29407,0.2608748008447886,0.5108042383185687
7837,0.7837,14,35,14,577482,28128,78563,29393,0.2605505946867242,0.5109959840753812
7838,0.7838,12,36,12,577518,28092,78575,29381,0.26021712549557224,0.5112139613383676
7839,0.7839,20,32,20,577550,28060,78595,29361,0.2599207084367705,0.5113286080005572
7840,0.784,24,26,24,577576,28034,78619,29337,0.25967986957649414,0.5113559115232434
7841,0.7841,19,50,19,577626,27984,78638,29318,0.2592167179221164,0.5116400823705979
7842,0.7842,21,32,21,577658,27952,78659,29297,0.2589203008633147,0.5117469300773813
7843,0.7843,15,29,15,577687,27923,78674,29282,0.2586516729037756,0.5118783323136089
7844,0.7844,16,21,16,577708,27902,78690,29266,0.258457149208937,0.5119297509095998
7845,0.7845,16,29,16,577737,27873,78706,29250,0.2581885212493979,0.5120529383960927
7846,0.7846,19,28,19,577765,27845,78725,29231,0.2579291563229464,0.5121417057957811
7847,0.7847,19,38,19,577803,27807,78744,29212,0.25757716106561934,0.5123204545853137
7848,0.7848,21,34,21,577837,27773,78765,29191,0.25726221794064247,0.5124464574116986
7849,0.7849,14,33,14,577870,27740,78779,29177,0.2569565378487532,0.5126236449566913
7850,0.785,19,31,19,577901,27709,78798,29158,0.256669383823039,0.5127402535741291
7851,0.7851,14,24,14,577925,27685,78812,29144,0.2564470710289377,0.5128367558816801
7852,0.7852,11,32,11,577957,27653,78823,29133,0.256150653970136,0.5130313809741838
7853,0.7853,26,31,26,577988,27622,78849,29107,0.2558634999444218,0.5130885437783145
7854,0.7854,22,30,22,578018,27592,78871,29085,0.25558560895179516,0.513171127617905
7855,0.7855,15,33,15,578051,27559,78886,29070,0.2552799288599059,0.5133412209292059
7856,0.7856,14,35,14,578086,27524,78900,29056,0.25495572270184147,0.5135383527748321
7857,0.7857,16,28,16,578114,27496,78916,29040,0.25469635777538996,0.5136550162728173
7858,0.7858,19,27,19,578141,27469,78935,29021,0.254446255882026,0.5137369445919632
7859,0.7859,14,24,14,578165,27445,78949,29007,0.25422394308792473,0.5138347622759158
7860,0.786,16,21,16,578186,27424,78965,28991,0.2540294193930861,0.5138881503146326
7861,0.7861,20,26,20,578212,27398,78985,28971,0.25378858053280967,0.5139527045007007
7862,0.7862,13,24,13,578236,27374,78998,28958,0.2535662677387084,0.5140595043669672
7863,0.7863,13,22,13,578258,27352,79011,28945,0.2533624810107822,0.5141481784109277
7864,0.7864,18,24,18,578282,27328,79029,28927,0.2531401682166809,0.5142120700382188
7865,0.7865,20,37,20,578319,27291,79049,28907,0.25279743599244137,0.5143777358624863
7866,0.7866,19,30,19,578349,27261,79068,28888,0.2525195449998147,0.5144882366560402
7867,0.7867,21,36,21,578385,27225,79089,28867,0.2521860758086628,0.5146366683305997
7868,0.7868,16,34,16,578419,27191,79105,28851,0.25187113268368594,0.5148103208308055
7869,0.7869,21,27,21,578446,27164,79126,28830,0.251621030790322,0.5148765939207772
7870,0.787,19,33,19,578479,27131,79145,28811,0.2513153506984327,0.5150155518215295
7871,0.7871,25,34,25,578513,27097,79170,28786,0.2510004075734559,0.5151119302829125
7872,0.7872,16,31,16,578544,27066,79186,28770,0.25071325354774165,0.5152589727057812
7873,0.7873,18,34,18,578578,27032,79204,28752,0.25039831042276484,0.5154166069123763
7874,0.7874,13,23,13,578601,27009,79217,28739,0.25018526066175106,0.515516251704097
7875,0.7875,24,35,24,578636,26974,79241,28715,0.24986105450368667,0.5156314532492952
7876,0.7876,24,38,24,578674,26936,79265,28691,0.24950905924635963,0.5157747137181584
7877,0.7877,20,22,20,578696,26914,79285,28671,0.24930527251843343,0.5158046235495187
7878,0.7878,20,43,20,578739,26871,79305,28651,0.2489069620956686,0.5160296819278845
7879,0.7879,12,24,12,578763,26847,79317,28639,0.2486846493015673,0.5161482175683957
7880,0.788,21,35,21,578798,26812,79338,28618,0.24836044314350292,0.5162908172469781
7881,0.7881,19,23,19,578821,26789,79357,28599,0.24814739338248917,0.5163392792662671
7882,0.7882,23,22,23,578843,26767,79380,28576,0.24794360665456297,0.516343530347108
7883,0.7883,15,22,15,578865,26745,79395,28561,0.24773981992663677,0.5164177485263804
7884,0.7884,15,34,15,578899,26711,79410,28546,0.24742487680165995,0.5166042311381364
7885,0.7885,13,30,13,578929,26681,79423,28533,0.2471469858090333,0.5167711087767595
7886,0.7886,19,23,19,578952,26658,79442,28514,0.24693393604801955,0.5168201261509461
7887,0.7887,14,20,14,578972,26638,79456,28500,0.2467486753862685,0.5168849069607168
7888,0.7888,28,31,28,579003,26607,79484,28472,0.2464615213605543,0.5169302274914214
7889,0.7889,21,33,21,579036,26574,79505,28451,0.24615584126866502,0.5170558836892322
7890,0.789,19,26,19,579062,26548,79524,28432,0.2459150024083886,0.5171335030920334
7891,0.7891,16,26,16,579088,26522,79540,28416,0.2456741635481122,0.517237613309549
7892,0.7892,24,28,24,579116,26494,79564,28392,0.24541479862166068,0.5172903837044055
7893,0.7893,22,29,22,579145,26465,79586,28370,0.2451461706621216,0.5173702926962707
7894,0.7894,21,37,21,579182,26428,79607,28349,0.2448034384378821,0.5175347317304708
7895,0.7895,22,44,22,579226,26384,79629,28327,0.24439586498202973,0.5177569410173457
7896,0.7896,14,30,14,579256,26354,79643,28313,0.2441179739894031,0.5179175736733312
7897,0.7897,18,24,18,579280,26330,79661,28295,0.2438956611953018,0.5179862700228833
7898,0.7898,18,36,18,579316,26294,79679,28277,0.24356219200414983,0.5181689908559491
7899,0.7899,13,33,13,579349,26261,79692,28264,0.24325651191226055,0.5183677212287942
7900,0.79,13,22,13,579371,26239,79705,28251,0.24305272518433435,0.5184621031381905
7901,0.7901,21,28,21,579399,26211,79726,28230,0.24279336025788284,0.5185430098638893
7902,0.7902,13,29,13,579428,26182,79739,28217,0.24252473229834376,0.5187043879483079
7903,0.7903,9,22,9,579450,26160,79748,28208,0.24232094557041758,0.5188346085932902
7904,0.7904,23,32,23,579482,26128,79771,28185,0.24202452851161585,0.5189365345313277
7905,0.7905,12,28,12,579510,26100,79783,28173,0.24176516358516434,0.5190978939804323
7906,0.7906,22,30,22,579540,26070,79805,28151,0.2414872725925377,0.5191899817413917
7907,0.7907,26,31,26,579571,26039,79831,28125,0.24120011856682352,0.519256332619452
7908,0.7908,15,21,15,579592,26018,79846,28110,0.2410055948719849,0.5193245639964529
7909,0.7909,24,32,24,579624,25986,79870,28086,0.24070917781318316,0.5194185530403906
7910,0.791,21,29,21,579653,25957,79891,28065,0.24044054985364408,0.5195105697678724
7911,0.7911,21,26,21,579679,25931,79912,28044,0.24019971099336768,0.5195738767948124
7912,0.7912,20,19,20,579698,25912,79932,28024,0.24002371336470413,0.5195787600118659
7913,0.7913,13,23,13,579721,25889,79945,28011,0.23981066360369038,0.5196846011131725
7914,0.7914,20,26,20,579747,25863,79965,27991,0.23956982474341398,0.5197571211052103
7915,0.7915,13,37,13,579784,25826,79978,27978,0.23922709251917448,0.519998513121701
7916,0.7916,24,28,24,579812,25798,80002,27954,0.23896772759272297,0.5200550677184105
7917,0.7917,8,19,8,579831,25779,80010,27946,0.23879172996405942,0.5201675197766403
7918,0.7918,20,26,20,579857,25753,80030,27926,0.23855089110378302,0.5202406900277576
7919,0.7919,24,19,24,579876,25734,80054,27902,0.2383748934751195,0.5202103065105527
7920,0.792,7,26,7,579902,25708,80061,27895,0.23813405461484308,0.5203999776131933
7921,0.7921,14,31,14,579933,25677,80075,27881,0.2378469005891289,0.5205758243399679
7922,0.7922,10,27,10,579960,25650,80085,27871,0.23759679869576494,0.5207488649315222
7923,0.7923,11,35,11,579995,25615,80096,27860,0.23727259253770056,0.5209911173445535
7924,0.7924,20,32,20,580027,25583,80116,27840,0.23697617547889882,0.5211238605095184
7925,0.7925,13,23,13,580050,25560,80129,27827,0.23676312571788508,0.5212317605409557
7926,0.7926,19,47,19,580097,25513,80148,27808,0.23632776316277002,0.5215206016391291
7927,0.7927,23,30,23,580127,25483,80171,27785,0.2360498721701434,0.521607719456334
7928,0.7928,11,29,11,580156,25454,80182,27774,0.2357812442106043,0.5217930412564815
7929,0.7929,13,30,13,580186,25424,80195,27761,0.2355033532179777,0.5219704803986086
7930,0.793,24,32,24,580218,25392,80219,27737,0.23520693615917596,0.5220689265749402
7931,0.7931,17,20,17,580238,25372,80236,27720,0.23502167549742486,0.5221125593309727
7932,0.7932,11,20,11,580258,25352,80247,27709,0.2348364148356738,0.5222102862742881
7933,0.7933,14,33,14,580291,25319,80261,27695,0.2345307347437845,0.5224091749349229
7934,0.7934,21,14,21,580305,25305,80282,27674,0.23440105228055874,0.5223579154004416
7935,0.7935,17,30,17,580335,25275,80299,27657,0.23412316128793212,0.522500566764906
7936,0.7936,10,28,10,580363,25247,80309,27647,0.2338637963614806,0.5226868832003629
7937,0.7937,18,31,18,580394,25216,80327,27629,0.23357664233576642,0.5228309206168985
7938,0.7938,14,27,14,580421,25189,80341,27615,0.23332654044240245,0.5229717445648057
7939,0.7939,13,34,13,580455,25155,80354,27602,0.23301159731742563,0.5231912352863127
7940,0.794,14,34,14,580489,25121,80368,27588,0.23269665419244878,0.5234020755468706
7941,0.7941,15,30,15,580519,25091,80383,27573,0.23241876319982216,0.523564484277685
7942,0.7942,22,32,22,580551,25059,80405,27551,0.23212234614102042,0.5236837103212317
7943,0.7943,19,33,19,580584,25026,80424,27532,0.23181666604913112,0.5238403287796339
7944,0.7944,15,26,15,580610,25000,80439,27517,0.23157582718885472,0.523963668907211
7945,0.7945,20,20,20,580630,24980,80459,27497,0.23139056652710363,0.5239819349429273
7946,0.7946,14,30,14,580660,24950,80473,27483,0.231112675534477,0.5241546354395132
7947,0.7947,20,20,20,580680,24930,80493,27463,0.23092741487272592,0.5241730765560285
7948,0.7948,13,23,13,580703,24907,80506,27450,0.23071436511171217,0.5242851958668373
7949,0.7949,17,23,17,580726,24884,80523,27433,0.23050131535069843,0.5243611063325496
7950,0.795,19,32,19,580758,24852,80542,27414,0.2302048982918967,0.5245092411893009
7951,0.7951,19,33,19,580791,24819,80561,27395,0.22989921820000742,0.52466771364002
7952,0.7952,19,31,19,580822,24788,80580,27376,0.22961206417429322,0.5248063798788436
7953,0.7953,18,16,18,580838,24772,80598,27358,0.22946385564489236,0.5248033761749472
7954,0.7954,19,30,19,580868,24742,80617,27339,0.22918596465226573,0.5249323169678002
7955,0.7955,14,23,14,580891,24719,80631,27325,0.228972914891252,0.5250365075705172
7956,0.7956,20,21,20,580912,24698,80651,27305,0.22877839119641336,0.5250658615849085
7957,0.7957,16,25,16,580937,24673,80667,27289,0.2285468153692245,0.5251722412532235
7958,0.7958,19,29,19,580966,24644,80686,27270,0.22827818740968542,0.5252918287937743
7959,0.7959,17,27,17,580993,24617,80703,27253,0.22802808551632148,0.5254096780412569
7960,0.796,19,30,19,581023,24587,80722,27234,0.22775019452369483,0.5255398390613844
7961,0.7961,13,27,13,581050,24560,80735,27221,0.22750009263033089,0.5256947529016435
7962,0.7962,15,26,15,581076,24534,80750,27206,0.22725925377005446,0.5258214147661384
7963,0.7963,21,22,21,581098,24512,80771,27185,0.22705546704212828,0.5258525639785674
7964,0.7964,20,21,20,581119,24491,80791,27165,0.22686094334728962,0.5258827628929844
7965,0.7965,17,24,17,581143,24467,80808,27148,0.22663863055318834,0.5259711324227453
7966,0.7966,23,22,23,581165,24445,80831,27125,0.22643484382526213,0.5259840992825286
7967,0.7967,22,27,22,581192,24418,80853,27103,0.2261847419318982,0.5260573358436366
7968,0.7968,14,34,14,581226,24384,80867,27089,0.22586979880692135,0.5262759116429973
7969,0.7969,13,36,13,581262,24348,80880,27076,0.2255363296157694,0.5265245799626633
7970,0.797,21,23,21,581285,24325,80901,27055,0.22532327985475564,0.526566757493188
7971,0.7971,22,34,22,581319,24291,80923,27033,0.2250083367297788,0.5267126490530746
7972,0.7972,18,26,18,581345,24265,80941,27015,0.2247674978695024,0.5268135725429017
7973,0.7973,22,28,22,581373,24237,80963,26993,0.22450813294305086,0.5268983017763029
7974,0.7974,17,32,17,581405,24205,80980,26976,0.22421171588424915,0.5270705926027237
7975,0.7975,25,22,25,581427,24183,81005,26951,0.22400792915632295,0.5270661399460241
7976,0.7976,14,26,14,581453,24157,81019,26937,0.22376709029604655,0.5272047598543861
7977,0.7977,12,29,12,581482,24128,81031,26925,0.22349846233650747,0.527393101286898
7978,0.7978,21,18,21,581500,24110,81052,26904,0.2233317277409315,0.5273846395107226
7979,0.7979,20,32,20,581532,24078,81072,26884,0.22303531068212976,0.5275303167065657
7980,0.798,9,33,9,581565,24045,81081,26875,0.22272963059024048,0.5277886881382561
7981,0.7981,18,34,18,581599,24011,81099,26857,0.22241468746526363,0.5279743650231973
7982,0.7982,21,29,21,581628,23982,81120,26836,0.22214605950572455,0.5280806013617222
7983,0.7983,13,25,13,581653,23957,81133,26823,0.2219144836785357,0.5282197715636077
7984,0.7984,13,32,13,581685,23925,81146,26810,0.22161806661973396,0.5284320488814428
7985,0.7985,21,31,21,581716,23894,81167,26789,0.2213309125940198,0.5285598721464791
7986,0.7986,18,27,18,581743,23867,81185,26771,0.22108081070065583,0.5286741182511158
7987,0.7987,12,28,12,581771,23839,81197,26759,0.22082144577420432,0.5288548954504131
7988,0.7988,15,34,15,581805,23805,81212,26744,0.22050650264922747,0.5290708025875883
7989,0.7989,18,24,18,581829,23781,81230,26726,0.22028418985512616,0.5291543746411389
7990,0.799,20,31,20,581860,23750,81250,26706,0.219997035829412,0.5292928492151577
7991,0.7991,17,28,17,581888,23722,81267,26689,0.21973767090296045,0.5294281010097003
7992,0.7992,21,30,21,581918,23692,81288,26668,0.21945977991033383,0.5295472597299444
7993,0.7993,13,23,13,581941,23669,81301,26655,0.21924673014932008,0.5296677529608139
7994,0.7994,15,22,15,581963,23647,81316,26640,0.2190429434213939,0.5297591822936345
7995,0.7995,24,19,24,581982,23628,81340,26616,0.21886694579273036,0.529734893718653
7996,0.7996,16,22,16,582004,23606,81356,26600,0.21866315906480419,0.5298171533282875
7997,0.7997,19,23,19,582027,23583,81375,26581,0.21845010930379044,0.5298819870823698
7998,0.7998,13,30,13,582057,23553,81388,26568,0.21817221831116382,0.5300772131441911
7999,0.7999,17,17,17,582074,23536,81405,26551,0.21801474674867538,0.530097630123585
8000,0.8,20,29,20,582103,23507,81425,26531,0.21774611878913633,0.5302170350533595
8001,0.8001,22,23,22,582126,23484,81447,26509,0.21753306902812256,0.530254235592983
8002,0.8002,19,22,19,582148,23462,81466,26490,0.21732928230019638,0.5303090967328635
8003,0.8003,11,26,11,582174,23436,81477,26479,0.21708844343991995,0.5304818190924572
8004,0.8004,17,36,17,582210,23400,81494,26462,0.21675497424876802,0.5307047450964663
8005,0.8005,19,26,19,582236,23374,81513,26443,0.2165141353884916,0.5308027380211574
8006,0.8006,23,25,23,582261,23349,81536,26420,0.21628255956130274,0.5308525387289277
8007,0.8007,16,18,16,582279,23331,81552,26404,0.2161158249657268,0.5308937368050669
8008,0.8008,8,26,8,582305,23305,81560,26396,0.21587498610545036,0.5310959538037464
8009,0.8009,16,32,16,582337,23273,81576,26380,0.21557856904664863,0.5312871327009445
8010,0.801,19,34,19,582371,23239,81595,26361,0.21526362592167178,0.5314717741935484
8011,0.8011,24,21,24,582392,23218,81619,26337,0.21506910222683315,0.5314700837453334
8012,0.8012,13,26,13,582418,23192,81632,26324,0.21482826336655675,0.5316261410453187
8013,0.8013,16,34,16,582452,23158,81648,26308,0.2145133202415799,0.5318400517527191
8014,0.8014,14,31,14,582483,23127,81662,26294,0.2142261662158657,0.5320410351874709
8015,0.8015,15,25,15,582508,23102,81677,26279,0.21399459038867688,0.5321682428464389
8016,0.8016,12,24,12,582532,23078,81689,26267,0.21377227759457557,0.5323133042861485
8017,0.8017,20,21,20,582553,23057,81709,26247,0.21357775389973693,0.5323503164043485
8018,0.8018,21,33,21,582586,23024,81730,26226,0.21327207380784763,0.5325076142131979
8019,0.8019,13,23,13,582609,23001,81743,26213,0.21305902404683388,0.5326329906124273
8020,0.802,10,22,10,582631,22979,81753,26203,0.2128552373189077,0.5327762189418893
8021,0.8021,13,21,13,582652,22958,81766,26190,0.21266071362406908,0.5328802799707008
8022,0.8022,27,25,27,582677,22933,81793,26163,0.21242913779688022,0.5328947368421053
8023,0.8023,32,24,32,582701,22909,81825,26131,0.2122068250027789,0.5328507340946166
8024,0.8024,15,31,15,582732,22878,81840,26116,0.21191967097706474,0.5330448626362412
8025,0.8025,19,32,19,582764,22846,81859,26097,0.211623253918263,0.5332121038759373
8026,0.8026,23,33,23,582797,22813,81882,26074,0.2113175738263737,0.5333524249800561
8027,0.8027,16,28,16,582825,22785,81898,26058,0.2110582088999222,0.5335053129414655
8028,0.8028,22,24,22,582849,22761,81920,26036,0.2108358961058209,0.5335573908232063
8029,0.8029,18,24,18,582873,22737,81938,26018,0.2106135833117196,0.5336478309916931
8030,0.803,20,27,20,582900,22710,81958,25998,0.21036348141835562,0.5337521557033752
8031,0.8031,15,26,15,582926,22684,81973,25983,0.21012264255807922,0.5338936034684694
8032,0.8032,18,23,18,582949,22661,81991,25965,0.20990959279706548,0.5339735943733805
8033,0.8033,21,15,21,582964,22646,82012,25944,0.20977064730075215,0.5339370240790287
8034,0.8034,18,33,18,582997,22613,82030,25926,0.20946496720886287,0.5341271966872
8035,0.8035,14,26,14,583023,22587,82044,25912,0.20922412834858647,0.5342790573001506
8036,0.8036,16,22,16,583045,22565,82060,25896,0.20902034162066027,0.5343678421823734
8037,0.8037,15,29,15,583074,22536,82075,25881,0.2087517136611212,0.5345436520230498
8038,0.8038,24,28,24,583102,22508,82099,25857,0.20849234873466968,0.534622144112478
8039,0.8039,21,27,21,583129,22481,82120,25836,0.2082422468413057,0.5347186290539562
8040,0.804,24,29,24,583158,22452,82144,25812,0.20797361888176666,0.534808552958727
8041,0.8041,16,16,16,583174,22436,82160,25796,0.2078254103523658,0.53483164703931
8042,0.8042,17,22,17,583196,22414,82177,25779,0.2076216236244396,0.5349117091693815
8043,0.8043,16,32,16,583228,22382,82193,25763,0.20732520656563785,0.5351126804444906
8044,0.8044,12,29,12,583257,22353,82205,25751,0.20705657860609877,0.5353193081656411
8045,0.8045,18,25,18,583282,22328,82223,25733,0.20682500277890992,0.5354237323401511
8046,0.8046,19,26,19,583308,22302,82242,25714,0.20658416391863352,0.5355298233922026
8047,0.8047,19,16,19,583324,22286,82261,25695,0.20643595538923265,0.5355244784393822
8048,0.8048,8,24,8,583348,22262,82269,25687,0.20621364259513136,0.5357150305532962
8049,0.8049,21,40,21,583388,22222,82290,25666,0.20584312127162918,0.535958904109589
8050,0.805,22,20,22,583408,22202,82312,25644,0.2056578606098781,0.5359695690339841
8051,0.8051,16,22,16,583430,22180,82328,25628,0.20545407388195192,0.5360609103078983
8052,0.8052,15,28,15,583458,22152,82343,25613,0.20519470895550038,0.536229456715168
8053,0.8053,13,22,13,583480,22130,82356,25600,0.2049909222275742,0.5363503037921643
8054,0.8054,19,27,19,583507,22103,82375,25581,0.20474082033421023,0.5364692559349048
8055,0.8055,16,23,16,583530,22080,82391,25565,0.2045277705731965,0.536572567950467
8056,0.8056,21,29,21,583559,22051,82412,25544,0.2042591426136574,0.5366950309906503
8057,0.8057,27,24,27,583583,22027,82439,25517,0.20403682981955612,0.5367028436816422
8058,0.8058,18,26,18,583609,22001,82457,25499,0.2037959909592797,0.536821052631579
8059,0.8059,13,21,13,583630,21980,82470,25486,0.20360146726444106,0.5369316984789112
8060,0.806,20,31,20,583661,21949,82490,25466,0.2033143132387269,0.5370874195929558
8061,0.8061,20,23,20,583684,21926,82510,25446,0.20310126347771315,0.5371527484590053
8062,0.8062,10,21,10,583705,21905,82520,25436,0.20290673978287452,0.5372932553178006
8063,0.8063,19,30,19,583735,21875,82539,25417,0.20262884879024787,0.5374481941977501
8064,0.8064,15,25,15,583760,21850,82554,25402,0.202397272963059,0.53758571065775
8065,0.8065,13,29,13,583789,21821,82567,25389,0.20212864500351996,0.5377886041092989
8066,0.8066,13,19,13,583808,21802,82580,25376,0.20195264737485644,0.5378778244096825
8067,0.8067,20,19,20,583827,21783,82600,25356,0.2017766497461929,0.5378985553363457
8068,0.8068,16,25,16,583852,21758,82616,25340,0.20154507391900403,0.538027092445539
8069,0.8069,16,20,16,583872,21738,82632,25324,0.20135981325725297,0.5380986783392121
8070,0.807,16,32,16,583904,21706,82648,25308,0.20106339619845123,0.5383077381205599
8071,0.8071,14,17,14,583921,21689,82662,25294,0.2009059246359628,0.5383649405103974
8072,0.8072,18,24,18,583945,21665,82680,25276,0.2006836118418615,0.5384631771798641
8073,0.8073,14,25,14,583970,21640,82694,25262,0.20045203601467265,0.5386124259093429
8074,0.8074,15,21,15,583991,21619,82709,25247,0.20025751231983402,0.5387060982375282
8075,0.8075,20,22,20,584013,21597,82729,25227,0.20005372559190782,0.53876217324449
8076,0.8076,18,18,18,584031,21579,82747,25209,0.19988699099633184,0.5387919979481919
8077,0.8077,17,21,17,584052,21558,82764,25192,0.1996924673014932,0.5388663101604279
8078,0.8078,15,21,15,584073,21537,82779,25177,0.19949794360665457,0.5389604829387336
8079,0.8079,14,22,14,584095,21515,82793,25163,0.19929415687872837,0.539076224345516
8080,0.808,18,26,18,584121,21489,82811,25145,0.19905331801845197,0.5391988677788738
8081,0.8081,24,31,24,584152,21458,82835,25121,0.19876616399273778,0.5393202945533395
8082,0.8082,15,32,15,584184,21426,82850,25106,0.19846974693393604,0.5395426803060259
8083,0.8083,15,20,15,584204,21406,82865,25091,0.19828448627218495,0.5396262124438136
8084,0.8084,17,27,17,584231,21379,82882,25074,0.198034384378821,0.5397713818267926
8085,0.8085,22,20,22,584251,21359,82904,25052,0.19784912371706992,0.5397858266359268
8086,0.8086,18,20,18,584271,21339,82922,25034,0.19766386305531883,0.5398399930994329
8087,0.8087,23,20,23,584291,21319,82945,25011,0.19747860239356774,0.5398445931361968
8088,0.8088,18,24,18,584315,21295,82963,24993,0.19725628959946645,0.5399455582440373
8089,0.8089,14,24,14,584339,21271,82977,24979,0.19703397680536514,0.5400864864864865
8090,0.809,17,17,17,584356,21254,82994,24962,0.19687650524287673,0.5401159771507703
8091,0.8091,21,20,21,584376,21234,83015,24941,0.19669124458112563,0.5401407688142934
8092,0.8092,23,28,23,584404,21206,83038,24918,0.19643187965467412,0.5402393547827595
8093,0.8093,16,20,16,584424,21186,83054,24902,0.19624661899292303,0.5403141815657004
8094,0.8094,25,25,25,584449,21161,83079,24877,0.19601504316573418,0.5403579651592163
8095,0.8095,20,23,20,584472,21138,83099,24857,0.19580199340472043,0.54042830742472
8096,0.8096,18,26,18,584498,21112,83117,24839,0.19556115454444403,0.5405540684642336
8097,0.8097,23,31,23,584529,21081,83140,24816,0.19527400051872984,0.5406889339172495
8098,0.8098,13,29,13,584558,21052,83153,24803,0.1950053725591908,0.5409006651401156
8099,0.8099,11,28,11,584586,21024,83164,24792,0.19474600763273928,0.5411210057621791
8100,0.81,24,18,24,584604,21006,83188,24768,0.1945792730371633,0.5410931970114039
8101,0.8101,12,21,12,584625,20985,83200,24756,0.19438474934232466,0.5412212238473142
8102,0.8102,23,26,23,584651,20959,83223,24733,0.19414391048204824,0.5412982579007266
8103,0.8103,15,26,15,584677,20933,83238,24718,0.19390307162177184,0.5414558279117654
8104,0.8104,21,25,21,584702,20908,83259,24697,0.19367149579458298,0.5415414976428023
8105,0.8105,14,21,14,584723,20887,83273,24683,0.19347697209974435,0.541650208470485
8106,0.8106,21,20,21,584743,20867,83294,24662,0.19329171143799326,0.5416767335105098
8107,0.8107,25,18,25,584761,20849,83319,24637,0.19312497684241728,0.541639185683507
8108,0.8108,23,27,23,584788,20822,83342,24614,0.1928748749490533,0.5417290254423804
8109,0.8109,24,25,24,584813,20797,83366,24590,0.19264329912186445,0.5417850926476745
8110,0.811,23,21,23,584834,20776,83389,24567,0.19244877542702582,0.5418035860000441
8111,0.8111,12,21,12,584855,20755,83401,24555,0.1922542517321872,0.5419333480467888
8112,0.8112,21,30,21,584885,20725,83422,24534,0.19197636073956056,0.5420800282816677
8113,0.8113,19,39,19,584924,20686,83441,24515,0.19161510244914595,0.5423552576270436
8114,0.8114,19,23,19,584947,20663,83460,24496,0.1914020526881322,0.5424389379747115
8115,0.8115,11,27,11,584974,20636,83471,24485,0.19115195079476824,0.5426519802309346
8116,0.8116,14,27,14,585001,20609,83485,24471,0.19090184890140427,0.5428349600709849
8117,0.8117,20,32,20,585033,20577,83505,24451,0.19060543184260254,0.5430176778893133
8118,0.8118,15,28,15,585061,20549,83520,24436,0.19034606691615102,0.5432032899855508
8119,0.8119,16,19,16,585080,20530,83536,24420,0.1901700692874875,0.5432703003337042
8120,0.812,12,27,12,585107,20503,83548,24408,0.18991996739412353,0.5434748725256618
8121,0.8121,19,28,19,585135,20475,83567,24389,0.18966060246767202,0.5436207203994294
8122,0.8122,15,20,15,585155,20455,83582,24374,0.18947534180592093,0.5437105445135961
8123,0.8123,18,31,18,585186,20424,83600,24356,0.18918818778020674,0.5439035283608754
8124,0.8124,18,21,18,585207,20403,83618,24338,0.1889936640853681,0.5439753246462976
8125,0.8125,29,15,29,585222,20388,83647,24309,0.1888547185890548,0.5438620041613531
8126,0.8126,22,27,22,585249,20361,83669,24287,0.18860461669569084,0.5439661351012364
8127,0.8127,15,23,15,585272,20338,83684,24272,0.1883915669346771,0.5440932526339386
8128,0.8128,27,25,27,585297,20313,83711,24245,0.18815999110748824,0.544122267606266
8129,0.8129,26,21,26,585318,20292,83737,24219,0.1879654674126496,0.5441126912448608
8130,0.813,21,23,21,585341,20269,83758,24198,0.18775241765163586,0.5441788292441586
8131,0.8131,15,22,15,585363,20247,83773,24183,0.18754863092370966,0.5442943956785955
8132,0.8132,17,30,17,585393,20217,83790,24166,0.18727073993108304,0.5444877543203479
8133,0.8133,29,29,29,585422,20188,83819,24137,0.18700211197154396,0.544545967287084
8134,0.8134,12,32,12,585454,20156,83831,24125,0.18670569491274222,0.5448160610645649
8135,0.8135,18,22,18,585476,20134,83849,24107,0.18650190818481605,0.5449017879342691
8136,0.8136,19,29,19,585505,20105,83868,24088,0.18623328022527696,0.5450636978707035
8137,0.8137,22,21,22,585526,20084,83890,24066,0.18603875653043833,0.5450962627406568
8138,0.8138,15,20,15,585546,20064,83905,24051,0.18585349586868724,0.5451887113226793
8139,0.8139,12,17,12,585563,20047,83917,24039,0.18569602430619883,0.5452751440366557
8140,0.814,13,28,13,585591,20019,83930,24026,0.1854366593797473,0.5454875695311613
8141,0.8141,17,28,17,585619,19991,83947,24009,0.18517729445329578,0.5456590909090909
8142,0.8142,17,27,17,585646,19964,83964,23992,0.1849271925599318,0.5458185458185458
8143,0.8143,14,22,14,585668,19942,83978,23978,0.18472340583200564,0.5459471766848816
8144,0.8144,17,19,17,585687,19923,83995,23961,0.1845474082033421,0.5460076565490839
8145,0.8145,21,26,21,585713,19897,84016,23940,0.1843065693430657,0.5461140132764559
8146,0.8146,14,19,14,585732,19878,84030,23926,0.18413057171440217,0.5462058259519679
8147,0.8147,16,28,16,585760,19850,84046,23910,0.18387120678795066,0.5463893967093236
8148,0.8148,15,16,15,585776,19834,84061,23895,0.1837229982585498,0.5464337167554711
8149,0.8149,16,29,16,585805,19805,84077,23879,0.1834543702990107,0.5466303452064829
8150,0.815,29,18,29,585823,19787,84106,23850,0.18328763570343473,0.5465545294131128
8151,0.8151,15,25,15,585848,19762,84121,23835,0.18305605987624587,0.5467119297199349
8152,0.8152,18,21,18,585869,19741,84139,23817,0.18286153618140724,0.5467881904586988
8153,0.8153,24,22,24,585891,19719,84163,23793,0.18265774945348104,0.5468146718146718
8154,0.8154,16,32,16,585923,19687,84179,23777,0.1823613323946793,0.5470504325418737
8155,0.8155,22,28,22,585951,19659,84201,23755,0.1821019674682278,0.5471737227622426
8156,0.8156,12,18,12,585969,19641,84213,23743,0.18193523287265181,0.547275493269408
8157,0.8157,13,26,13,585995,19615,84226,23730,0.18169439401237542,0.5474679893874727
8158,0.8158,20,22,20,586017,19593,84246,23710,0.1814906072844492,0.5475371221393437
8159,0.8159,21,26,21,586043,19567,84267,23689,0.1812497684241728,0.5476465692620677
8160,0.816,20,28,20,586071,19539,84287,23669,0.1809904034977213,0.5477920755415664
8161,0.8161,9,23,9,586094,19516,84296,23660,0.18077735373670756,0.5479896238651103
8162,0.8162,24,18,24,586112,19498,84320,23636,0.18061061914113158,0.5479668011313581
8163,0.8163,15,26,15,586138,19472,84335,23621,0.18036978028085515,0.5481400691527626
8164,0.8164,19,17,19,586155,19455,84354,23602,0.18021230871836674,0.5481570940845856
8165,0.8165,6,16,6,586171,19439,84360,23596,0.18006410018896588,0.5482978970605321
8166,0.8166,22,28,22,586199,19411,84382,23574,0.17980473526251436,0.5484238687914389
8167,0.8167,16,26,16,586225,19385,84398,23558,0.17956389640223794,0.5485876627156929
8168,0.8168,9,21,9,586246,19364,84407,23549,0.1793693727073993,0.5487614475799875
8169,0.8169,20,15,20,586261,19349,84427,23529,0.179230427211086,0.5487429451000513
8170,0.817,21,21,21,586282,19328,84448,23508,0.17903590351624735,0.54879073676347
8171,0.8171,14,22,14,586304,19306,84462,23494,0.17883211678832117,0.5489252336448598
8172,0.8172,17,26,17,586330,19280,84479,23477,0.17859127792804477,0.549079682858947
8173,0.8173,14,28,14,586358,19252,84493,23463,0.17833191300159323,0.5492918178625775
8174,0.8174,20,26,20,586384,19226,84513,23443,0.17809107414131684,0.5494152663526214
8175,0.8175,17,23,17,586407,19203,84530,23426,0.1778780243803031,0.5495320087264538
8176,0.8176,20,30,20,586437,19173,84550,23406,0.17760013338767647,0.5497076023391813
8177,0.8177,22,25,22,586462,19148,84572,23384,0.1773685575604876,0.5497977993040534
8178,0.8178,9,23,9,586485,19125,84581,23375,0.17715550779947387,0.55
8179,0.8179,19,16,19,586501,19109,84600,23356,0.177007299270073,0.5500058872012246
8180,0.818,8,25,8,586526,19084,84608,23348,0.17677572344288414,0.5502450980392157
8181,0.8181,15,17,15,586543,19067,84623,23333,0.1766182518803957,0.5503066037735849
8182,0.8182,14,24,14,586567,19043,84637,23319,0.17639593908629442,0.5504697606345309
8183,0.8183,24,22,24,586589,19021,84661,23295,0.17619215235836821,0.5505009925323755
8184,0.8184,16,20,16,586609,19001,84677,23279,0.17600689169661715,0.5505912961210975
8185,0.8185,17,20,17,586629,18981,84694,23262,0.17582163103486606,0.55067111710816
8186,0.8186,18,18,18,586647,18963,84712,23244,0.17565489643929008,0.5507143364844694
8187,0.8187,24,25,24,586672,18938,84736,23220,0.17542332061210122,0.5507851416101333
8188,0.8188,18,22,18,586694,18916,84754,23202,0.17521953388417502,0.5508808585402916
8189,0.8189,21,25,21,586719,18891,84775,23181,0.1749879580569862,0.5509840273816314
8190,0.819,18,26,18,586745,18865,84793,23163,0.17474711919670977,0.5511325782811459
8191,0.8191,11,16,11,586761,18849,84804,23152,0.1745989106673089,0.5512249708340278
8192,0.8192,10,13,10,586774,18836,84814,23142,0.17447849123717069,0.5512887703082567
8193,0.8193,16,33,16,586807,18803,84830,23126,0.1741728111452814,0.551551432182976
8194,0.8194,12,28,12,586835,18775,84842,23114,0.1739134462188299,0.551791639809974
8195,0.8195,19,22,19,586857,18753,84861,23095,0.1737096594909037,0.5518782259606194
8196,0.8196,16,17,16,586874,18736,84877,23079,0.17355218792841529,0.5519311251943083
8197,0.8197,20,29,20,586903,18707,84897,23059,0.1732835599688762,0.5520997940908873
8198,0.8198,21,28,21,586931,18679,84918,23038,0.1730241950424247,0.5522448881750845
8199,0.8199,17,23,17,586954,18656,84935,23021,0.17281114528141095,0.5523670129807807
8200,0.82,10,22,10,586976,18634,84945,23011,0.17260735855348475,0.5525513266898787
8201,0.8201,19,22,19,586998,18612,84964,22992,0.17240357182555857,0.5526391693106432
8202,0.8202,27,16,27,587014,18596,84991,22965,0.1722553632961577,0.5525612954452491
8203,0.8203,17,20,17,587034,18576,85008,22948,0.1720701026344066,0.5526442539254407
8204,0.8204,22,22,22,587056,18554,85030,22926,0.1718663159064804,0.5527000964320155
8205,0.8205,20,22,20,587078,18532,85050,22906,0.17166252917855424,0.5527776437086732
8206,0.8206,15,23,15,587101,18509,85065,22891,0.1714494794175405,0.5529227053140097
8207,0.8207,13,26,13,587127,18483,85078,22878,0.17120864055726406,0.553129759918764
8208,0.8208,15,23,15,587150,18460,85093,22863,0.17099559079625032,0.5532754156281006
8209,0.8209,11,23,11,587173,18437,85104,22852,0.17078254103523657,0.5534646031630701
8210,0.821,18,24,18,587197,18413,85122,22834,0.1705602282411353,0.5535917763716149
8211,0.8211,12,28,12,587225,18385,85134,22822,0.17030086331468375,0.5538379401557988
8212,0.8212,20,18,20,587243,18367,85154,22802,0.1701341287191078,0.5538633437780854
8213,0.8213,15,41,15,587284,18326,85169,22787,0.16975434436251807,0.5542529127040109
8214,0.8214,14,24,14,587308,18302,85183,22773,0.16953203156841676,0.5544248326232502
8215,0.8215,14,29,14,587337,18273,85197,22759,0.16926340360887768,0.5546646519789432
8216,0.8216,24,13,24,587350,18260,85221,22735,0.1691429841787395,0.5545798268081473
8217,0.8217,20,16,20,587366,18244,85241,22715,0.16899477564933862,0.5545789692131156
8218,0.8218,14,28,14,587394,18216,85255,22701,0.1687354107228871,0.554806070826307
8219,0.8219,19,21,19,587415,18195,85274,22682,0.16854088702804845,0.5548841646891896
8220,0.822,17,29,17,587444,18166,85291,22665,0.1682722590685094,0.5550929440866008
8221,0.8221,21,26,21,587470,18140,85312,22644,0.16803142020823297,0.5552177324440957
8222,0.8222,17,25,17,587495,18115,85329,22627,0.16779984438104412,0.5553728339305876
8223,0.8223,17,21,17,587516,18094,85346,22610,0.16760532068620548,0.5554736635220126
8224,0.8224,15,22,15,587538,18072,85361,22595,0.1674015339582793,0.5556101999163942
8225,0.8225,17,18,17,587556,18054,85378,22578,0.16723479936270333,0.5556704075605434
8226,0.8226,22,24,22,587580,18030,85400,22556,0.16701248656860201,0.5557581432020894
8227,0.8227,19,21,19,587601,18009,85419,22537,0.16681796287376338,0.5558378138410695
8228,0.8228,19,22,19,587623,17987,85438,22518,0.1666141761458372,0.5559313664979633
8229,0.8229,19,19,19,587642,17968,85457,22499,0.16643817851717366,0.5559838881063582
8230,0.823,19,22,19,587664,17946,85476,22480,0.16623439178924748,0.5560777717310642
8231,0.8231,14,19,14,587683,17927,85490,22466,0.16605839416058393,0.5561854776817765
8232,0.8232,14,24,14,587707,17903,85504,22452,0.16583608136648265,0.5563622847230827
8233,0.8233,13,16,13,587723,17887,85517,22439,0.16568787283708178,0.5564400138868224
8234,0.8234,12,25,12,587748,17862,85529,22427,0.16545629700989292,0.5566531807689443
8235,0.8235,16,29,16,587777,17833,85545,22411,0.16518766905035384,0.5568780439320147
8236,0.8236,15,25,15,587802,17808,85560,22396,0.16495609322316498,0.5570589991045667
8237,0.8237,14,21,14,587823,17787,85574,22382,0.16476156952832635,0.5571958475441261
8238,0.8238,17,19,17,587842,17768,85591,22365,0.16458557189966283,0.557272070366033
8239,0.8239,17,24,17,587866,17744,85608,22348,0.16436325910556152,0.557417938740896
8240,0.824,14,18,14,587884,17726,85622,22334,0.16419652450998554,0.5575137294058912
8241,0.8241,15,19,15,587903,17707,85637,22319,0.16402052688132202,0.5576125518413032
8242,0.8242,31,20,31,587923,17687,85668,22288,0.16383526621957092,0.5575484677923702
8243,0.8243,17,21,17,587944,17666,85685,22271,0.1636407425247323,0.5576533039537271
8244,0.8244,18,24,18,587968,17642,85703,22253,0.163418429730631,0.5577891966411831
8245,0.8245,17,25,17,587993,17617,85720,22236,0.16318685390344215,0.557950467969789
8246,0.8246,11,34,11,588027,17583,85731,22225,0.1628719107784653,0.5583048633440515
8247,0.8247,12,22,12,588049,17561,85743,22213,0.1626681240505391,0.5584804143410268
8248,0.8248,11,23,11,588072,17538,85754,22202,0.16245507428952535,0.5586814292903876
8249,0.8249,19,18,19,588090,17520,85773,22183,0.16228833969394937,0.5587235221519784
8250,0.825,21,33,21,588123,17487,85794,22162,0.1619826596020601,0.5589548286211506
8251,0.8251,22,11,22,588134,17476,85816,22140,0.161880766238097,0.5588651050080775
8252,0.8252,20,23,20,588157,17453,85836,22120,0.16166771647708325,0.5589669724306977
8253,0.8253,13,17,13,588174,17436,85849,22107,0.16151024491459484,0.559062286624687
8254,0.8254,10,26,10,588200,17410,85859,22097,0.16126940605431841,0.5593186017667755
8255,0.8255,18,23,18,588223,17387,85877,22079,0.16105635629330467,0.5594435716819541
8256,0.8256,9,20,9,588243,17367,85886,22070,0.1608710956315536,0.5596267464563734
8257,0.8257,14,19,14,588262,17348,85900,22056,0.16069509800289006,0.5597401279057964
8258,0.8258,18,17,18,588279,17331,85918,22038,0.16053762644040165,0.5597805379867409
8259,0.8259,17,26,17,588305,17305,85935,22021,0.16029678758012525,0.5599603315872451
8260,0.826,17,30,17,588335,17275,85952,22004,0.1600188965874986,0.5601975610377046
8261,0.8261,23,25,23,588360,17250,85975,21981,0.15978732076030974,0.5602967041370345
8262,0.8262,15,20,15,588380,17230,85990,21966,0.15960206009855868,0.5604143279926523
8263,0.8263,17,32,17,588412,17198,86007,21949,0.15930564303975694,0.5606815337062866
8264,0.8264,29,23,29,588435,17175,86036,21920,0.1590925932787432,0.5606855096559662
8265,0.8265,10,28,10,588463,17147,86046,21910,0.15883322835229166,0.5609749852779271
8266,0.8266,14,24,14,588487,17123,86060,21896,0.15861091555819037,0.5611625105717727
8267,0.8267,9,25,9,588512,17098,86069,21887,0.15837933973100152,0.5614210593818135
8268,0.8268,20,16,20,588528,17082,86089,21867,0.15823113120160065,0.5614264807825619
8269,0.8269,21,23,21,588551,17059,86110,21846,0.1580180814405869,0.5615216553142269
8270,0.827,17,18,17,588569,17041,86127,21829,0.15785134684501093,0.5615899151016208
8271,0.8271,21,24,21,588593,17017,86148,21808,0.15762903405090964,0.5616999356084996
8272,0.8272,16,16,16,588609,17001,86164,21792,0.15748082552150877,0.5617508313355503
8273,0.8273,18,17,18,588626,16984,86182,21774,0.15732335395902033,0.5617936942050673
8274,0.8274,20,27,20,588653,16957,86202,21754,0.15707325206565637,0.5619591330629536
8275,0.8275,11,29,11,588682,16928,86213,21743,0.1568046241061173,0.5622559540741123
8276,0.8276,10,25,10,588707,16903,86223,21733,0.15657304827892846,0.5625064706491355
8277,0.8277,13,16,13,588723,16887,86236,21720,0.1564248397495276,0.5625922760121221
8278,0.8278,24,21,24,588744,16866,86260,21696,0.15623031605468896,0.5626264197915046
8279,0.8279,10,30,10,588774,16836,86270,21686,0.15595242506206233,0.5629510409636053
8280,0.828,23,20,23,588794,16816,86293,21663,0.15576716440031124,0.5629824059876816
8281,0.8281,22,30,22,588824,16786,86315,21641,0.15548927340768462,0.5631717282119343
8282,0.8282,19,18,19,588842,16768,86334,21622,0.15532253881210864,0.5632195884344882
8283,0.8283,19,17,19,588859,16751,86353,21603,0.1551650672496202,0.5632528549825312
8284,0.8284,16,20,16,588879,16731,86369,21587,0.15497980658786914,0.5633644762252727
8285,0.8285,17,31,17,588910,16700,86386,21570,0.15469265256215495,0.5636268617716227
8286,0.8286,24,20,24,588930,16680,86410,21546,0.15450739190040386,0.5636477789985873
8287,0.8287,18,22,18,588952,16658,86428,21528,0.15430360517247768,0.5637668255381554
8288,0.8288,18,17,18,588969,16641,86446,21510,0.15414613360998924,0.5638122198631753
8289,0.8289,22,13,22,588982,16628,86468,21488,0.15402571417985106,0.5637527547486619
8290,0.829,7,21,7,589003,16607,86475,21481,0.15383119048501243,0.563983406847301
8291,0.8291,20,23,20,589026,16584,86495,21461,0.15361814072399865,0.564095150479695
8292,0.8292,19,18,19,589044,16566,86514,21442,0.1534514061284227,0.564144390654599
8293,0.8293,17,20,17,589064,16546,86531,21425,0.1532661454666716,0.5642463985673277
8294,0.8294,16,14,16,589078,16532,86547,21409,0.15313646300344586,0.5642708415698058
8295,0.8295,18,30,18,589108,16502,86565,21391,0.15285857201081923,0.5645105956245217
8296,0.8296,17,25,17,589133,16477,86582,21374,0.15262699618363038,0.5646878550104356
8297,0.8297,14,20,14,589153,16457,86596,21360,0.15244173552187928,0.5648253430996641
8298,0.8298,10,23,10,589176,16434,86606,21350,0.15222868576086554,0.565053991107347
8299,0.8299,13,17,13,589193,16417,86619,21337,0.15207121419837713,0.5651586586851725
8300,0.83,21,19,21,589212,16398,86640,21316,0.15189521656971358,0.5652012515246327
8301,0.8301,17,19,17,589231,16379,86657,21299,0.15171921894105006,0.5652900897075216
8302,0.8302,15,21,15,589252,16358,86672,21284,0.15152469524621143,0.5654322299559004
8303,0.8303,21,29,21,589281,16329,86693,21263,0.15125606728667235,0.5656256650351138
8304,0.8304,18,15,18,589296,16314,86711,21245,0.15111712179035902,0.5656433877366277
8305,0.8305,17,15,17,589311,16299,86728,21228,0.15097817629404572,0.5656727156447358
8306,0.8306,21,23,21,589334,16276,86749,21207,0.15076512653303198,0.5657764853400208
8307,0.8307,12,30,12,589364,16246,86761,21195,0.15048723554040536,0.5660906492882135
8308,0.8308,18,17,18,589381,16229,86779,21177,0.15032976397791692,0.5661391220659787
8309,0.8309,16,27,16,589408,16202,86795,21161,0.15007966208455298,0.5663624441292188
8310,0.831,15,15,15,589423,16187,86810,21146,0.14994071658823965,0.566415771569389
8311,0.8311,19,21,19,589444,16166,86829,21127,0.14974619289340102,0.5665138229694581
8312,0.8312,18,23,18,589467,16143,86847,21109,0.14953314313238728,0.5666541393750671
8313,0.8313,14,18,14,589485,16125,86861,21095,0.1493664085368113,0.5667651800107469
8314,0.8314,8,19,8,589504,16106,86869,21087,0.14919041090814777,0.5669615250181486
8315,0.8315,14,25,14,589529,16081,86883,21073,0.14895883508095892,0.5671798460461861
8316,0.8316,15,28,15,589557,16053,86898,21058,0.14869947015450738,0.5674328366252593
8317,0.8317,21,22,21,589579,16031,86919,21037,0.1484956834265812,0.5675245494766376
8318,0.8318,20,20,20,589599,16011,86939,21017,0.1483104227648301,0.5675974937884843
8319,0.8319,22,31,22,589630,15980,86961,20995,0.14802326873911595,0.5678160919540229
8320,0.832,12,20,12,589650,15960,86973,20983,0.14783800807736486,0.5679831091140406
8321,0.8321,17,26,17,589676,15934,86990,20966,0.14759716921708843,0.5681842818428184
8322,0.8322,19,23,19,589699,15911,87009,20947,0.14738411945607469,0.5683162407075805
8323,0.8323,15,26,15,589725,15885,87024,20932,0.1471432805957983,0.5685417062769916
8324,0.8324,15,17,15,589742,15868,87039,20917,0.14698580903330988,0.5686285170585836
8325,0.8325,19,14,19,589756,15854,87058,20898,0.1468561265700841,0.5686221158032216
8326,0.8326,20,22,20,589778,15832,87078,20878,0.14665233984215792,0.5687278670661945
8327,0.8327,18,19,18,589797,15813,87096,20860,0.1464763422134944,0.5688108417636953
8328,0.8328,22,23,22,589820,15790,87118,20838,0.14626329245248065,0.5689090313421427
8329,0.8329,16,23,16,589843,15767,87134,20822,0.14605024269146688,0.5690781382382684
8330,0.833,14,21,14,589864,15746,87148,20808,0.14585571899662825,0.5692400284510587
8331,0.8331,11,19,11,589883,15727,87159,20797,0.14567972136796473,0.5694064176979521
8332,0.8332,8,29,8,589912,15698,87167,20789,0.14541109340842565,0.5697645736837778
8333,0.8333,11,16,11,589928,15682,87178,20778,0.14526288487902478,0.569884805266045
8334,0.8334,18,21,18,589949,15661,87196,20760,0.14506836118418615,0.5700008237006123
8335,0.8335,21,16,21,589965,15645,87217,20739,0.14492015265478528,0.5700032981530343
8336,0.8336,10,27,10,589992,15618,87227,20729,0.1446700507614213,0.5703084161003659
8337,0.8337,16,21,16,590013,15597,87243,20713,0.14447552706658268,0.5704489121454145
8338,0.8338,16,19,16,590032,15578,87259,20697,0.14429952943791916,0.5705582356995176
8339,0.8339,15,15,15,590047,15563,87274,20682,0.14416058394160583,0.5706166367774865
8340,0.834,12,18,12,590065,15545,87286,20670,0.14399384934602985,0.5707579732155185
8341,0.8341,20,24,20,590089,15521,87306,20650,0.14377153655192856,0.5708993392496752
8342,0.8342,15,30,15,590119,15491,87321,20635,0.14349364555930194,0.5711952610308365
8343,0.8343,19,22,19,590141,15469,87340,20616,0.14328985883137574,0.5713177220451712
8344,0.8344,14,22,14,590163,15447,87354,20602,0.14308607210344956,0.5714999029099281
8345,0.8345,17,30,17,590193,15417,87371,20585,0.14280818111082294,0.5717737903449809
8346,0.8346,25,16,25,590209,15401,87396,20560,0.14265997258142207,0.5717304858040655
8347,0.8347,21,21,21,590230,15380,87417,20539,0.1424654488865834,0.5718143600879757
8348,0.8348,18,13,18,590243,15367,87435,20521,0.14234502945644523,0.5718067320552831
8349,0.8349,12,22,12,590265,15345,87447,20509,0.14214124272851902,0.5720142801361076
8350,0.835,10,20,10,590285,15325,87457,20499,0.14195598206676793,0.5722141581062975
8351,0.8351,14,21,14,590306,15304,87471,20485,0.1417614583719293,0.5723825756517366
8352,0.8352,18,18,18,590324,15286,87489,20467,0.14159472377635332,0.572455458283221
8353,0.8353,20,17,20,590341,15269,87509,20447,0.1414372522138649,0.5724885205510135
8354,0.8354,17,20,17,590361,15249,87526,20430,0.14125199155211382,0.5726057344656521
8355,0.8355,14,17,14,590378,15232,87540,20416,0.1410945199896254,0.5727109515260324
8356,0.8356,18,15,18,590393,15217,87558,20398,0.14095557449331209,0.5727362066544995
8357,0.8357,24,25,24,590418,15192,87582,20374,0.14072399866612323,0.572850475172918
8358,0.8358,10,15,10,590433,15177,87592,20364,0.14058505316980993,0.5729720604372415
8359,0.8359,10,18,10,590451,15159,87602,20354,0.14041831857423395,0.5731422296060598
8360,0.836,17,16,17,590467,15143,87619,20337,0.14027011004483309,0.573196166854566
8361,0.8361,16,22,16,590489,15121,87635,20321,0.14006632331690688,0.5733592912363862
8362,0.8362,19,18,19,590507,15103,87654,20302,0.1398995887213309,0.5734218330744245
8363,0.8363,8,21,8,590528,15082,87662,20294,0.13970506502649227,0.5736657620985979
8364,0.8364,14,17,14,590545,15065,87676,20280,0.13954759346400386,0.5737728108643373
8365,0.8365,14,12,14,590557,15053,87690,20266,0.1394364370669532,0.5737988051756845
8366,0.8366,12,19,12,590576,15034,87702,20254,0.13926043943828967,0.5739628202221718
8367,0.8367,14,18,14,590594,15016,87716,20240,0.1390937048427137,0.5740866802813706
8368,0.8368,19,19,19,590613,14997,87735,20221,0.13891770721405017,0.5741666193423818
8369,0.8369,14,12,14,590625,14985,87749,20207,0.13880655081699952,0.5741929984087293
8370,0.837,22,23,22,590648,14962,87771,20185,0.13859350105598578,0.5743022164053831
8371,0.8371,20,26,20,590674,14936,87791,20165,0.13835266219570935,0.5744850574057719
8372,0.8372,17,14,17,590688,14922,87808,20148,0.1382229797324836,0.574508126603935
8373,0.8373,19,25,19,590713,14897,87827,20129,0.13799140390529474,0.5746873750927882
8374,0.8374,22,16,22,590729,14881,87849,20107,0.13784319537589387,0.57468274837087
8375,0.8375,16,16,16,590745,14865,87865,20091,0.137694986846493,0.5747511156882938
8376,0.8376,23,29,23,590774,14836,87888,20068,0.13742635888695395,0.574948429979372
8377,0.8377,13,22,13,590796,14814,87901,20055,0.13722257215902775,0.575152714445496
8378,0.8378,20,20,20,590816,14794,87921,20035,0.13703731149727666,0.5752390249504723
8379,0.8379,22,24,22,590840,14770,87943,20013,0.13681499870317537,0.5753672771181324
8380,0.838,18,18,18,590858,14752,87961,19995,0.1366482641075994,0.5754453621895416
8381,0.8381,11,28,11,590886,14724,87972,19984,0.13638889918114788,0.5757750374553418
8382,0.8382,20,24,20,590910,14700,87992,19964,0.13616658638704657,0.5759289176090469
8383,0.8383,22,22,22,590932,14678,88014,19942,0.1359627996591204,0.5760254188330445
8384,0.8384,15,14,15,590946,14664,88029,19927,0.13583311719589464,0.576074701511954
8385,0.8385,19,17,19,590963,14647,88048,19908,0.1356756456334062,0.5761250180871075
8386,0.8386,17,23,17,590986,14624,88065,19891,0.13546259587239246,0.5763001593510068
8387,0.8387,12,20,12,591006,14604,88077,19879,0.13527733521064136,0.5764869645912478
8388,0.8388,11,16,11,591022,14588,88088,19868,0.1351291266812405,0.576619456698398
8389,0.8389,16,15,16,591037,14573,88104,19852,0.1349901811849272,0.5766739288307916
8390,0.839,13,21,13,591058,14552,88117,19839,0.13479565749008857,0.5768660405338606
8391,0.8391,20,26,20,591084,14526,88137,19819,0.13455481862981214,0.5770563400786141
8392,0.8392,14,19,14,591103,14507,88151,19805,0.13437882100114862,0.5772033107950572
8393,0.8393,21,19,21,591122,14488,88172,19784,0.1342028233724851,0.5772642390289449
8394,0.8394,17,14,17,591136,14474,88189,19767,0.13407314090925931,0.577290382874332
8395,0.8395,17,10,17,591146,14464,88206,19750,0.13398051057838378,0.5772490793242532
8396,0.8396,24,20,24,591166,14444,88230,19726,0.1337952499166327,0.5772900204858062
8397,0.8397,16,29,16,591195,14415,88246,19710,0.13352662195709364,0.5775824175824176
8398,0.8398,19,13,19,591208,14402,88265,19691,0.13340620252695543,0.5775672425424574
8399,0.8399,21,21,21,591229,14381,88286,19670,0.1332116788321168,0.577662917388623
8400,0.84,16,22,16,591251,14359,88302,19654,0.1330078921041906,0.5778378855143621
8401,0.8401,15,20,15,591271,14339,88317,19639,0.13282263144243953,0.5779916416504797
8402,0.8402,16,28,16,591299,14311,88333,19623,0.132563266515988,0.5782695821300171
8403,0.8403,16,12,16,591311,14299,88349,19607,0.13245211011893734,0.5782752315224444
8404,0.8404,16,13,16,591324,14286,88365,19591,0.13233169068879913,0.5782979602680285
8405,0.8405,21,15,21,591339,14271,88386,19570,0.13219274519248583,0.5782926036464644
8406,0.8406,20,19,20,591358,14252,88406,19550,0.13201674756382228,0.5783681438968108
8407,0.8407,13,28,13,591386,14224,88419,19537,0.13175738263737077,0.5786854654779183
8408,0.8408,19,23,19,591409,14201,88438,19518,0.13154433287635703,0.5788427889320561
8409,0.8409,24,14,24,591423,14187,88462,19494,0.13141465041313127,0.5787832902823551
8410,0.841,21,21,21,591444,14166,88483,19473,0.13122012671829264,0.5788816552216177
8411,0.8411,12,24,12,591468,14142,88495,19461,0.13099781392419133,0.5791447192214981
8412,0.8412,18,20,18,591488,14122,88513,19443,0.13081255326244026,0.579264114404886
8413,0.8413,16,20,16,591508,14102,88529,19427,0.13062729260068917,0.5794088699334904
8414,0.8414,14,25,14,591533,14077,88543,19413,0.13039571677350031,0.5796655718124814
8415,0.8415,14,20,14,591553,14057,88557,19399,0.13021045611174922,0.5798362027737924
8416,0.8416,14,21,14,591574,14036,88571,19385,0.1300159324169106,0.5800245354717094
8417,0.8417,13,16,13,591590,14020,88584,19372,0.12986772388750972,0.5801389554384284
8418,0.8418,11,13,11,591603,14007,88595,19361,0.1297473044573715,0.580226564373052
8419,0.8419,18,20,18,591623,13987,88613,19343,0.12956204379562045,0.5803480348034803
8420,0.842,14,23,14,591646,13964,88627,19329,0.1293489940346067,0.5805724927161866
8421,0.8421,13,22,13,591668,13942,88640,19316,0.1291452073066805,0.580792591256239
8422,0.8422,11,25,11,591693,13917,88651,19305,0.12891363147949164,0.5810908434170128
8423,0.8423,16,22,16,591715,13895,88667,19289,0.12870984475156547,0.5812741080038573
8424,0.8424,18,18,18,591733,13877,88685,19271,0.1285431101559895,0.5813623748039097
8425,0.8425,11,15,11,591748,13862,88696,19260,0.12840416465967616,0.581486625203792
8426,0.8426,19,14,19,591762,13848,88715,19241,0.1282744821964504,0.5814923388437245
8427,0.8427,10,20,10,591782,13828,88725,19231,0.12808922153469932,0.5817175353156477
8428,0.8428,16,17,16,591799,13811,88741,19215,0.1279317499722109,0.5818143281051293
8429,0.8429,16,18,16,591817,13793,88757,19199,0.12776501537663493,0.5819289524733269
8430,0.843,16,18,16,591835,13775,88773,19183,0.12759828078105895,0.582043813338188
8431,0.8431,17,18,17,591853,13757,88790,19166,0.12743154618548297,0.5821462199678037
8432,0.8432,16,18,16,591871,13739,88806,19150,0.127264811589907,0.5822615464136945
8433,0.8433,13,22,13,591893,13717,88819,19137,0.12706102486198081,0.5824861508492116
8434,0.8434,20,25,20,591918,13692,88839,19117,0.12682944903479196,0.5826754853851077
8435,0.8435,20,16,20,591934,13676,88859,19097,0.1266812405053911,0.5827052756842522
8436,0.8436,11,20,11,591954,13656,88870,19086,0.12649597984364,0.5829210188748396
8437,0.8437,23,15,23,591969,13641,88893,19063,0.1263570343473267,0.5828950587084148
8438,0.8438,10,19,10,591988,13622,88903,19053,0.12618103671866315,0.583106350420811
8439,0.8439,17,22,17,592010,13600,88920,19036,0.12597724999073698,0.5832822649834538
8440,0.844,20,21,20,592031,13579,88940,19016,0.12578272629589832,0.58340236232551
8441,0.8441,18,18,18,592049,13561,88958,18998,0.12561599170032237,0.5834945790718388
8442,0.8442,17,24,17,592073,13537,88975,18981,0.12539367890622105,0.5837074850851836
8443,0.8443,25,24,25,592097,13513,89000,18956,0.12517136611211976,0.5838184114078043
8444,0.8444,20,16,20,592113,13497,89020,18936,0.1250231575827189,0.583849782628804
8445,0.8445,18,14,18,592127,13483,89038,18918,0.12489347511949313,0.5838708681830808
8446,0.8446,21,22,21,592149,13461,89059,18897,0.12468968839156694,0.5839977748933803
8447,0.8447,19,19,19,592168,13442,89078,18878,0.1245136907629034,0.5840965346534653
8448,0.8448,18,9,18,592177,13433,89096,18860,0.12443032346511541,0.5840274982194283
8449,0.8449,22,21,22,592198,13412,89118,18838,0.12423579977027678,0.5841240310077519
8450,0.845,14,28,14,592226,13384,89132,18824,0.12397643484382526,0.5844510680576255
8451,0.8451,10,16,10,592242,13368,89142,18814,0.12382822631442439,0.5846125163134671
8452,0.8452,16,17,16,592259,13351,89158,18798,0.12367075475193598,0.5847149211484027
8453,0.8453,19,28,19,592287,13323,89177,18779,0.12341138982548445,0.584979129026229
8454,0.8454,12,17,12,592304,13306,89189,18767,0.12325391826299603,0.5851339132603748
8455,0.8455,20,22,20,592326,13284,89209,18747,0.12305013153506984,0.5852767631357123
8456,0.8456,19,19,19,592345,13265,89228,18728,0.12287413390640631,0.5853780514487544
8457,0.8457,17,17,17,592362,13248,89245,18711,0.1227166623439179,0.585468882005069
8458,0.8458,13,17,13,592379,13231,89258,18698,0.12255919078142948,0.5856118262394688
8459,0.8459,18,20,18,592399,13211,89276,18680,0.12237393011967838,0.5857451945690006
8460,0.846,19,21,19,592420,13190,89295,18661,0.12217940642483975,0.5858842736491789
8461,0.8461,24,25,24,592445,13165,89319,18637,0.1219478305976509,0.5860323250110056
8462,0.8462,13,24,13,592469,13141,89332,18624,0.1217255178035496,0.586305682354793
8463,0.8463,19,20,19,592489,13121,89351,18605,0.12154025714179852,0.5864275357750741
8464,0.8464,17,23,17,592512,13098,89368,18588,0.12132720738078476,0.5866313198257905
8465,0.8465,23,17,23,592529,13081,89391,18565,0.12116973581829635,0.5866460216141061
8466,0.8466,16,20,16,592549,13061,89407,18549,0.12098447515654526,0.5868079721607087
8467,0.8467,19,16,19,592565,13045,89426,18530,0.12083626662714439,0.5868566904196358
8468,0.8468,13,22,13,592587,13023,89439,18517,0.1206324798992182,0.5870957514267596
8469,0.8469,20,23,20,592610,13000,89459,18497,0.12041943013820446,0.5872622789472013
8470,0.847,17,12,17,592622,12988,89476,18480,0.1203082737411538,0.5872632515571374
8471,0.8471,16,14,16,592636,12974,89492,18464,0.12017859127792804,0.5873147146765061
8472,0.8472,21,18,21,592654,12956,89513,18443,0.12001185668235206,0.5873753941208318
8473,0.8473,17,17,17,592671,12939,89530,18426,0.11985438511986365,0.5874701099952176
8474,0.8474,15,20,15,592691,12919,89545,18411,0.11966912445811256,0.5876476220874561
8475,0.8475,21,14,21,592705,12905,89566,18390,0.11953944199488681,0.5876338073174628
8476,0.8476,16,23,16,592728,12882,89582,18374,0.11932639223387306,0.5878551318146916
8477,0.8477,18,23,18,592751,12859,89600,18356,0.11911334247285932,0.5880506166906936
8478,0.8478,31,11,31,592762,12848,89631,18325,0.11901144910889622,0.5878484586019953
8479,0.8479,7,16,7,592778,12832,89638,18318,0.11886324057949535,0.5880577849117175
8480,0.848,17,25,17,592803,12807,89655,18301,0.11863166475230649,0.5883052590973383
8481,0.8481,20,18,20,592821,12789,89675,18281,0.11846493015673051,0.5883810749919537
8482,0.8482,15,15,15,592836,12774,89690,18266,0.1183259846604172,0.5884664948453608
8483,0.8483,15,21,15,592857,12753,89705,18251,0.11813146096557857,0.5886659785834086
8484,0.8484,16,19,16,592876,12734,89721,18235,0.11795546333691503,0.5888146210726856
8485,0.8485,19,17,19,592893,12717,89740,18216,0.11779799177442662,0.5888856560954321
8486,0.8486,19,18,19,592911,12699,89759,18197,0.11763125717885065,0.5889759192128431
8487,0.8487,6,22,6,592933,12677,89765,18191,0.11742747045092446,0.5893157962938966
8488,0.8488,12,12,12,592945,12665,89777,18179,0.1173163140538738,0.589385293736221
8489,0.8489,16,22,16,592967,12643,89793,18163,0.11711252732594761,0.589592936440953
8490,0.849,14,18,14,592985,12625,89807,18149,0.11694579273037163,0.5897510885812699
8491,0.8491,20,26,20,593011,12599,89827,18129,0.11670495387009522,0.5899830773236137
8492,0.8492,13,18,13,593029,12581,89840,18116,0.11653821927451925,0.5901553897775027
8493,0.8493,22,10,22,593039,12571,89862,18094,0.11644558894364371,0.5900538072721343
8494,0.8494,12,19,12,593058,12552,89874,18082,0.11626959131498017,0.5902591891362539
8495,0.8495,15,27,15,593085,12525,89889,18067,0.11601948942161622,0.5905792364016736
8496,0.8496,21,13,21,593098,12512,89910,18046,0.115899069991478,0.5905491197067871
8497,0.8497,12,18,12,593116,12494,89922,18034,0.11573233539590204,0.5907363731656184
8498,0.8498,26,17,26,593133,12477,89948,18008,0.11557486383341362,0.5907167459406265
8499,0.8499,10,15,10,593148,12462,89958,17998,0.1154359183371003,0.5908732764281024
8500,0.85,13,15,13,593163,12447,89971,17985,0.115296972840787,0.5909897476340694
8501,0.8501,13,17,13,593180,12430,89984,17972,0.11513950127829857,0.5911453193868824
8502,0.8502,18,29,18,593209,12401,90002,17954,0.11487087331875949,0.5914676330093889
8503,0.8503,16,19,16,593228,12382,90018,17938,0.11469487569009597,0.591622691292876
8504,0.8504,10,24,10,593252,12358,90028,17928,0.11447256289599467,0.5919566796539655
8505,0.8505,15,18,15,593270,12340,90043,17913,0.11430582830041869,0.592106567943675
8506,0.8506,13,24,13,593294,12316,90056,17900,0.11408351550631739,0.5924013767540376
8507,0.8507,11,23,11,593317,12293,90067,17889,0.11387046574530364,0.5927042608177059
8508,0.8508,17,8,17,593325,12285,90084,17872,0.11379636148060321,0.5926318930928143
8509,0.8509,23,18,23,593343,12267,90107,17849,0.11362962688502723,0.5926749900385178
8510,0.851,12,25,12,593368,12242,90119,17837,0.11339805105783837,0.5930050866052727
8511,0.8511,14,10,14,593378,12232,90133,17823,0.11330542072696284,0.5930128098486109
8512,0.8512,17,19,17,593397,12213,90150,17806,0.1131294230982993,0.5931576668110197
8513,0.8513,13,15,13,593412,12198,90163,17793,0.112990477601986,0.5932779833950185
8514,0.8514,13,17,13,593429,12181,90176,17780,0.11283300603949757,0.5934381362437836
8515,0.8515,16,17,16,593446,12164,90192,17764,0.11267553447700915,0.5935578722266773
8516,0.8516,15,14,15,593460,12150,90207,17749,0.11254585201378339,0.593631894043279
8517,0.8517,18,13,18,593473,12137,90225,17731,0.1124254325836452,0.5936453729744208
8518,0.8518,14,15,14,593488,12122,90239,17717,0.11228648708733188,0.5937531418613224
8519,0.8519,12,24,12,593512,12098,90251,17705,0.11206417429323058,0.5940677113042311
8520,0.852,13,11,13,593523,12087,90264,17692,0.11196228092926748,0.594109943248598
8521,0.8521,13,16,13,593539,12071,90277,17679,0.11181407239986661,0.5942521008403361
8522,0.8522,22,16,22,593555,12055,90299,17657,0.11166586387046575,0.594271674744211
8523,0.8523,17,23,17,593578,12032,90316,17640,0.111452814109452,0.5944998651927743
8524,0.8524,7,23,7,593601,12009,90323,17633,0.11123976434843826,0.5948653936981311
8525,0.8525,19,21,19,593622,11988,90342,17614,0.11104524065359961,0.5950273630160124
8526,0.8526,12,15,12,593637,11973,90354,17602,0.1109062951572863,0.5951648351648352
8527,0.8527,17,20,17,593657,11953,90371,17585,0.11072103449553522,0.5953348229399418
8528,0.8528,16,23,16,593680,11930,90387,17569,0.11050798473452147,0.5955795111698702
8529,0.8529,17,18,17,593698,11912,90404,17552,0.1103412501389455,0.5957100190062449
8530,0.853,12,22,12,593720,11890,90416,17540,0.1101374634110193,0.5959904858987428
8531,0.8531,15,15,15,593735,11875,90431,17525,0.109998517914706,0.5960884353741497
8532,0.8532,21,17,21,593752,11858,90452,17504,0.10984104635221757,0.596144676793134
8533,0.8533,20,18,20,593770,11840,90472,17484,0.1096743117566416,0.5962351657345519
8534,0.8534,17,16,17,593786,11824,90489,17467,0.10952610322724073,0.5963265166774777
8535,0.8535,17,18,17,593804,11806,90506,17450,0.10935936863166475,0.5964588460486738
8536,0.8536,19,15,19,593819,11791,90525,17431,0.10922042313535144,0.5965026350010266
8537,0.8537,10,16,10,593835,11775,90535,17421,0.10907221460595057,0.5966913275791205
8538,0.8538,16,19,16,593854,11756,90551,17405,0.10889621697728705,0.5968588182846953
8539,0.8539,12,12,12,593866,11744,90563,17393,0.10878506058023639,0.5969386004049834
8540,0.854,18,22,18,593888,11722,90581,17375,0.1085812738523102,0.5971405986871499
8541,0.8541,17,24,17,593912,11698,90598,17358,0.1083589610582089,0.5973981277533039
8542,0.8542,17,25,17,593937,11673,90615,17341,0.10812738523102004,0.5976769835251947
8543,0.8543,16,10,16,593947,11663,90631,17325,0.1080347549001445,0.5976611011453015
8544,0.8544,22,14,22,593961,11649,90653,17303,0.10790507243691874,0.5976443768996961
8545,0.8545,13,19,13,593980,11630,90666,17290,0.10772907480825522,0.5978561549100968
8546,0.8546,22,14,22,593994,11616,90688,17268,0.10759939234502945,0.5978396343996676
8547,0.8547,21,19,21,594013,11597,90709,17247,0.10742339471636593,0.5979406462349188
8548,0.8548,16,15,16,594028,11582,90725,17231,0.10728444922005262,0.5980286676153125
8549,0.8549,19,10,19,594038,11572,90744,17212,0.10719181888917707,0.5979710950528071
8550,0.855,22,20,22,594058,11552,90766,17190,0.10700655822742598,0.5980794655904251
8551,0.8551,10,18,10,594076,11534,90776,17180,0.10683982363185002,0.5983144110886676
8552,0.8552,16,14,16,594090,11520,90792,17164,0.10671014116862425,0.5983823734486124
8553,0.8553,16,19,16,594109,11501,90808,17148,0.10653414353996073,0.5985549233830151
8554,0.8554,17,22,17,594131,11479,90825,17131,0.10633035681203454,0.5987766515204473
8555,0.8555,13,16,13,594147,11463,90838,17118,0.10618214828263367,0.5989293586648473
8556,0.8556,17,30,17,594177,11433,90855,17101,0.10590425729000703,0.5993201093432396
8557,0.8557,20,25,20,594202,11408,90875,17081,0.10567268146281819,0.5995647442872688
8558,0.8558,11,15,11,594217,11393,90886,17070,0.10553373596650487,0.5997259600182693
8559,0.8559,11,23,11,594240,11370,90897,17059,0.10532068620549112,0.6000562805585845
8560,0.856,12,18,12,594258,11352,90909,17047,0.10515395160991516,0.6002676150568682
8561,0.8561,23,12,23,594270,11340,90932,17024,0.1050427952128645,0.6001974333662389
8562,0.8562,20,16,20,594286,11324,90952,17004,0.10489458668346363,0.6002541654899746
8563,0.8563,9,27,9,594313,11297,90961,16995,0.10464448479009968,0.6006998444790047
8564,0.8564,22,20,22,594333,11277,90983,16973,0.10445922412834859,0.6008141592920354
8565,0.8565,20,24,20,594357,11253,91003,16953,0.10423691133424728,0.6010423314188471
8566,0.8566,15,22,15,594379,11231,91018,16938,0.1040331246063211,0.6012993006496503
8567,0.8567,9,25,9,594404,11206,91027,16929,0.10380154877913224,0.6017060600675316
8568,0.8568,14,15,14,594419,11191,91041,16915,0.10366260328281893,0.6018287910054793
8569,0.8569,25,17,25,594436,11174,91066,16890,0.1035051317203305,0.6018386545039909
8570,0.857,18,16,18,594452,11158,91084,16872,0.10335692319092964,0.6019265073135925
8571,0.8571,14,24,14,594476,11134,91098,16858,0.10313461039682834,0.6022434981423264
8572,0.8572,25,16,25,594492,11118,91123,16833,0.10298640186742747,0.6022324782655362
8573,0.8573,25,13,25,594505,11105,91148,16808,0.10286598243728927,0.6021567011786623
8574,0.8574,15,15,15,594520,11090,91163,16793,0.10272703694097596,0.6022666140659183
8575,0.8575,23,10,23,594530,11080,91186,16770,0.10263440661010041,0.6021543985637343
8576,0.8576,24,22,24,594552,11058,91210,16746,0.10243061988217422,0.6022874406560207
8577,0.8577,16,24,16,594576,11034,91226,16730,0.10220830708807292,0.6025788791240455
8578,0.8578,14,22,14,594598,11012,91240,16716,0.10200452036014673,0.6028563185227929
8579,0.8579,15,15,15,594613,10997,91255,16701,0.10186557486383341,0.6029677233013214
8580,0.858,14,23,14,594636,10974,91269,16687,0.10165252510281966,0.6032681392574383
8581,0.8581,11,21,11,594657,10953,91280,16676,0.10145800140798103,0.6035687140323573
8582,0.8582,14,24,14,594681,10929,91294,16662,0.10123568861387973,0.6038925736653257
8583,0.8583,16,23,16,594704,10906,91310,16646,0.10102263885286598,0.6041666666666666
8584,0.8584,16,26,16,594730,10880,91326,16630,0.10078179999258957,0.6045074518356961
8585,0.8585,13,23,13,594753,10857,91339,16617,0.10056875023157583,0.604826381305962
8586,0.8586,19,12,19,594765,10845,91358,16598,0.10045759383452518,0.6048172575884561
8587,0.8587,22,10,22,594775,10835,91380,16576,0.10036496350364964,0.6047207325526248
8588,0.8588,15,15,15,594790,10820,91395,16561,0.10022601800733633,0.6048354698513568
8589,0.8589,14,15,14,594805,10805,91409,16547,0.10008707251102301,0.6049649020181339
8590,0.859,20,20,20,594825,10785,91429,16527,0.09990181184927192,0.6051186291739895
8591,0.8591,6,20,6,594845,10765,91435,16521,0.09971655118752085,0.6054753353368028
8592,0.8592,10,16,10,594861,10749,91445,16511,0.09956834265811998,0.6056859867938371
8593,0.8593,22,18,22,594879,10731,91467,16489,0.099401608062544,0.6057678177810434
8594,0.8594,13,16,13,594895,10715,91480,16476,0.09925339953314313,0.6059357875767717
8595,0.8595,16,15,16,594910,10700,91496,16460,0.09911445403682982,0.6060382916053019
8596,0.8596,19,16,19,594926,10684,91515,16441,0.09896624550742895,0.6061198156682027
8597,0.8597,12,11,12,594937,10673,91527,16429,0.09886435214346585,0.6061914249870858
8598,0.8598,14,17,14,594954,10656,91541,16415,0.09870688058097743,0.6063684385504784
8599,0.8599,14,17,14,594971,10639,91555,16401,0.09854940901848902,0.6065458579881656
8600,0.86,17,15,17,594986,10624,91572,16384,0.0984104635221757,0.6066350710900474
8601,0.8601,9,15,9,595001,10609,91581,16375,0.09827151802586238,0.6068410910168989
8602,0.8602,21,11,21,595012,10598,91602,16354,0.0981696246618993,0.606782428020184
8603,0.8603,18,18,18,595030,10580,91620,16336,0.09800289006632332,0.6069252489225739
8604,0.8604,19,19,19,595049,10561,91639,16317,0.09782689243765978,0.6070764193764417
8605,0.8605,10,18,10,595067,10543,91649,16307,0.09766015784208382,0.6073370577281192
8606,0.8606,10,15,10,595082,10528,91659,16297,0.0975212123457705,0.6075302889095993
8607,0.8607,17,18,17,595100,10510,91676,16280,0.09735447775019453,0.6076894363568496
8608,0.8608,16,20,16,595120,10490,91692,16264,0.09716921708844344,0.6079090977050161
8609,0.8609,15,22,15,595142,10468,91707,16249,0.09696543036051725,0.6081895422390239
8610,0.861,19,11,19,595153,10457,91726,16230,0.09686353699655414,0.6081612770262674
8611,0.8611,12,17,12,595170,10440,91738,16218,0.09670606543406574,0.6083727211343687
8612,0.8612,24,15,24,595185,10425,91762,16194,0.09656711993775242,0.6083624478755776
8613,0.8613,16,18,16,595203,10407,91778,16178,0.09640038534217645,0.6085386496144443
8614,0.8614,10,19,10,595222,10388,91788,16168,0.09622438771351291,0.6088266305166441
8615,0.8615,15,8,15,595230,10380,91803,16153,0.09615028344881248,0.6087890551388837
8616,0.8616,19,23,19,595253,10357,91822,16134,0.09593723368779873,0.6090370314446416
8617,0.8617,16,19,16,595272,10338,91838,16118,0.0957612360591352,0.6092379800423344
8618,0.8618,15,22,15,595294,10316,91853,16103,0.09555744933120901,0.609523449032893
8619,0.8619,23,14,23,595308,10302,91876,16080,0.09542776686798325,0.6095064816920628
8620,0.862,18,16,18,595324,10286,91894,16062,0.09527955833858238,0.609609837558828
8621,0.8621,17,15,17,595339,10271,91911,16045,0.09514061284226907,0.6097051223590211
8622,0.8622,20,20,20,595359,10251,91931,16025,0.09495535218051798,0.6098721266555032
8623,0.8623,19,16,19,595375,10235,91950,16006,0.09480714365111712,0.6099615106131626
8624,0.8624,12,16,12,595391,10219,91962,15994,0.09465893512171626,0.6101552664708351
8625,0.8625,18,13,18,595404,10206,91980,15976,0.09453851569157805,0.6101902070124513
8626,0.8626,23,16,23,595420,10190,92003,15953,0.09439030716217718,0.6102207091764525
8627,0.8627,17,15,17,595435,10175,92020,15936,0.09425136166586387,0.6103174907127265
8628,0.8628,22,15,22,595450,10160,92042,15914,0.09411241616955056,0.6103398021017106
8629,0.8629,28,18,28,595468,10142,92070,15886,0.09394568157397458,0.6103427078530813
8630,0.863,11,11,11,595479,10131,92081,15875,0.09384378821001149,0.610436053218488
8631,0.8631,18,16,18,595495,10115,92099,15857,0.09369557968061062,0.6105421222855383
8632,0.8632,18,18,18,595513,10097,92117,15839,0.09352884508503465,0.6106955582973473
8633,0.8633,14,20,14,595533,10077,92131,15825,0.09334358442328355,0.6109566828816307
8634,0.8634,17,17,17,595550,10060,92148,15808,0.09318611286079514,0.6111025204886346
8635,0.8635,12,16,12,595566,10044,92160,15796,0.09303790433139428,0.6113003095975232
8636,0.8636,20,14,20,595580,10030,92180,15776,0.09290822186816851,0.61133069828722
8637,0.8637,13,18,13,595598,10012,92193,15763,0.09274148727259254,0.6115615906886518
8638,0.8638,11,18,11,595616,9994,92204,15752,0.09257475267701656,0.6118231958362464
8639,0.8639,9,24,9,595640,9970,92213,15743,0.09235243988291526,0.6122583906973127
8640,0.864,17,18,17,595658,9952,92230,15726,0.09218570528733928,0.6124308746787133
8641,0.8641,21,21,21,595679,9931,92251,15705,0.09199118159250065,0.6126150725542207
8642,0.8642,16,11,16,595690,9920,92267,15689,0.09188928822853755,0.6126361825920574
8643,0.8643,13,24,13,595714,9896,92280,15676,0.09166697543443625,0.6130142343187862
8644,0.8644,17,13,17,595727,9883,92297,15659,0.09154655600429805,0.6130686712082061
8645,0.8645,14,22,14,595749,9861,92311,15645,0.09134276927637186,0.6133850858621501
8646,0.8646,22,14,22,595763,9847,92333,15623,0.09121308681314609,0.6133882999607381
8647,0.8647,20,11,20,595774,9836,92353,15603,0.091111193449183,0.6133495813514682
8648,0.8648,18,16,18,595790,9820,92371,15585,0.09096298491978214,0.6134619169454831
8649,0.8649,15,9,15,595799,9811,92386,15570,0.09087961762199415,0.6134510066585241
8650,0.865,16,19,16,595818,9792,92402,15554,0.09070361999333061,0.6136668507851337
8651,0.8651,15,11,15,595829,9781,92417,15539,0.09060172662936752,0.6137045813586098
8652,0.8652,22,11,22,595840,9770,92439,15517,0.09049983326540442,0.6136354648633685
8653,0.8653,9,11,9,595851,9759,92448,15508,0.09039793990144133,0.6137649899077848
8654,0.8654,9,17,9,595868,9742,92457,15499,0.09024046833895291,0.6140406481518165
8655,0.8655,22,21,22,595889,9721,92479,15477,0.09004594464411426,0.6142154139217398
8656,0.8656,11,9,11,595898,9712,92490,15466,0.08996257734632628,0.6142664230677576
8657,0.8657,18,15,18,595913,9697,92508,15448,0.08982363185001296,0.6143567309604295
8658,0.8658,21,12,21,595925,9685,92529,15427,0.08971247545296232,0.614327811404906
8659,0.8659,15,13,15,595938,9672,92544,15412,0.08959205602282411,0.614415563705948
8660,0.866,12,21,12,595959,9651,92556,15400,0.08939753232798547,0.6147459183266137
8661,0.8661,16,18,16,595977,9633,92572,15384,0.0892307977324095,0.6149418395491066
8662,0.8662,19,18,19,595995,9615,92591,15365,0.08906406313683353,0.6150920736589272
8663,0.8663,16,16,16,596011,9599,92607,15349,0.08891585460743266,0.615239698573032
8664,0.8664,12,19,12,596030,9580,92619,15337,0.08873985697876913,0.6155235381466468
8665,0.8665,15,10,15,596040,9570,92634,15322,0.08864722664789358,0.6155391290374418
8666,0.8666,19,15,19,596055,9555,92653,15303,0.08850828115158027,0.6156167028723147
8667,0.8667,13,17,13,596072,9538,92666,15290,0.08835080958909185,0.6158369582729176
8668,0.8668,15,20,15,596092,9518,92681,15275,0.08816554892734077,0.6161013189206631
8669,0.8669,15,14,15,596106,9504,92696,15260,0.08803586646411501,0.6162170893232111
8670,0.867,10,22,10,596128,9482,92706,15250,0.08783207973618881,0.6166100598415009
8671,0.8671,13,13,13,596141,9469,92719,15237,0.08771166030605061,0.6167327774629645
8672,0.8672,17,19,17,596160,9450,92736,15220,0.08753566267738708,0.6169436562626672
8673,0.8673,16,16,16,596176,9434,92752,15204,0.08738745414798621,0.6170955434694374
8674,0.8674,14,8,14,596184,9426,92766,15190,0.08731334988328578,0.617078323041924
8675,0.8675,14,26,14,596210,9400,92780,15176,0.08707251102300938,0.6175130208333334
8676,0.8676,8,17,8,596227,9383,92788,15168,0.08691503946052095,0.6178159749093723
8677,0.8677,17,14,17,596241,9369,92805,15151,0.0867853569972952,0.6179037520391517
8678,0.8678,25,12,25,596253,9357,92830,15126,0.08667420060024454,0.6178164440632276
8679,0.8679,16,18,16,596271,9339,92846,15110,0.08650746600466856,0.6180211869606119
8680,0.868,12,13,12,596284,9326,92858,15098,0.08638704657453036,0.618162463150999
8681,0.8681,16,14,16,596298,9312,92874,15082,0.08625736411130461,0.6182667869148151
8682,0.8682,5,22,5,596320,9290,92879,15077,0.08605357738337842,0.6187466655722904
8683,0.8683,17,17,17,596337,9273,92896,15060,0.08589610582089,0.6189125878436691
8684,0.8684,22,24,22,596361,9249,92918,15038,0.0856737930267887,0.6191789846419895
8685,0.8685,18,13,18,596374,9236,92936,15020,0.08555337359665048,0.6192282321899736
8686,0.8686,18,15,18,596389,9221,92954,15002,0.08541442810033717,0.619328737150642
8687,0.8687,33,17,33,596406,9204,92987,14969,0.08525695653784875,0.6192446117569189
8688,0.8688,18,14,18,596420,9190,93005,14951,0.08512727407462299,0.6193198293359844
8689,0.8689,13,13,13,596433,9177,93018,14938,0.08500685464448479,0.6194484760522496
8690,0.869,8,18,8,596451,9159,93026,14930,0.08484012004890881,0.6197849640914941
8691,0.8691,17,15,17,596466,9144,93043,14913,0.0847011745525955,0.6199027310138421
8692,0.8692,12,15,12,596481,9129,93055,14901,0.08456222905628219,0.6200998751560549
8693,0.8693,17,16,17,596497,9113,93072,14884,0.08441402052688132,0.6202441971913156
8694,0.8694,11,16,11,596513,9097,93083,14873,0.08426581199748046,0.6204839382561536
8695,0.8695,19,23,19,596536,9074,93102,14854,0.08405276223646671,0.6207790036776998
8696,0.8696,26,10,26,596546,9064,93128,14828,0.08396013190559116,0.6206261510128913
8697,0.8697,11,16,11,596562,9048,93139,14817,0.0838119233761903,0.6208673790069139
8698,0.8698,17,22,17,596584,9026,93156,14800,0.08360813664826411,0.6211701502560228
8699,0.8699,12,19,12,596603,9007,93168,14788,0.08343213901960057,0.6214750998108847
8700,0.87,21,9,21,596612,8998,93189,14767,0.08334877172181258,0.6213759730696402
8701,0.8701,18,20,18,596632,8978,93207,14749,0.0831635110600615,0.6216125089560416
8702,0.8702,19,11,19,596643,8967,93226,14730,0.0830616176960984,0.6215976705912141
8703,0.8703,27,12,27,596655,8955,93253,14703,0.08295046129904776,0.6214811057570377
8704,0.8704,13,17,13,596672,8938,93266,14690,0.08279298973655934,0.6217199932283731
8705,0.8705,16,17,16,596689,8921,93282,14674,0.08263551817407092,0.6219114219114219
8706,0.8706,12,11,12,596700,8910,93294,14662,0.08253362481010783,0.6220091634142203
8707,0.8707,16,19,16,596719,8891,93310,14646,0.08235762718144429,0.6222543229808387
8708,0.8708,22,15,22,596734,8876,93332,14624,0.08221868168513098,0.6222978723404256
8709,0.8709,7,23,7,596757,8853,93339,14617,0.08200563192411724,0.6227950575202386
8710,0.871,20,27,20,596784,8826,93359,14597,0.08175553003075327,0.623190880758229
8711,0.8711,8,10,8,596794,8816,93367,14589,0.08166289969987772,0.6233283486434522
8712,0.8712,19,17,19,596811,8799,93386,14570,0.08150542813738931,0.6234755445247978
8713,0.8713,10,14,10,596825,8785,93396,14560,0.08137574567416354,0.623688155922039
8714,0.8714,17,13,17,596838,8772,93413,14543,0.08125532624402534,0.6237615269140039
8715,0.8715,16,10,16,596848,8762,93429,14527,0.0811626959131498,0.6237708789557301
8716,0.8716,15,17,15,596865,8745,93444,14512,0.08100522435066138,0.6239841768069828
8717,0.8717,14,11,14,596876,8734,93458,14498,0.08090333098669829,0.6240530303030303
8718,0.8718,17,14,17,596890,8720,93475,14481,0.08077364852347253,0.6241541312874445
8719,0.8719,13,10,13,596900,8710,93488,14468,0.08068101819259699,0.6242126154111658
8720,0.872,10,13,10,596913,8697,93498,14458,0.08056059876245877,0.6244007773698985
8721,0.8721,13,10,13,596923,8687,93511,14445,0.08046796843158324,0.6244596230330278
8722,0.8722,18,22,18,596945,8665,93529,14427,0.08026418170365704,0.624761822276113
8723,0.8723,22,9,22,596954,8656,93551,14405,0.08018081440586906,0.624647673561424
8724,0.8724,12,8,12,596962,8648,93563,14393,0.08010671014116863,0.6246690681828045
8725,0.8725,17,12,17,596974,8636,93580,14376,0.07999555374411797,0.6247175386754736
8726,0.8726,15,12,15,596986,8624,93595,14361,0.07988439734706733,0.6247987818142267
8727,0.8727,10,16,10,597002,8608,93605,14351,0.07973618881766646,0.6250707783440045
8728,0.8728,12,14,12,597016,8594,93617,14339,0.07960650635444069,0.6252561810491432
8729,0.8729,10,11,10,597027,8583,93627,14329,0.0795046129904776,0.6253928072625698
8730,0.873,15,8,15,597035,8575,93642,14314,0.07943050872577717,0.6253658962820569
8731,0.8731,16,12,16,597047,8563,93658,14298,0.07931935232872651,0.6254319583570273
8732,0.8732,13,14,13,597061,8549,93671,14285,0.07918966986550076,0.6256021721993519
8733,0.8733,14,16,14,597077,8533,93685,14271,0.07904146133609989,0.6258112611822487
8734,0.8734,16,16,16,597093,8517,93701,14255,0.07889325280669902,0.6259880555067627
8735,0.8735,6,14,6,597107,8503,93707,14249,0.07876357034347327,0.6262746132208158
8736,0.8736,22,13,22,597120,8490,93729,14227,0.07864315091333507,0.6262710745256856
8737,0.8737,17,16,17,597136,8474,93746,14210,0.0784949423839342,0.6264327279139481
8738,0.8738,17,12,17,597148,8462,93763,14193,0.07838378598688354,0.6264842198190245
8739,0.8739,9,9,9,597157,8453,93772,14184,0.07830041868909556,0.6265847948049653
8740,0.874,16,21,16,597178,8432,93788,14168,0.07810589499425692,0.6269026548672566
8741,0.8741,14,14,14,597192,8418,93802,14154,0.07797621253103117,0.6270600744284954
8742,0.8742,22,14,22,597206,8404,93824,14132,0.0778465300678054,0.6270855520056798
8743,0.8743,18,16,18,597222,8388,93842,14114,0.07769832153840453,0.6272331348324593
8744,0.8744,16,12,16,597234,8376,93858,14098,0.07758716514135389,0.6273026608525407
8745,0.8745,14,13,14,597247,8363,93872,14084,0.07746674571121569,0.6274335100458859
8746,0.8746,11,17,11,597264,8346,93883,14073,0.07730927414872726,0.6277264820018734
8747,0.8747,10,17,10,597281,8329,93893,14063,0.07715180258623884,0.6280367988567346
8748,0.8748,15,12,15,597293,8317,93908,14048,0.07704064618918818,0.628124301363738
8749,0.8749,25,15,25,597308,8302,93933,14023,0.07690170069287487,0.6281298992161254
8750,0.875,14,20,14,597328,8282,93947,14009,0.0767164400311238,0.6284599165582522
8751,0.8751,17,16,17,597344,8266,93964,13992,0.07656823150172293,0.6286279090664031
8752,0.8752,10,15,10,597359,8251,93974,13982,0.07642928600540962,0.6288849907794719
8753,0.8753,20,21,20,597380,8230,93994,13962,0.07623476231057097,0.6291456380677721
8754,0.8754,10,11,10,597391,8219,94004,13952,0.07613286894660788,0.6292905146362365
8755,0.8755,20,12,20,597403,8207,94024,13932,0.07602171254955722,0.6292967162021772
8756,0.8756,24,24,24,597427,8183,94048,13908,0.07579939975545592,0.6295776560590286
8757,0.8757,13,9,13,597436,8174,94061,13895,0.07571603245766793,0.6296162037246816
8758,0.8758,17,15,17,597451,8159,94078,13878,0.07557708696135462,0.6297590416118346
8759,0.8759,14,16,14,597467,8143,94092,13864,0.07542887843195376,0.6299813695642296
8760,0.876,18,15,18,597482,8128,94110,13846,0.07528993293564044,0.6301083098206972
8761,0.8761,13,12,13,597494,8116,94123,13833,0.0751787765385898,0.6302337236320561
8762,0.8762,10,13,10,597507,8103,94133,13823,0.07505835710845159,0.6304387485177415
8763,0.8763,12,14,12,597521,8089,94145,13811,0.07492867464522583,0.6306392694063927
8764,0.8764,19,14,19,597535,8075,94164,13792,0.07479899218200008,0.6307220926510266
8765,0.8765,16,15,16,597550,8060,94180,13776,0.07466004668568677,0.6308847774317641
8766,0.8766,14,11,14,597561,8049,94194,13762,0.07455815332172366,0.630966026316996
8767,0.8767,16,19,16,597580,8030,94210,13746,0.07438215569306014,0.6312454077883909
8768,0.8768,13,18,13,597598,8012,94223,13733,0.07421542109748416,0.6315474821798115
8769,0.8769,14,12,14,597610,8000,94237,13719,0.0741042647004335,0.6316589161563608
8770,0.877,14,8,14,597618,7992,94251,13705,0.07403016043573307,0.6316541457344333
8771,0.8771,19,13,19,597631,7979,94270,13686,0.07390974100559487,0.6317101315485807
8772,0.8772,11,12,11,597643,7967,94281,13675,0.07379858460854422,0.6318732095000462
8773,0.8773,13,6,13,597649,7961,94294,13662,0.0737430064100189,0.6318272210146603
8774,0.8774,19,8,19,597657,7953,94313,13643,0.07366890214531846,0.6317373587701426
8775,0.8775,22,9,22,597666,7944,94335,13621,0.07358553484753047,0.6316253188036169
8776,0.8776,14,22,14,597688,7922,94349,13607,0.07338174811960428,0.6320312137117376
8777,0.8777,13,14,13,597702,7908,94362,13594,0.07325206565637853,0.6322202585805972
8778,0.8778,16,12,16,597714,7896,94378,13578,0.07314090925932787,0.6322995250069852
8779,0.8779,16,15,16,597729,7881,94394,13562,0.07300196376301456,0.6324674719022525
8780,0.878,16,13,16,597742,7868,94410,13546,0.07288154433287636,0.632576818903521
8781,0.8781,12,13,12,597755,7855,94422,13534,0.07276112490273816,0.6327551545186778
8782,0.8782,13,9,13,597764,7846,94435,13521,0.07267775760495017,0.6327982402770628
8783,0.8783,12,8,12,597772,7838,94447,13509,0.07260365334024974,0.6328289689417717
8784,0.8784,18,14,18,597786,7824,94465,13491,0.07247397087702397,0.6329345531315975
8785,0.8785,18,14,18,597800,7810,94483,13473,0.07234428841379821,0.6330404548230982
8786,0.8786,17,9,17,597809,7801,94500,13456,0.07226092111601022,0.6330150068212824
8787,0.8787,24,14,24,597823,7787,94524,13432,0.07213123865278447,0.6330175785852302
8788,0.8788,16,13,16,597836,7774,94540,13416,0.07201081922264627,0.6331288343558282
8789,0.8789,6,9,6,597845,7765,94546,13410,0.07192745192485828,0.6332939787485242
8790,0.879,13,8,13,597853,7757,94559,13397,0.07185334766015784,0.6333081213954808
8791,0.8791,13,15,13,597868,7742,94572,13384,0.07171440216384453,0.633532140490391
8792,0.8792,17,20,17,597888,7722,94589,13367,0.07152914150209344,0.633837545639907
8793,0.8793,24,14,24,597902,7708,94613,13343,0.07139945903886769,0.6338416227257613
8794,0.8794,17,13,17,597915,7695,94630,13326,0.07127903960872949,0.6339374910803482
8795,0.8795,18,17,18,597932,7678,94648,13308,0.07112156804624106,0.634137043743448
8796,0.8796,10,16,10,597948,7662,94658,13298,0.0709733595168402,0.6344465648854962
8797,0.8797,15,12,15,597960,7650,94673,13283,0.07086220311978954,0.6345483208331343
8798,0.8798,12,20,12,597980,7630,94685,13271,0.07067694245803846,0.6349456963781637
8799,0.8799,12,18,12,597998,7612,94697,13259,0.07051020786246248,0.6352834075990609
8800,0.88,21,11,21,598009,7601,94718,13238,0.0704083144984994,0.6352512116704256
8801,0.8801,14,15,14,598024,7586,94732,13224,0.07026936900218607,0.6354637193656896
8802,0.8802,17,11,17,598035,7575,94749,13207,0.07016747563822298,0.6355018766240016
8803,0.8803,11,7,11,598042,7568,94760,13196,0.0701026344066101,0.6355230206125987
8804,0.8804,18,14,18,598056,7554,94778,13178,0.06997295194338435,0.6356357322014278
8805,0.8805,24,21,24,598077,7533,94802,13154,0.0697784282485457,0.635858268477788
8806,0.8806,9,17,9,598094,7516,94811,13145,0.06962095668605728,0.6362228352935483
8807,0.8807,15,14,15,598108,7502,94826,13130,0.06949127422283152,0.6363900736719659
8808,0.8808,14,11,14,598119,7491,94840,13116,0.06938938085886842,0.6364827485805794
8809,0.8809,12,13,12,598132,7478,94852,13104,0.06926896142873022,0.636672820911476
8810,0.881,14,11,14,598143,7467,94866,13090,0.06916706806476712,0.6367660650873181
8811,0.8811,21,10,21,598153,7457,94887,13069,0.06907443773389159,0.636704667251291
8812,0.8812,18,13,18,598166,7444,94905,13051,0.06895401830375338,0.6367894608441084
8813,0.8813,14,7,14,598173,7437,94919,13037,0.0688891770721405,0.6367588160593924
8814,0.8814,21,20,21,598193,7417,94940,13016,0.06870391641038942,0.6370087603386678
8815,0.8815,10,10,10,598203,7407,94950,13006,0.06861128607951388,0.637142997109685
8816,0.8816,10,20,10,598223,7387,94960,12996,0.0684260254177628,0.6375901486532896
8817,0.8817,11,11,11,598234,7376,94971,12985,0.0683241320537997,0.6377388144000786
8818,0.8818,16,14,16,598248,7362,94987,12969,0.06819444959057394,0.6378928729526339
8819,0.8819,10,10,10,598258,7352,94997,12959,0.0681018192596984,0.6380286544237113
8820,0.882,18,9,18,598267,7343,95015,12941,0.0680184519619104,0.6379905344113587
8821,0.8821,17,8,17,598275,7335,95032,12924,0.06794434769720997,0.6379386939138161
8822,0.8822,21,17,21,598292,7318,95053,12903,0.06778687613472155,0.6380990059838781
8823,0.8823,11,8,11,598300,7310,95064,12892,0.06771277187002112,0.6381546381546381
8824,0.8824,14,8,14,598308,7302,95078,12878,0.06763866760532068,0.6381565906838453
8825,0.8825,31,13,31,598321,7289,95109,12847,0.06751824817518248,0.6380115216527612
8826,0.8826,20,11,20,598332,7278,95129,12827,0.06741635481121938,0.6380004973887092
8827,0.8827,17,14,17,598346,7264,95146,12810,0.06728667234799363,0.6381388861213511
8828,0.8828,15,12,15,598358,7252,95161,12795,0.06717551595094298,0.6382501122362448
8829,0.8829,14,18,14,598376,7234,95175,12781,0.067008781355367,0.6385710716962278
8830,0.883,15,6,15,598382,7228,95190,12766,0.06695320315684168,0.6384915474642393
8831,0.8831,18,18,18,598400,7210,95208,12748,0.0667864685612657,0.6387413568493837
8832,0.8832,15,11,15,598411,7199,95223,12733,0.0666845751973026,0.6388219947822597
8833,0.8833,17,12,17,598423,7187,95240,12716,0.06657341880025196,0.6388986584936944
8834,0.8834,15,13,15,598436,7174,95255,12701,0.06645299937011374,0.6390440251572327
8835,0.8835,11,14,11,598450,7160,95266,12690,0.06632331690688799,0.6392947103274559
8836,0.8836,18,11,18,598461,7149,95284,12672,0.0662214235429249,0.6393219312850008
8837,0.8837,22,10,22,598471,7139,95306,12650,0.06612879321204936,0.6392440244580322
8838,0.8838,20,13,20,598484,7126,95326,12630,0.06600837378191114,0.6392994533306338
8839,0.8839,24,10,24,598494,7116,95350,12606,0.06591574345103561,0.6391846668694858
8840,0.884,13,20,13,598514,7096,95363,12593,0.06573048278928452,0.6395957133424754
8841,0.8841,16,15,16,598529,7081,95379,12577,0.06559153729297121,0.6397904161155764
8842,0.8842,13,14,13,598543,7067,95392,12564,0.06546185482974545,0.6400081503744078
8843,0.8843,17,10,17,598553,7057,95409,12547,0.06536922449886991,0.6400224443991023
8844,0.8844,11,13,11,598566,7044,95420,12536,0.06524880506873171,0.6402451481103166
8845,0.8845,21,8,21,598574,7036,95441,12515,0.06517470080403127,0.6401207099381105
8846,0.8846,14,13,14,598587,7023,95455,12501,0.06505428137389306,0.6402888752304856
8847,0.8847,9,18,9,598605,7005,95464,12492,0.0648875467783171,0.6407139559932298
8848,0.8848,13,10,13,598615,6995,95477,12479,0.06479491644744155,0.6408031221115333
8849,0.8849,8,10,8,598625,6985,95485,12471,0.064702286116566,0.6409847861842105
8850,0.885,13,11,13,598636,6974,95498,12458,0.06460039275260292,0.6411074516261837
8851,0.8851,15,14,15,598650,6960,95513,12443,0.06447071028937715,0.6412925836210895
8852,0.8852,15,11,15,598661,6949,95528,12428,0.06436881692541406,0.6413789544305104
8853,0.8853,19,20,19,598681,6929,95547,12409,0.06418355626366297,0.6416899369117799
8854,0.8854,18,19,18,598700,6910,95565,12391,0.06400755863499945,0.6419874617895446
8855,0.8855,18,8,18,598708,6902,95583,12373,0.06393345437029901,0.6419195849546044
8856,0.8856,8,7,8,598715,6895,95591,12365,0.06386861313868614,0.6420041536863966
8857,0.8857,13,14,13,598729,6881,95604,12352,0.06373893067546037,0.6422295013778402
8858,0.8858,11,10,11,598739,6871,95615,12341,0.06364630034458484,0.6423589423277118
8859,0.8859,12,17,12,598756,6854,95627,12329,0.06348882878209641,0.6427044779231611
8860,0.886,18,15,18,598771,6839,95645,12311,0.0633498832857831,0.6428720626631854
8861,0.8861,8,9,8,598780,6830,95653,12303,0.06326651598799511,0.6430251398107981
8862,0.8862,16,8,16,598788,6822,95669,12287,0.06319241172329468,0.6429954471714898
8863,0.8863,14,15,14,598803,6807,95683,12273,0.06305346622698137,0.6432389937106918
8864,0.8864,13,10,13,598813,6797,95696,12260,0.06296083589610582,0.6433331584194784
8865,0.8865,19,13,19,598826,6784,95715,12241,0.06284041646596762,0.6434165571616295
8866,0.8866,19,8,19,598834,6776,95734,12222,0.06276631220126719,0.6433308769344142
8867,0.8867,11,12,11,598846,6764,95745,12211,0.06265515580421653,0.6435309617918313
8868,0.8868,19,11,19,598857,6753,95764,12192,0.06255326244025344,0.6435471100554236
8869,0.8869,15,12,15,598869,6741,95779,12177,0.062442106043202786,0.6436726926736441
8870,0.887,9,13,9,598882,6728,95788,12168,0.06232168661306458,0.6439458086367486
8871,0.8871,15,16,15,598898,6712,95803,12153,0.06217347808366371,0.6442088523721177
8872,0.8872,17,9,17,598907,6703,95820,12136,0.06209011078587573,0.6441955517808801
8873,0.8873,10,17,10,598924,6686,95830,12126,0.061932639223387306,0.6445885604933022
8874,0.8874,13,14,13,598938,6672,95843,12113,0.061802956760161544,0.644822997072132
8875,0.8875,16,12,16,598950,6660,95859,12097,0.0616918003631109,0.644932558511489
8876,0.8876,14,19,14,598969,6641,95873,12083,0.061515802734447365,0.6453215124973296
8877,0.8877,13,8,13,598977,6633,95886,12070,0.06144169846974693,0.6453510132064375
8878,0.8878,14,12,14,598989,6621,95900,12056,0.06133054207269628,0.6454998126037372
8879,0.8879,14,15,14,599004,6606,95914,12042,0.06119159657638297,0.6457528957528957
8880,0.888,12,15,12,599019,6591,95926,12030,0.06105265108006966,0.6460447881424198
8881,0.8881,21,12,21,599031,6579,95947,12009,0.06094149468301901,0.6460619754680439
8882,0.8882,17,15,17,599046,6564,95964,11992,0.0608025491867057,0.6462599698210821
8883,0.8883,19,7,19,599053,6557,95983,11973,0.06073770795509281,0.6461413923367512
8884,0.8884,22,15,22,599068,6542,96005,11951,0.0605987624587795,0.6462445249553885
8885,0.8885,18,12,18,599080,6530,96023,11933,0.06048760606172885,0.6463196663597465
8886,0.8886,16,7,16,599087,6523,96039,11917,0.06042276483011597,0.6462581344902386
8887,0.8887,17,11,17,599098,6512,96056,11900,0.06032087146615288,0.6463176189441668
8888,0.8888,9,12,9,599110,6500,96065,11891,0.06020971506910223,0.6465662552335382
8889,0.8889,11,15,11,599125,6485,96076,11880,0.06007076957278892,0.6468826572284236
8890,0.889,20,10,20,599135,6475,96096,11860,0.05997813924191337,0.6468502863376057
8891,0.8891,17,5,17,599140,6470,96113,11843,0.0599318240764756,0.6466990662370993
8892,0.8892,19,12,19,599152,6458,96132,11824,0.05982066767942495,0.6467563723881413
8893,0.8893,22,6,22,599158,6452,96154,11802,0.059765089480899626,0.6465432234030898
8894,0.8894,14,24,14,599182,6428,96168,11788,0.059542776686798325,0.6471234079929732
8895,0.8895,22,11,22,599193,6417,96190,11766,0.05944088332283523,0.6470879392839466
8896,0.8896,11,10,11,599203,6407,96201,11755,0.059348252991959685,0.6472304812245347
8897,0.8897,16,11,16,599214,6396,96217,11739,0.05924635962799659,0.6473118279569893
8898,0.8898,9,10,9,599224,6386,96226,11730,0.05915372929712105,0.6474939280194303
8899,0.8899,16,16,16,599240,6370,96242,11714,0.059005520767720185,0.6477549214775492
8900,0.89,14,19,14,599259,6351,96256,11700,0.05882952313905665,0.6481635366461692
8901,0.8901,17,9,17,599268,6342,96273,11683,0.05874615584126867,0.6481553398058253
8902,0.8902,14,15,14,599283,6327,96287,11669,0.05860721034495535,0.648421871527006
8903,0.8903,20,14,20,599297,6313,96307,11649,0.058477527881729593,0.6485357977953458
8904,0.8904,18,19,18,599316,6294,96325,11631,0.058301530253066065,0.6488702928870292
8905,0.8905,12,13,12,599329,6281,96337,11619,0.05818111082292786,0.6491061452513966
8906,0.8906,16,7,16,599336,6274,96353,11603,0.05811626959131498,0.6490462605582592
8907,0.8907,16,11,16,599347,6263,96369,11587,0.05801437622735189,0.6491316526610644
8908,0.8908,7,13,7,599360,6250,96376,11580,0.05789395679721368,0.6494671901289961
8909,0.8909,12,18,12,599378,6232,96388,11568,0.0577272222016377,0.6498876404494383
8910,0.891,11,9,11,599387,6223,96399,11557,0.05764385490384972,0.65
8911,0.8911,23,10,23,599397,6213,96422,11534,0.05755122457297417,0.6499126612948667
8912,0.8912,20,7,20,599404,6206,96442,11514,0.057486383341361295,0.6497742663656885
8913,0.8913,15,9,15,599413,6197,96457,11499,0.057403016043573306,0.6498078661844484
8914,0.8914,22,15,22,599428,6182,96479,11477,0.057264070547259995,0.649923551729996
8915,0.8915,16,18,16,599446,6164,96495,11461,0.05709733595168402,0.6502695035460992
8916,0.8916,18,9,18,599455,6155,96513,11443,0.05701396865389603,0.6502443459484032
8917,0.8917,18,16,18,599471,6139,96531,11425,0.056865760124495165,0.6504782509678889
8918,0.8918,14,9,14,599480,6130,96545,11411,0.056782392826707176,0.6505330368850123
8919,0.8919,14,15,14,599495,6115,96559,11397,0.056643447330393865,0.6508108725445408
8920,0.892,13,12,13,599507,6103,96572,11384,0.056532290933343214,0.6509978841425058
8921,0.8921,15,7,15,599514,6096,96587,11369,0.056467449701730336,0.6509590609791011
8922,0.8922,30,9,30,599523,6087,96617,11339,0.05638408240394235,0.650694364742339
8923,0.8923,16,12,16,599535,6075,96633,11323,0.056272926006891696,0.6508219335555812
8924,0.8924,14,11,14,599546,6064,96647,11309,0.0561710326429286,0.6509526276405917
8925,0.8925,10,8,10,599554,6056,96657,11299,0.05609692837822817,0.6510515701526938
8926,0.8926,20,16,20,599570,6040,96677,11279,0.0559487198488273,0.6512500721750678
8927,0.8927,10,13,10,599583,6027,96687,11269,0.055828300418689095,0.6515379278445883
8928,0.8928,14,11,14,599594,6016,96701,11255,0.055726407054726,0.6516704302009149
8929,0.8929,22,6,22,599600,6010,96723,11233,0.05567082885620067,0.6514527634402366
8930,0.893,12,12,12,599612,5998,96735,11221,0.05555967245915002,0.6516638596898775
8931,0.8931,19,12,19,599624,5986,96754,11202,0.05544851606209937,0.6517337677449383
8932,0.8932,20,14,20,599638,5972,96774,11182,0.055318833598873615,0.651859624577358
8933,0.8933,17,13,17,599651,5959,96791,11165,0.05519841416873541,0.6520088764307405
8934,0.8934,16,16,16,599667,5943,96807,11149,0.05505020563933454,0.6522934706295342
8935,0.8935,15,5,15,599672,5938,96822,11134,0.055003890473896776,0.6521790065604499
8936,0.8936,16,7,16,599679,5931,96838,11118,0.05493904924228389,0.6521203589653352
8937,0.8937,17,7,17,599686,5924,96855,11101,0.05487420801067101,0.6520411160058737
8938,0.8938,12,11,12,599697,5913,96867,11089,0.05477231464670792,0.65221738618986
8939,0.8939,16,8,16,599705,5905,96883,11073,0.054698210382007485,0.6521969607727648
8940,0.894,28,15,28,599720,5890,96911,11045,0.054559264885694174,0.6521995866548568
8941,0.8941,13,10,13,599730,5880,96924,11032,0.05446663455481863,0.652317880794702
8942,0.8942,9,12,9,599742,5868,96933,11023,0.05435547815776798,0.6525960570718133
8943,0.8943,13,9,13,599751,5859,96946,11010,0.05427211085997999,0.6526765072025609
8944,0.8944,15,18,15,599769,5841,96961,10995,0.054105376264404016,0.6530648610121169
8945,0.8945,15,7,15,599776,5834,96976,10980,0.05404053503279114,0.653027239205424
8946,0.8946,15,12,15,599788,5822,96991,10965,0.05392937863574049,0.6531840114374218
8947,0.8947,16,8,16,599796,5814,97007,10949,0.053855274371040054,0.6531647079878303
8948,0.8948,15,9,15,599805,5805,97022,10934,0.053771907073252065,0.6532050899097915
8949,0.8949,16,13,16,599818,5792,97038,10918,0.05365148764311386,0.6533812088569718
8950,0.895,20,13,20,599831,5779,97058,10898,0.05353106821297566,0.6534748455957307
8951,0.8951,14,14,14,599845,5765,97072,10884,0.0534013857497499,0.6537329569343504
8952,0.8952,7,12,7,599857,5753,97079,10877,0.053290229352699246,0.6540589296452195
8953,0.8953,16,11,16,599868,5742,97095,10861,0.05318833598873615,0.654158886948142
8954,0.8954,13,7,13,599875,5735,97108,10848,0.053123494757123274,0.654163902792016
8955,0.8955,10,12,10,599887,5723,97118,10838,0.053012338360072624,0.654429080369543
8956,0.8956,19,7,19,599894,5716,97137,10819,0.052947497128459746,0.6543090414272755
8957,0.8957,18,17,18,599911,5699,97155,10801,0.05279002556597132,0.6546060606060606
8958,0.8958,13,16,13,599927,5683,97168,10788,0.052641817036570455,0.654969340052213
8959,0.8959,14,6,14,599933,5677,97182,10774,0.05258623883804513,0.6549145948574555
8960,0.896,17,9,17,599942,5668,97199,10757,0.052502871540257144,0.6549162861491629
8961,0.8961,12,11,12,599953,5657,97211,10745,0.05240097817629404,0.6551030362150957
8962,0.8962,17,9,17,599962,5648,97228,10728,0.05231761087850606,0.655105031753786
8963,0.8963,9,14,9,599976,5634,97237,10719,0.0521879284152803,0.6554760594386351
8964,0.8964,9,11,9,599987,5623,97246,10710,0.0520860350513172,0.65572766791159
8965,0.8965,9,15,9,600002,5608,97255,10701,0.05194708955500389,0.6561407811637746
8966,0.8966,16,9,16,600011,5599,97271,10685,0.0518637222572159,0.6561655612871531
8967,0.8967,19,14,19,600025,5585,97290,10666,0.05173403979399015,0.6563288413020737
8968,0.8968,15,7,15,600032,5578,97305,10651,0.05166919856237726,0.6562942880029576
8969,0.8969,17,8,17,600040,5570,97322,10634,0.05159509429767683,0.6562577141446556
8970,0.897,21,10,21,600050,5560,97343,10613,0.05150246396680129,0.6562171520435294
8971,0.8971,14,12,14,600062,5548,97357,10599,0.05139130756975064,0.6564067628661671
8972,0.8972,14,10,14,600072,5538,97371,10585,0.051298677238875094,0.6565155368107672
8973,0.8973,18,12,18,600084,5526,97389,10567,0.051187520841824444,0.6566208910706518
8974,0.8974,11,10,11,600094,5516,97400,10556,0.051094890510948905,0.6567944250871081
8975,0.8975,13,9,13,600103,5507,97413,10543,0.051011523213160916,0.6568847352024922
8976,0.8976,26,13,26,600116,5494,97439,10517,0.050891103783022716,0.6568609081256636
8977,0.8977,12,17,12,600133,5477,97451,10505,0.05073363222053429,0.6573019647102991
8978,0.8978,14,17,14,600150,5460,97465,10491,0.05057616065804587,0.6577017114914425
8979,0.8979,12,4,12,600154,5456,97477,10479,0.05053910852569565,0.6576090367116411
8980,0.898,16,9,16,600163,5447,97493,10463,0.05045574122790766,0.6576367064739158
8981,0.8981,20,9,20,600172,5438,97513,10443,0.05037237393011968,0.6575782381462124
8982,0.8982,16,7,16,600179,5431,97529,10427,0.050307532698506796,0.657523016773868
8983,0.8983,19,11,19,600190,5420,97548,10408,0.0502056393345437,0.6575688653019964
8984,0.8984,12,14,12,600204,5406,97560,10396,0.050075956871317946,0.6578914061511201
8985,0.8985,13,10,13,600214,5396,97573,10383,0.0499833265404424,0.658026490905634
8986,0.8986,12,5,12,600219,5391,97585,10371,0.049937011375004635,0.6579748762847354
8987,0.8987,11,5,11,600224,5386,97596,10360,0.04989069620956686,0.6579448748888607
8988,0.8988,16,12,16,600236,5374,97612,10344,0.04977953981251621,0.6580989947830512
8989,0.8989,16,11,16,600247,5363,97628,10328,0.04967764644855312,0.6582117137212414
8990,0.899,18,9,18,600256,5354,97646,10310,0.04959427915076513,0.658197139938713
8991,0.8991,20,11,20,600267,5343,97666,10290,0.04949238578680203,0.6582229898292075
8992,0.8992,13,7,13,600274,5336,97679,10277,0.04942754455518915,0.6582335233459297
8993,0.8993,19,13,19,600287,5323,97698,10258,0.04930712512505095,0.6583659585392465
8994,0.8994,20,9,20,600296,5314,97718,10238,0.04922375782726296,0.6583076131687243
8995,0.8995,16,10,16,600306,5304,97734,10222,0.049131127496387414,0.6583794924642535
8996,0.8996,13,13,13,600319,5291,97747,10209,0.049010708066249214,0.6586451612903226
8997,0.8997,18,13,18,600332,5278,97765,10191,0.04889028863611101,0.6588014739155731
8998,0.8998,17,10,17,600342,5268,97782,10174,0.04879765830523547,0.6588524802486725
8999,0.8999,13,13,13,600355,5255,97795,10161,0.04867723887509726,0.6591203943954334
9000,0.9,18,9,18,600364,5246,97813,10143,0.048593871577309274,0.6591071544609787
9001,0.9001,15,5,15,600369,5241,97828,10128,0.0485475564118715,0.6589888737068124
9002,0.9002,22,11,22,600380,5230,97850,10106,0.048445663047908406,0.6589723526343245
9003,0.9003,21,13,21,600393,5217,97871,10085,0.0483252436177702,0.6590641746176971
9004,0.9004,14,17,14,600410,5200,97885,10071,0.048167772055281784,0.6594852989326174
9005,0.9005,16,14,16,600424,5186,97901,10055,0.04803808959205602,0.6597336132799685
9006,0.9006,13,13,13,600437,5173,97914,10042,0.047917670161917815,0.6600065724613868
9007,0.9007,11,12,11,600449,5161,97925,10031,0.04780651376486717,0.6602817272248552
9008,0.9008,16,8,16,600457,5153,97941,10015,0.04773240950016674,0.6602716244725738
9009,0.9009,12,15,12,600472,5138,97953,10003,0.04759346400385342,0.6606564956079519
9010,0.901,21,15,21,600487,5123,97974,9982,0.04745451850754011,0.6608407811982787
9011,0.9011,16,11,16,600498,5112,97990,9966,0.047352625143577014,0.6609629924393156
9012,0.9012,16,12,16,600510,5100,98006,9950,0.04724146874652636,0.6611295681063123
9013,0.9013,14,11,14,600521,5089,98020,9936,0.04713957538256327,0.6612978369384359
9014,0.9014,10,10,10,600531,5079,98030,9926,0.04704694505168772,0.661512829056981
9015,0.9015,23,13,23,600544,5066,98053,9903,0.04692652562154952,0.6615672389605184
9016,0.9016,12,11,12,600555,5055,98065,9891,0.04682463225758642,0.6617824167001204
9017,0.9017,8,8,8,600563,5047,98073,9883,0.04675052799288599,0.6619557937039517
9018,0.9018,23,8,23,600571,5039,98096,9860,0.046676423728185555,0.6617893818377072
9019,0.9019,11,12,11,600583,5027,98107,9849,0.046565267331134905,0.6620731379403065
9020,0.902,15,13,15,600596,5014,98122,9834,0.046444847900996705,0.6623114224137931
9021,0.9021,17,9,17,600605,5005,98139,9817,0.046361480603208716,0.6623262717581972
9022,0.9022,13,7,13,600612,4998,98152,9804,0.04629663937159584,0.6623429266315363
9023,0.9023,15,15,15,600627,4983,98167,9789,0.04615769387528252,0.662672623883022
9024,0.9024,14,11,14,600638,4972,98181,9775,0.046055800511319425,0.6628466806808164
9025,0.9025,17,16,17,600654,4956,98198,9758,0.04590759198191856,0.6631779257849667
9026,0.9026,14,14,14,600668,4942,98212,9744,0.0457779095186928,0.663489037178265
9027,0.9027,22,7,22,600675,4935,98234,9722,0.045713068287079925,0.6633008118987515
9028,0.9028,10,6,10,600681,4929,98244,9712,0.045657490088554596,0.6633426678505566
9029,0.9029,17,11,17,600692,4918,98261,9695,0.0455555967245915,0.6634503524259221
9030,0.903,24,10,24,600702,4908,98285,9671,0.045462966393715956,0.6633513958433364
9031,0.9031,19,9,19,600711,4899,98304,9652,0.045379599095927974,0.6633221084461549
9032,0.9032,15,18,15,600729,4881,98319,9637,0.045212864500351994,0.6637966662074666
9033,0.9033,14,14,14,600743,4867,98333,9623,0.04508318203712624,0.6641131815044858
9034,0.9034,12,11,12,600754,4856,98345,9611,0.04498128867316314,0.664339531347204
9035,0.9035,21,10,21,600764,4846,98366,9590,0.0448886583422876,0.6643114436131893
9036,0.9036,13,13,13,600777,4833,98379,9577,0.04476823891214939,0.6646079111727967
9037,0.9037,12,14,12,600791,4819,98391,9565,0.04463855644892364,0.6649749721913237
9038,0.9038,12,5,12,600796,4814,98403,9553,0.044592241283485864,0.6649265678290527
9039,0.9039,16,8,16,600804,4806,98419,9537,0.04451813701878543,0.664923656138883
9040,0.904,19,9,19,600813,4797,98438,9518,0.04443476972099744,0.6648969612294796
9041,0.9041,22,10,22,600823,4787,98460,9496,0.0443421393901219,0.6648463208009522
9042,0.9042,14,7,14,600830,4780,98474,9482,0.044277298158509025,0.6648436404431356
9043,0.9043,12,8,12,600838,4772,98486,9470,0.04420319389380859,0.6649347001825586
9044,0.9044,11,10,11,600848,4762,98497,9459,0.044110563562933046,0.6651430982350046
9045,0.9045,14,14,14,600862,4748,98511,9445,0.04398088109970729,0.665468893116325
9046,0.9046,8,5,8,600867,4743,98519,9437,0.04393456593426952,0.6655148095909732
9047,0.9047,18,12,18,600879,4731,98537,9419,0.04382340953721887,0.6656537102473499
9048,0.9048,14,8,14,600887,4723,98551,9405,0.043749305272518434,0.6656993204983013
9049,0.9049,18,20,18,600907,4703,98569,9387,0.04356404461076735,0.6662171753016324
9050,0.905,14,7,14,600914,4696,98583,9373,0.04349920337915447,0.6662165043713129
9051,0.9051,13,11,13,600925,4685,98596,9360,0.04339731001519138,0.6664293342826628
9052,0.9052,19,10,19,600935,4675,98615,9341,0.04330467968431583,0.6664526255707762
9053,0.9053,14,11,14,600946,4664,98629,9327,0.04320278632035274,0.6666428418268887
9054,0.9054,13,18,13,600964,4646,98642,9314,0.04303605172477676,0.6671919770773639
9055,0.9055,22,11,22,600975,4635,98664,9292,0.042934158360813664,0.6671932217993825
9056,0.9056,23,7,23,600982,4628,98687,9269,0.042869317129200786,0.6669784845650141
9057,0.9057,16,14,16,600996,4614,98703,9253,0.042739634665975024,0.6672676137592847
9058,0.9058,9,11,9,601007,4603,98712,9244,0.04263774130201193,0.6675814255795479
9059,0.9059,13,10,13,601017,4593,98725,9231,0.04254511097113639,0.6677517361111112
9060,0.906,15,13,15,601030,4580,98740,9216,0.042424691540998184,0.6680197158596695
9061,0.9061,13,14,13,601044,4566,98753,9203,0.04229500907777243,0.6683855036676593
9062,0.9062,13,6,13,601050,4560,98766,9190,0.0422394308792471,0.6683636363636364
9063,0.9063,18,9,18,601059,4551,98784,9172,0.04215606358145911,0.668366975151206
9064,0.9064,10,11,10,601070,4540,98794,9162,0.042054170217496016,0.6686615092687199
9065,0.9065,8,14,8,601084,4526,98802,9154,0.04192448775427026,0.6691520467836257
9066,0.9066,15,6,15,601090,4520,98817,9139,0.04186890955574493,0.6690826561241672
9067,0.9067,21,14,21,601104,4506,98838,9118,0.04173922709251918,0.6692601291837933
9068,0.9068,14,9,14,601113,4497,98852,9104,0.04165585979473119,0.6693625468715536
9069,0.9069,15,9,15,601122,4488,98867,9089,0.0415724924969432,0.6694409663401341
9070,0.907,13,12,13,601134,4476,98880,9076,0.04146133609989255,0.6697166469893743
9071,0.9071,13,13,13,601147,4463,98893,9063,0.04134091666975435,0.6700428803785302
9072,0.9072,12,9,12,601156,4454,98905,9051,0.04125754937196636,0.6701962236208812
9073,0.9073,4,7,4,601163,4447,98909,9047,0.04119270814035348,0.6704461242033496
9074,0.9074,17,12,17,601175,4435,98926,9030,0.04108155174330283,0.6706275529149647
9075,0.9075,17,5,17,601180,4430,98943,9013,0.04103523657786506,0.670460462694339
9076,0.9076,14,10,14,601190,4420,98957,8999,0.04094260624698951,0.6706162903346002
9077,0.9077,12,16,12,601206,4404,98969,8987,0.040794397717588644,0.6711223956388619
9078,0.9078,16,8,16,601214,4396,98985,8971,0.04072029345288821,0.6711303957507294
9079,0.9079,16,8,16,601222,4388,99001,8955,0.04064618918818778,0.6711384246421345
9080,0.908,15,13,15,601235,4375,99016,8940,0.04052576975804958,0.6714232069095005
9081,0.9081,16,13,16,601248,4362,99032,8924,0.04040535032791137,0.671684479903658
9082,0.9082,11,11,11,601259,4351,99043,8913,0.04030345696394828,0.6719692400482509
9083,0.9083,14,14,14,601273,4337,99057,8899,0.040173774500722514,0.6723330311272288
9084,0.9084,16,8,16,601281,4329,99073,8883,0.04009967023602208,0.6723433242506812
9085,0.9085,15,9,15,601290,4320,99088,8868,0.0400163029382341,0.6724294813466788
9086,0.9086,12,4,12,601294,4316,99100,8856,0.03997925080588388,0.6723352566049196
9087,0.9087,16,6,16,601300,4310,99116,8840,0.03992367260735855,0.6722433460076046
9088,0.9088,13,12,13,601312,4298,99129,8827,0.0398125162103079,0.6725333333333333
9089,0.9089,19,15,19,601327,4283,99148,8808,0.03967357071399459,0.672828660912077
9090,0.909,16,12,16,601339,4271,99164,8792,0.03956241431694394,0.6730460078083136
9091,0.9091,13,10,13,601349,4261,99177,8779,0.039469783986068395,0.6732361963190184
9092,0.9092,11,9,11,601358,4252,99188,8768,0.03938641668828041,0.6734254992319508
9093,0.9093,16,10,16,601368,4242,99204,8752,0.03929378635740487,0.6735416346005849
9094,0.9094,10,7,10,601375,4235,99214,8742,0.03922894512579199,0.6736533867611929
9095,0.9095,20,6,20,601381,4229,99234,8722,0.03917336692726667,0.6734615087638021
9096,0.9096,22,8,22,601389,4221,99256,8700,0.039099262662566234,0.6733224982586488
9097,0.9097,14,14,14,601403,4207,99270,8686,0.03896958019934047,0.6736989063833088
9098,0.9098,14,15,14,601418,4192,99284,8672,0.03883063470302716,0.6741293532338308
9099,0.9099,13,9,13,601427,4183,99297,8659,0.03874726740523917,0.6742719202616415
9100,0.91,13,5,13,601432,4178,99310,8646,0.0387009522398014,0.6742046163443544
9101,0.9101,11,11,11,601443,4167,99321,8635,0.0385990588758383,0.6745039837525386
9102,0.9102,13,13,13,601456,4154,99334,8622,0.0384786394457001,0.6748591108328115
9103,0.9103,15,8,15,601464,4146,99349,8607,0.03840453518099966,0.6749000235238767
9104,0.9104,18,7,18,601471,4139,99367,8589,0.038339693949386786,0.674811439346323
9105,0.9105,8,5,8,601476,4134,99375,8581,0.03829337878394902,0.6748721981911129
9106,0.9106,14,9,14,601485,4125,99389,8567,0.03821001148616103,0.6749921210211156
9107,0.9107,10,15,10,601500,4110,99399,8557,0.03807106598984772,0.6755348543459383
9108,0.9108,20,8,20,601508,4102,99419,8537,0.037996961725147285,0.6754490070416963
9109,0.9109,12,9,12,601517,4093,99431,8525,0.037913594427359296,0.6756221271199874
9110,0.911,20,11,20,601528,4082,99451,8505,0.0378117010633962,0.6756971478509574
9111,0.9111,11,10,11,601538,4072,99462,8494,0.037719070732520656,0.6759509788317682
9112,0.9112,22,13,22,601551,4059,99484,8472,0.03759865130238245,0.6760833133828106
9113,0.9113,12,8,12,601559,4051,99496,8460,0.037524547037682016,0.6762049396531052
9114,0.9114,18,10,18,601569,4041,99514,8442,0.03743191670680648,0.6762797404470079
9115,0.9115,14,9,14,601578,4032,99528,8428,0.03734854940901849,0.6764044943820224
9116,0.9116,15,9,15,601587,4023,99543,8413,0.0372651821112305,0.6765036989385654
9117,0.9117,11,7,11,601594,4016,99554,8402,0.03720034087961762,0.6765984860686101
9118,0.9118,15,6,15,601600,4010,99569,8387,0.0371447626810923,0.6765346454787449
9119,0.9119,18,6,18,601606,4004,99587,8369,0.03708918448256697,0.6763921441849188
9120,0.912,19,10,19,601616,3994,99606,8350,0.03699655415169143,0.6764419961114712
9121,0.9121,15,15,15,601631,3979,99621,8335,0.03685760865537812,0.6768718531752477
9122,0.9122,15,15,15,601646,3964,99636,8320,0.0367186631590648,0.6773038098339303
9123,0.9123,11,12,11,601658,3952,99647,8309,0.03660750676201415,0.6776771878313351
9124,0.9124,19,10,19,601668,3942,99666,8290,0.03651487643113861,0.6777305428384565
9125,0.9125,12,11,12,601679,3931,99678,8278,0.03641298306717552,0.6780244082234417
9126,0.9126,19,10,19,601689,3921,99697,8259,0.03632035273629997,0.6780788177339901
9127,0.9127,13,5,13,601694,3916,99710,8246,0.0362740375708622,0.6780134846242394
9128,0.9128,14,10,14,601704,3906,99724,8232,0.03618140723998666,0.6782006920415224
9129,0.9129,15,8,15,601712,3898,99739,8217,0.03610730297528623,0.6782501031778787
9130,0.913,12,16,12,601728,3882,99751,8205,0.03595909444588536,0.6788284934226855
9131,0.9131,18,4,18,601732,3878,99769,8187,0.035922042313535144,0.6785743887277248
9132,0.9132,13,5,13,601737,3873,99782,8174,0.03587572714809737,0.6785091724080684
9133,0.9133,15,9,15,601746,3864,99797,8159,0.03579235985030939,0.678615986026782
9134,0.9134,20,9,20,601755,3855,99817,8139,0.0357089925525214,0.6785892946473236
9135,0.9135,15,9,15,601764,3846,99832,8124,0.03562562525473341,0.6786967418546366
9136,0.9136,10,10,10,601774,3836,99842,8114,0.03553299492385787,0.6789958158995816
9137,0.9137,17,10,17,601784,3826,99859,8097,0.035440364592982325,0.6791076071458525
9138,0.9138,16,8,16,601792,3818,99875,8081,0.03536626032828189,0.6791327002269099
9139,0.9139,10,12,10,601804,3806,99885,8071,0.03525510393123124,0.6795487075860908
9140,0.914,7,8,7,601812,3798,99892,8064,0.03518099966653081,0.6798179059180577
9141,0.9141,12,14,12,601826,3784,99904,8052,0.03505131720330505,0.6802973977695167
9142,0.9142,10,5,10,601831,3779,99914,8042,0.03500500203786728,0.6803146941883089
9143,0.9143,9,9,9,601840,3770,99923,8033,0.03492163474007929,0.6805896805896806
9144,0.9144,10,5,10,601845,3765,99933,8023,0.034875319574641524,0.6806073973532406
9145,0.9145,16,7,16,601852,3758,99949,8007,0.03481047834302864,0.6805779855503612
9146,0.9146,18,18,18,601870,3740,99967,7989,0.03464374374745267,0.6811322363372837
9147,0.9147,12,6,12,601876,3734,99979,7977,0.03458816554892734,0.6811544701562633
9148,0.9148,15,7,15,601883,3727,99994,7962,0.03452332431731446,0.6811532209769869
9149,0.9149,14,8,14,601891,3719,100008,7948,0.03444922005261403,0.6812376789234593
9150,0.915,15,8,15,601899,3711,100023,7933,0.03437511578791359,0.6812950875987633
9151,0.9151,10,9,10,601908,3702,100033,7923,0.034291748490125604,0.6815483870967742
9152,0.9152,14,12,14,601920,3690,100047,7909,0.03418059209307495,0.681869126648849
9153,0.9153,14,7,14,601927,3683,100061,7895,0.034115750861462076,0.6818967006391432
9154,0.9154,17,9,17,601936,3674,100078,7878,0.03403238356367409,0.6819598337950139
9155,0.9155,13,8,13,601944,3666,100091,7865,0.03395827929897366,0.6820744081172492
9156,0.9156,16,12,16,601956,3654,100107,7849,0.03384712290192301,0.682343736416587
9157,0.9157,15,13,15,601969,3641,100122,7834,0.0337267034717848,0.6827015250544662
9158,0.9158,10,14,10,601983,3627,100132,7824,0.03359702100855904,0.6832591040083835
9159,0.9159,19,10,19,601993,3617,100151,7805,0.0335043906776835,0.6833304149886185
9160,0.916,11,6,11,601999,3611,100162,7794,0.03344881247915817,0.6833844804910127
9161,0.9161,19,10,19,602009,3601,100181,7775,0.033356182148282634,0.6834563994374121
9162,0.9162,17,6,17,602015,3595,100198,7758,0.033300603949757306,0.683343609618603
9163,0.9163,16,14,16,602029,3581,100214,7742,0.03317092148653155,0.683741058023492
9164,0.9164,19,8,19,602037,3573,100233,7723,0.03309681722183112,0.683693342776204
9165,0.9165,15,7,15,602044,3566,100248,7708,0.03303197599021824,0.6836970019513926
9166,0.9166,9,2,9,602046,3564,100257,7699,0.03301344992404313,0.6835656574624878
9167,0.9167,7,14,7,602060,3550,100264,7692,0.03288376746081737,0.6842198896993418
9168,0.9168,19,9,19,602069,3541,100283,7673,0.03280040016302938,0.6842339932227572
9169,0.9169,12,7,12,602076,3534,100295,7661,0.032735558931416504,0.684323358642251
9170,0.917,22,14,22,602090,3520,100317,7639,0.03260587646819074,0.684559548346626
9171,0.9171,10,8,10,602098,3512,100327,7629,0.03253177220349031,0.6847679741495377
9172,0.9172,14,9,14,602107,3503,100341,7615,0.032448404905702326,0.6849253462853031
9173,0.9173,10,13,10,602120,3490,100351,7605,0.03232798547556412,0.6854438936457864
9174,0.9174,16,14,16,602134,3476,100367,7589,0.03219830301233836,0.6858563036601898
9175,0.9175,11,8,11,602142,3468,100378,7578,0.03212419874763792,0.686040195545899
9176,0.9176,6,9,6,602151,3459,100384,7572,0.03204083144984994,0.686429154201795
9177,0.9177,15,3,15,602154,3456,100399,7557,0.03201304235058727,0.6861890493053664
9178,0.9178,12,7,12,602161,3449,100411,7545,0.031948201118974395,0.6862834273239949
9179,0.9179,16,12,16,602173,3437,100427,7529,0.031837044721923745,0.686576691592194
9180,0.918,14,9,14,602182,3428,100441,7515,0.03175367742413576,0.6867403819793475
9181,0.9181,8,11,8,602193,3417,100449,7507,0.03165178406017266,0.6872024899304284
9182,0.9182,13,9,13,602202,3408,100462,7494,0.03156841676238468,0.6873968079251513
9183,0.9183,10,4,10,602206,3404,100472,7484,0.03153136463003446,0.6873622336517267
9184,0.9184,4,9,4,602215,3395,100476,7480,0.03144799733224647,0.6878160919540229
9185,0.9185,14,9,14,602224,3386,100490,7466,0.03136463003445848,0.6879837817913749
9186,0.9186,17,5,17,602229,3381,100507,7449,0.03131831486902071,0.6878116343490305
9187,0.9187,5,11,5,602240,3370,100512,7444,0.031216421505057615,0.6883669317551322
9188,0.9188,13,8,13,602248,3362,100525,7431,0.03114231724035718,0.688501806726582
9189,0.9189,19,10,19,602258,3352,100544,7412,0.03104968690948164,0.6885916016350799
9190,0.919,17,11,17,602269,3341,100561,7395,0.030947793545518545,0.6888040238450075
9191,0.9191,15,7,15,602276,3334,100576,7380,0.030882952313905664,0.6888183684898264
9192,0.9192,13,14,13,602290,3320,100589,7367,0.030753269850679908,0.6893421914475532
9193,0.9193,13,7,13,602297,3313,100602,7354,0.030688428619067027,0.6894159557513828
9194,0.9194,13,16,13,602313,3297,100615,7341,0.03054022008966616,0.6900733220530175
9195,0.9195,15,4,15,602317,3293,100630,7326,0.030503167957315943,0.6898954703832753
9196,0.9196,13,8,13,602325,3285,100643,7313,0.03042906369261551,0.6900358558218532
9197,0.9197,10,10,10,602335,3275,100653,7303,0.030336433361739967,0.6903951597655511
9198,0.9198,20,9,20,602344,3266,100673,7283,0.03025306606395198,0.6903971940468291
9199,0.9199,11,5,11,602349,3261,100684,7272,0.03020675089851421,0.6904015949871831
9200,0.92,11,8,11,602357,3253,100695,7261,0.030132646633813775,0.6906030055164543
9201,0.9201,11,7,11,602364,3246,100706,7250,0.030067805402200897,0.6907393292682927
9202,0.9202,12,7,12,602371,3239,100718,7238,0.030002964170588016,0.6908466163978239
9203,0.9203,16,11,16,602382,3228,100734,7222,0.02990107080662492,0.6911004784688995
9204,0.9204,14,8,14,602390,3220,100748,7208,0.029826966541924488,0.6912159570387418
9205,0.9205,12,9,12,602399,3211,100760,7196,0.0297435992441365,0.6914576727202845
9206,0.9206,11,6,11,602405,3205,100771,7185,0.029688021045611176,0.6915303176130895
9207,0.9207,14,4,14,602409,3201,100785,7171,0.02965096891326096,0.6913806401851138
9208,0.9208,12,9,12,602418,3192,100797,7159,0.02956760161547297,0.6916239976813835
9209,0.9209,18,7,18,602425,3185,100815,7141,0.029502760383860092,0.6915552973077668
9210,0.921,10,6,10,602431,3179,100825,7131,0.029447182185334767,0.691658583899127
9211,0.9211,11,11,11,602442,3168,100836,7120,0.02934528882137167,0.6920684292379471
9212,0.9212,14,6,14,602448,3162,100850,7106,0.029289710622846344,0.6920529801324503
9213,0.9213,10,6,10,602454,3156,100860,7096,0.02923413242432102,0.6921576277799454
9214,0.9214,15,5,15,602459,3151,100875,7081,0.02918781725888325,0.6920445660672401
9215,0.9215,11,5,11,602464,3146,100886,7070,0.029141502093445477,0.6920516836335161
9216,0.9216,15,4,15,602468,3142,100901,7055,0.02910444996109526,0.6918701578895754
9217,0.9217,18,7,18,602475,3135,100919,7037,0.029039608729482382,0.6918010224144711
9218,0.9218,8,10,8,602485,3125,100927,7029,0.02894697839860684,0.6922395115225527
9219,0.9219,11,10,11,602495,3115,100938,7018,0.028854348067731298,0.6925885719924998
9220,0.922,10,11,10,602506,3104,100948,7008,0.0287524547037682,0.6930379746835443
9221,0.9221,8,11,8,602517,3093,100956,7000,0.028650561339805106,0.6935499851382146
9222,0.9222,14,7,14,602524,3086,100970,6986,0.028585720108192228,0.6936060365369341
9223,0.9223,13,8,13,602532,3078,100983,6973,0.028511615843491794,0.6937618147448015
9224,0.9224,16,7,16,602539,3071,100999,6957,0.028446774611878913,0.6937574790586358
9225,0.9225,13,9,13,602548,3062,101012,6944,0.028363407314090927,0.6939836098340996
9226,0.9226,17,6,17,602554,3056,101029,6927,0.028307829115565602,0.6938795953120305
9227,0.9227,21,15,21,602569,3041,101050,6906,0.028168883619252287,0.6942796823162762
9228,0.9228,15,9,15,602578,3032,101065,6891,0.0280855163214643,0.6944472437770836
9229,0.9229,14,6,14,602584,3026,101079,6877,0.028029938122938976,0.6944360294860144
9230,0.923,19,12,19,602596,3014,101098,6858,0.027918781725888325,0.6946920583468396
9231,0.9231,14,10,14,602606,3004,101112,6844,0.027826151395012783,0.6949634443541836
9232,0.9232,12,10,12,602616,2994,101124,6832,0.02773352106413724,0.695298188479544
9233,0.9233,8,10,8,602626,2984,101132,6824,0.0276408907332617,0.6957585644371941
9234,0.9234,13,5,13,602631,2979,101145,6811,0.02759457556782393,0.6957099080694586
9235,0.9235,16,6,16,602637,2973,101161,6795,0.027538997369298605,0.6956388206388207
9236,0.9236,11,8,11,602645,2965,101172,6784,0.02746489310459817,0.6958662426915581
9237,0.9237,9,6,9,602651,2959,101181,6775,0.027409314906072846,0.6960139716457777
9238,0.9238,14,11,14,602662,2948,101195,6761,0.027307421542109748,0.6963641981666495
9239,0.9239,16,11,16,602673,2937,101211,6745,0.027205528178146653,0.6966535839702541
9240,0.924,19,8,19,602681,2929,101230,6726,0.02713142391344622,0.6966338684619369
9241,0.9241,12,8,12,602689,2921,101242,6714,0.027057319648745786,0.6968344577062792
9242,0.9242,18,7,18,602696,2914,101260,6696,0.026992478417132905,0.6967741935483871
9243,0.9243,20,12,20,602708,2902,101280,6676,0.026881322020082254,0.6970139903946544
9244,0.9244,15,12,15,602720,2890,101295,6661,0.026770165623031604,0.6974138833629986
9245,0.9245,12,9,12,602729,2881,101307,6649,0.026686798325243618,0.697691500524659
9246,0.9246,14,6,14,602735,2875,101321,6635,0.026631220126718293,0.6976866456361724
9247,0.9247,16,10,16,602745,2865,101337,6619,0.02653858979584275,0.697912273302404
9248,0.9248,11,6,11,602751,2859,101348,6608,0.026483011597317425,0.6980035914228372
9249,0.9249,5,9,5,602760,2850,101353,6603,0.02639964429952944,0.6985084100285623
9250,0.925,15,8,15,602768,2842,101368,6588,0.026325540034829006,0.6986214209968187
9251,0.9251,17,12,17,602780,2830,101385,6571,0.026214383637778355,0.6989681948728859
9252,0.9252,15,5,15,602785,2825,101400,6556,0.026168068472340583,0.6988593966528088
9253,0.9253,10,9,10,602794,2816,101410,6546,0.026084701174552596,0.6992095706045717
9254,0.9254,17,7,17,602801,2809,101427,6529,0.026019859942939715,0.6991861212251017
9255,0.9255,15,6,15,602807,2803,101442,6514,0.02596428174441439,0.6991520875818397
9256,0.9256,15,9,15,602816,2794,101457,6499,0.025880914446626404,0.6993435919509308
9257,0.9257,17,9,17,602825,2785,101474,6482,0.025797547148838414,0.6994712420416532
9258,0.9258,14,6,14,602831,2779,101488,6468,0.02574196895031309,0.6994700984102953
9259,0.9259,19,10,19,602841,2769,101507,6449,0.025649338619437547,0.6996094597526579
9260,0.926,13,6,13,602847,2763,101520,6436,0.025593760420912222,0.6996412653549299
9261,0.9261,16,8,16,602855,2755,101536,6420,0.02551965615621179,0.6997275204359673
9262,0.9262,17,6,17,602861,2749,101553,6403,0.025464077957686466,0.6996284965034965
9263,0.9263,16,7,16,602868,2742,101569,6387,0.025399236726073585,0.6996385146237266
9264,0.9264,19,7,19,602875,2735,101588,6368,0.025334395494460708,0.6995495990332857
9265,0.9265,13,10,13,602885,2725,101601,6355,0.025241765163585166,0.6998898678414097
9266,0.9266,20,6,20,602891,2719,101621,6335,0.02518618696505984,0.6996907444223548
9267,0.9267,21,12,21,602903,2707,101642,6314,0.02507503056800919,0.6999224032812327
9268,0.9268,11,9,11,602912,2698,101653,6303,0.0249916632702212,0.7002555271636485
9269,0.9269,12,4,12,602916,2694,101665,6291,0.024954611137870984,0.7001669449081803
9270,0.927,10,7,10,602923,2687,101675,6281,0.024889769906258106,0.7003791257805531
9271,0.9271,12,8,12,602931,2679,101687,6269,0.024815665641557672,0.7006034868126956
9272,0.9272,17,3,17,602934,2676,101704,6252,0.024787876542295008,0.7002688172043011
9273,0.9273,13,8,13,602942,2668,101717,6239,0.024713772277594574,0.7004603121140676
9274,0.9274,11,7,11,602949,2661,101728,6228,0.024648931045981697,0.7006412419844752
9275,0.9275,15,7,15,602956,2654,101743,6213,0.024584089814368815,0.7006879440622533
9276,0.9276,11,10,11,602966,2644,101754,6202,0.024491459483493273,0.7011078453538322
9277,0.9277,11,6,11,602972,2638,101765,6191,0.02443588128496795,0.7012119152791936
9278,0.9278,14,8,14,602980,2630,101779,6177,0.024361777020267518,0.7013739071193369
9279,0.9279,12,8,12,602988,2622,101791,6165,0.024287672755567084,0.701604643222943
9280,0.928,10,11,10,602999,2611,101801,6155,0.024185779391603986,0.7021446497832535
9281,0.9281,12,6,12,603005,2605,101813,6143,0.02413020119307866,0.702217649748514
9282,0.9282,17,3,17,603008,2602,101830,6126,0.024102412093816,0.7018790100824931
9283,0.9283,15,6,15,603014,2596,101845,6111,0.024046833895290675,0.7018490869415412
9284,0.9284,11,9,11,603023,2587,101856,6100,0.023963466597502685,0.7021986876942558
9285,0.9285,13,9,13,603032,2578,101869,6087,0.0238800992997147,0.7024812463935373
9286,0.9286,10,11,10,603043,2567,101879,6077,0.0237782059357516,0.7030310041647385
9287,0.9287,11,11,11,603054,2556,101890,6066,0.023676312571788507,0.7035490605427975
9288,0.9288,4,3,4,603057,2553,101894,6062,0.023648523472525843,0.7036564132327336
9289,0.9289,12,10,12,603067,2543,101906,6050,0.0235558931416503,0.7040614453625044
9290,0.929,14,8,14,603075,2535,101920,6036,0.023481788876949867,0.704235211760588
9291,0.9291,19,10,19,603085,2525,101939,6017,0.02338915854607433,0.7044017794427535
9292,0.9292,15,10,15,603095,2515,101954,6002,0.023296528215198786,0.7047082305976283
9293,0.9293,11,5,11,603100,2510,101965,5991,0.023250213049761013,0.7047406187507352
9294,0.9294,12,11,12,603111,2499,101977,5979,0.02314831968579792,0.7052370842179759
9295,0.9295,15,9,15,603120,2490,101992,5964,0.02306495238800993,0.7054648687012065
9296,0.9296,17,6,17,603126,2484,102009,5947,0.023009374189484604,0.7053730281105444
9297,0.9297,7,10,7,603136,2474,102016,5940,0.022916743858609062,0.7059662467316378
9298,0.9298,16,7,16,603143,2467,102032,5924,0.022851902626996184,0.7059945179358836
9299,0.9299,14,6,14,603149,2461,102046,5910,0.02279632442847086,0.7060088400430056
9300,0.93,14,7,14,603156,2454,102060,5896,0.022731483196857978,0.7061077844311378
9301,0.9301,9,8,9,603164,2446,102069,5887,0.022657378932157544,0.7064682587303492
9302,0.9302,10,3,10,603167,2443,102079,5877,0.022629589832894884,0.7063701923076923
9303,0.9303,9,5,9,603172,2438,102088,5868,0.02258327466745711,0.7064772453647965
9304,0.9304,9,13,9,603185,2425,102097,5859,0.022462855237318908,0.7072670207629165
9305,0.9305,16,7,16,603192,2418,102113,5843,0.022398014005706027,0.7072993584311826
9306,0.9306,15,3,15,603195,2415,102128,5828,0.022370224906443366,0.7070241416959845
9307,0.9307,11,10,11,603205,2405,102139,5817,0.022277594575567824,0.7074920943809292
9308,0.9308,15,11,15,603216,2394,102154,5802,0.02217570121160473,0.7079062957540263
9309,0.9309,18,10,18,603226,2384,102172,5784,0.022083070880729187,0.7081292850146915
9310,0.931,8,9,8,603235,2375,102180,5776,0.021999703582941198,0.7086247086247086
9311,0.9311,18,6,18,603241,2369,102198,5758,0.021944125384415872,0.7085025224560109
9312,0.9312,20,7,20,603248,2362,102218,5738,0.021879284152802995,0.7083950617283951
9313,0.9313,12,13,12,603261,2349,102230,5726,0.02175886472266479,0.7091021671826625
9314,0.9314,9,6,9,603267,2343,102239,5717,0.021703286524139463,0.7093052109181142
9315,0.9315,18,6,18,603273,2337,102257,5699,0.021647708325614138,0.7091836734693877
9316,0.9316,10,5,10,603278,2332,102267,5689,0.02160139316017637,0.7092631841416283
9317,0.9317,13,4,13,603282,2328,102280,5676,0.021564341027826152,0.7091454272863568
9318,0.9318,20,7,20,603289,2321,102300,5656,0.02149949979621327,0.709038485646233
9319,0.9319,15,8,15,603297,2313,102315,5641,0.021425395531512837,0.7092029167714358
9320,0.932,17,14,17,603311,2299,102332,5624,0.021295713068287078,0.709832134292566
9321,0.9321,15,5,15,603316,2294,102347,5609,0.02124939790284931,0.7097304820954068
9322,0.9322,9,7,9,603323,2287,102356,5600,0.02118455667123643,0.710029161912007
9323,0.9323,10,5,10,603328,2282,102366,5590,0.02113824150579866,0.7101117886178862
9324,0.9324,19,6,19,603334,2276,102385,5571,0.021082663307273333,0.7099528482222506
9325,0.9325,12,7,12,603341,2269,102397,5559,0.021017822075660456,0.7101430761369443
9326,0.9326,12,10,12,603351,2259,102409,5547,0.020925191744784914,0.7106072252113759
9327,0.9327,15,8,15,603359,2251,102424,5532,0.02085108748008448,0.7107799049209816
9328,0.9328,7,5,7,603364,2246,102431,5525,0.020804772314646707,0.7109767082743533
9329,0.9329,17,9,17,603373,2237,102448,5508,0.02072140501685872,0.7111684958037443
9330,0.933,18,3,18,603376,2234,102466,5490,0.020693615917596057,0.7107716209218021
9331,0.9331,16,6,16,603382,2228,102482,5474,0.02063803771907073,0.7107244871461957
9332,0.9332,15,13,15,603395,2215,102497,5459,0.02051761828893253,0.7113630440448266
9333,0.9333,10,8,10,603403,2207,102507,5449,0.020443514024232095,0.7117293625914316
9334,0.9334,17,12,17,603415,2195,102524,5432,0.020332357627181444,0.7122066343254229
9335,0.9335,17,11,17,603426,2184,102541,5415,0.020230464263218347,0.7125937623371497
9336,0.9336,13,6,13,603432,2178,102554,5402,0.020174886064693025,0.7126649076517151
9337,0.9337,17,10,17,603442,2168,102571,5385,0.020082255733817483,0.7129617370581226
9338,0.9338,16,5,16,603447,2163,102587,5369,0.02003594056837971,0.7128252788104089
9339,0.9339,12,8,12,603455,2155,102599,5357,0.019961836303679276,0.713125665601704
9340,0.934,10,9,10,603464,2146,102609,5347,0.01987846900589129,0.7135993594021086
9341,0.9341,24,10,24,603474,2136,102633,5323,0.019785838675015748,0.7136345354605175
9342,0.9342,15,2,15,603476,2134,102648,5308,0.01976731260884064,0.7132491265788766
9343,0.9343,14,10,14,603486,2124,102662,5294,0.019674682277965098,0.7136694526826638
9344,0.9344,13,11,13,603497,2113,102675,5281,0.019572788914002,0.7142277522315391
9345,0.9345,9,4,9,603501,2109,102684,5272,0.019535736781651783,0.7142663595718737
9346,0.9346,17,7,17,603508,2102,102701,5255,0.019470895550038905,0.7142857142857143
9347,0.9347,23,3,23,603511,2099,102724,5232,0.01944310645077624,0.7136816259719001
9348,0.9348,11,10,11,603521,2089,102735,5221,0.0193504761199007,0.7142270861833105
9349,0.9349,12,6,12,603527,2083,102747,5209,0.019294897921375374,0.7143444871091608
9350,0.935,13,3,13,603530,2080,102760,5196,0.019267108822112713,0.71412864211105
9351,0.9351,11,12,11,603542,2068,102771,5185,0.019155952425062062,0.7148766027850545
9352,0.9352,8,5,8,603547,2063,102779,5177,0.019109637259624293,0.7150552486187846
9353,0.9353,13,10,13,603557,2053,102792,5164,0.01901700692874875,0.7155327698489677
9354,0.9354,11,7,11,603564,2046,102803,5153,0.01895216569713587,0.7157938602583692
9355,0.9355,16,4,16,603568,2042,102819,5137,0.018915113564785653,0.7155592700933278
9356,0.9356,16,8,16,603576,2034,102835,5121,0.01884100930008522,0.7157232704402515
9357,0.9357,10,13,10,603589,2021,102845,5111,0.018720589869947016,0.7166292765002804
9358,0.9358,11,6,11,603595,2015,102856,5100,0.01866501167142169,0.7167955024595924
9359,0.9359,14,11,14,603606,2004,102870,5086,0.018563118307458593,0.7173483779971791
9360,0.936,20,7,20,603613,1997,102890,5066,0.018498277075845716,0.7172589551182217
9361,0.9361,11,9,11,603622,1988,102901,5055,0.018414909778057726,0.7177339202044584
9362,0.9362,13,8,13,603630,1980,102914,5042,0.018340805513357292,0.7180290515522643
9363,0.9363,14,8,14,603638,1972,102928,5028,0.01826670124865686,0.7182857142857143
9364,0.9364,16,8,16,603646,1964,102944,5012,0.018192596983956425,0.7184633027522935
9365,0.9365,16,11,16,603657,1953,102960,4996,0.01809070361999333,0.7189523672470859
9366,0.9366,15,7,15,603664,1946,102975,4981,0.018025862388380453,0.7190703046051682
9367,0.9367,17,5,17,603669,1941,102992,4964,0.01797954722294268,0.7188993482983346
9368,0.9368,8,6,8,603675,1935,103000,4956,0.017923969024417355,0.7191989551589029
9369,0.9369,15,5,15,603680,1930,103015,4941,0.017877653858979586,0.7191092999563382
9370,0.937,8,7,8,603687,1923,103023,4933,0.017812812627366705,0.7195157526254375
9371,0.9371,11,3,11,603690,1920,103034,4922,0.017785023528104044,0.7193802981584332
9372,0.9372,19,6,19,603696,1914,103053,4903,0.01772944532957872,0.7192313334311281
9373,0.9373,13,6,13,603702,1908,103066,4890,0.017673867131053393,0.7193292144748455
9374,0.9374,11,10,11,603712,1898,103077,4879,0.01758123680017785,0.7199350745167479
9375,0.9375,15,9,15,603721,1889,103092,4864,0.01749786950238986,0.7202724714941507
9376,0.9376,8,3,8,603724,1886,103100,4856,0.0174700804031272,0.7202610501334915
9377,0.9377,21,7,21,603731,1879,103121,4835,0.01740523917151432,0.7201370271075365
9378,0.9378,12,6,12,603737,1873,103133,4823,0.017349660972988994,0.7202807646356033
9379,0.9379,22,13,22,603750,1860,103155,4801,0.01722924154285079,0.7207626482510133
9380,0.938,15,3,15,603753,1857,103170,4786,0.017201452443588127,0.7204576245672136
9381,0.9381,12,4,12,603757,1853,103182,4774,0.01716440031123791,0.7203862984759318
9382,0.9382,13,8,13,603765,1845,103195,4761,0.017090296046537477,0.720708446866485
9383,0.9383,13,3,13,603768,1842,103208,4748,0.017062506947274816,0.7204855842185129
9384,0.9384,12,8,12,603776,1834,103220,4736,0.016988402682574382,0.7208523592085236
9385,0.9385,11,9,11,603785,1825,103231,4725,0.016905035384786396,0.7213740458015268
9386,0.9386,10,6,10,603791,1819,103241,4715,0.01684945718626107,0.721610039791858
9387,0.9387,15,11,15,603802,1808,103256,4700,0.016747563822297973,0.7221880762138906
9388,0.9388,12,5,12,603807,1803,103268,4688,0.016701248656860204,0.7222307810814974
9389,0.9389,14,7,14,603814,1796,103282,4674,0.016636407425247322,0.7224111282843895
9390,0.939,14,6,14,603820,1790,103296,4660,0.016580829226721997,0.7224806201550388
9391,0.9391,11,6,11,603826,1784,103307,4649,0.016525251028196672,0.7226799316026737
9392,0.9392,7,7,7,603833,1777,103314,4642,0.016460409796583794,0.7231656021187101
9393,0.9393,17,4,17,603837,1773,103331,4625,0.016423357664233577,0.722882150672085
9394,0.9394,22,9,22,603846,1764,103353,4603,0.016339990366445588,0.7229464425946286
9395,0.9395,19,5,19,603851,1759,103372,4584,0.01629367520100782,0.7226864259813968
9396,0.9396,10,10,10,603861,1749,103382,4574,0.016201044870132277,0.7233907955084612
9397,0.9397,8,10,8,603871,1739,103390,4566,0.016108414539256734,0.7241871530531324
9398,0.9398,12,8,12,603879,1731,103402,4554,0.0160343102745563,0.724582338902148
9399,0.9399,9,7,9,603886,1724,103411,4545,0.01596946904294342,0.7249960121231457
9400,0.94,15,11,15,603897,1713,103426,4530,0.015867575678980325,0.7256126862085536
9401,0.9401,12,13,12,603910,1700,103438,4518,0.015747156248842122,0.7266001929880991
9402,0.9402,15,9,15,603919,1691,103453,4503,0.015663788951054133,0.7269938650306749
9403,0.9403,15,6,15,603925,1685,103468,4488,0.015608210752528807,0.727037097035477
9404,0.9404,6,10,6,603935,1675,103474,4482,0.015515580421653265,0.7279519246386227
9405,0.9405,16,4,16,603939,1671,103490,4466,0.015478528289303049,0.727717125631416
9406,0.9406,13,7,13,603946,1664,103503,4453,0.015413687057690171,0.7279712277260095
9407,0.9407,7,4,7,603950,1660,103510,4446,0.015376634925339954,0.7281362594169669
9408,0.9408,18,8,18,603958,1652,103528,4428,0.01530253066063952,0.7282894736842105
9409,0.9409,15,10,15,603968,1642,103543,4413,0.015209900329763978,0.7288191577208918
9410,0.941,11,5,11,603973,1637,103554,4402,0.015163585164326207,0.7289286305679749
9411,0.9411,12,9,12,603982,1628,103566,4390,0.01508021786653822,0.7294782319707545
9412,0.9412,14,6,14,603988,1622,103580,4376,0.015024639668012894,0.7295765255085028
9413,0.9413,7,5,7,603993,1617,103587,4369,0.014978324502575123,0.7298696959572335
9414,0.9414,10,6,10,603999,1611,103597,4359,0.014922746304049798,0.7301507537688442
9415,0.9415,11,5,11,604004,1606,103608,4348,0.014876431138612027,0.730265367819953
9416,0.9416,18,3,18,604007,1603,103626,4330,0.014848642039349364,0.729816281813585
9417,0.9417,11,5,11,604012,1598,103637,4319,0.014802326873911593,0.7299307081291195
9418,0.9418,12,6,12,604018,1592,103649,4307,0.014746748675386268,0.7301237497880997
9419,0.9419,11,4,11,604022,1588,103660,4296,0.014709696543036051,0.7301155676410604
9420,0.942,14,6,14,604028,1582,103674,4282,0.014654118344510726,0.730218281036835
9421,0.9421,16,5,16,604033,1577,103690,4266,0.014607803179072955,0.7301043984254664
9422,0.9422,17,13,17,604046,1564,103707,4249,0.01448738374893475,0.730947875451574
9423,0.9423,13,8,13,604054,1556,103720,4236,0.014413279484234317,0.731353591160221
9424,0.9424,5,10,5,604064,1546,103725,4231,0.014320649153358777,0.7323870521031677
9425,0.9425,18,11,18,604075,1535,103743,4213,0.01421875578939568,0.7329505915100905
9426,0.9426,14,7,14,604082,1528,103757,4199,0.014153914557782801,0.7331936441417846
9427,0.9427,17,5,17,604087,1523,103774,4182,0.01410759939234503,0.7330411919368974
9428,0.9428,16,3,16,604090,1520,103790,4166,0.014079810293082367,0.7326767499120648
9429,0.9429,16,10,16,604100,1510,103806,4150,0.013987179962206825,0.7332155477031802
9430,0.943,19,5,19,604105,1505,103825,4131,0.013940864796769054,0.7329666430092264
9431,0.9431,15,8,15,604113,1497,103840,4116,0.01386676053206862,0.7332977017637627
9432,0.9432,10,8,10,604121,1489,103850,4106,0.013792656267368187,0.733869526362824
9433,0.9433,16,5,16,604126,1484,103866,4090,0.013746341101930416,0.7337639038392537
9434,0.9434,15,5,15,604131,1479,103881,4075,0.013700025936492645,0.7337054375225063
9435,0.9435,14,4,14,604135,1475,103895,4061,0.013662973804142428,0.7335621387283237
9436,0.9436,15,7,15,604142,1468,103910,4046,0.013598132572529549,0.7337685890460646
9437,0.9437,15,8,15,604150,1460,103925,4031,0.013524028307829115,0.7341103624112184
9438,0.9438,11,7,11,604157,1453,103936,4020,0.013459187076216236,0.7345148912844874
9439,0.9439,13,5,13,604162,1448,103949,4007,0.013412871910778465,0.7345554537121907
9440,0.944,19,5,19,604167,1443,103968,3988,0.013366556745340694,0.7343030749401583
9441,0.9441,12,8,12,604175,1435,103980,3976,0.013292452480640262,0.7347994825355757
9442,0.9442,14,12,14,604187,1423,103994,3962,0.013181296083589611,0.7357474466109564
9443,0.9443,16,10,16,604197,1413,104010,3946,0.01308866575271407,0.7363314051128942
9444,0.9444,12,7,12,604204,1406,104022,3934,0.01302382452110119,0.7367041198501872
9445,0.9445,15,3,15,604207,1403,104037,3919,0.012996035421838527,0.7363773017662533
9446,0.9446,11,3,11,604210,1400,104048,3908,0.012968246322575865,0.7362471740768651
9447,0.9447,9,5,9,604215,1395,104057,3899,0.012921931157138094,0.7364941443143181
9448,0.9448,9,6,9,604221,1389,104066,3890,0.012866352958612768,0.7368819852244743
9449,0.9449,9,6,9,604227,1383,104075,3881,0.012810774760087443,0.7372720364741642
9450,0.945,15,6,15,604233,1377,104090,3866,0.012755196561562118,0.7373641045203128
9451,0.9451,18,5,18,604238,1372,104108,3848,0.012708881396124347,0.7371647509578544
9452,0.9452,20,4,20,604242,1368,104128,3828,0.01267182926377413,0.7367205542725174
9453,0.9453,15,8,15,604250,1360,104143,3813,0.012597724999073696,0.7370964624009279
9454,0.9454,15,1,15,604251,1359,104158,3798,0.012588461965986142,0.7364746945898778
9455,0.9455,10,4,10,604255,1355,104168,3788,0.012551409833635925,0.7365350962473265
9456,0.9456,17,3,17,604258,1352,104185,3771,0.012523620734373263,0.7360921335155183
9457,0.9457,18,9,18,604267,1343,104203,3753,0.012440253436585275,0.7364599686028257
9458,0.9458,14,5,14,604272,1338,104217,3739,0.012393938271147504,0.7364585385069923
9459,0.9459,6,3,6,604275,1335,104223,3733,0.012366149171884841,0.7365824782951855
9460,0.946,14,7,14,604282,1328,104237,3719,0.012301307940271962,0.7368733901327521
9461,0.9461,11,4,11,604286,1324,104248,3708,0.012264255807921745,0.7368839427662957
9462,0.9462,13,4,13,604290,1320,104261,3695,0.01222720367557153,0.7367896311066799
9463,0.9463,14,10,14,604300,1310,104275,3681,0.012134573344695988,0.7375275495892607
9464,0.9464,7,5,7,604305,1305,104282,3674,0.012088258179258217,0.7378991765414742
9465,0.9465,17,5,17,604310,1300,104299,3657,0.012041943013820446,0.7377446035908816
9466,0.9466,19,6,19,604316,1294,104318,3638,0.01198636481529512,0.7376317923763179
9467,0.9467,10,12,10,604328,1282,104328,3628,0.01187520841824447,0.7389002036659877
9468,0.9468,8,9,8,604337,1273,104336,3620,0.011791841120456482,0.7398324136521561
9469,0.9469,13,12,13,604349,1261,104349,3607,0.011680684723405832,0.7409613804437141
9470,0.947,11,5,11,604354,1256,104360,3596,0.011634369557968061,0.7411376751854906
9471,0.9471,8,4,8,604358,1252,104368,3588,0.011597317425617844,0.7413223140495868
9472,0.9472,11,4,11,604362,1248,104379,3577,0.011560265293267627,0.7413471502590674
9473,0.9473,9,6,9,604368,1242,104388,3568,0.011504687094742302,0.7417879417879418
9474,0.9474,10,4,10,604372,1238,104398,3558,0.011467634962392085,0.7418682235195997
9475,0.9475,11,6,11,604378,1232,104409,3547,0.01141205676386676,0.7422054823184767
9476,0.9476,16,5,16,604383,1227,104425,3531,0.011365741598428989,0.7421185372005045
9477,0.9477,17,5,17,604388,1222,104442,3514,0.011319426432991218,0.7419763513513513
9478,0.9478,12,6,12,604394,1216,104454,3502,0.011263848234465893,0.7422636710470538
9479,0.9479,18,7,18,604401,1209,104472,3484,0.011199007002853013,0.7423822714681441
9480,0.948,7,1,7,604402,1208,104479,3477,0.01118974396976546,0.7421558164354323
9481,0.9481,14,7,14,604409,1201,104493,3463,0.011124902738152581,0.7424957118353345
9482,0.9482,14,6,14,604415,1195,104507,3449,0.011069324539627256,0.7426787252368647
9483,0.9483,15,7,15,604422,1188,104522,3434,0.011004483308014377,0.7429684119428819
9484,0.9484,11,3,11,604425,1185,104533,3423,0.010976694208751714,0.7428385416666666
9485,0.9485,19,5,19,604430,1180,104552,3404,0.010930379043313943,0.7425828970331588
9486,0.9486,12,7,12,604437,1173,104564,3392,0.010865537811701064,0.7430449069003285
9487,0.9487,9,8,9,604445,1165,104573,3383,0.01079143354700063,0.7438434476693052
9488,0.9488,9,4,9,604449,1161,104582,3374,0.010754381414650413,0.7439911797133407
9489,0.9489,15,11,15,604460,1150,104597,3359,0.010652488050687317,0.744954535373697
9490,0.949,15,6,15,604466,1144,104612,3344,0.010596909852161992,0.7450980392156863
9491,0.9491,12,5,12,604471,1139,104624,3332,0.01055059468672422,0.7452471482889734
9492,0.9492,15,4,15,604475,1135,104639,3317,0.010513542554374004,0.745058400718778
9493,0.9493,6,3,6,604478,1132,104645,3311,0.010485753455111341,0.7452171955885663
9494,0.9494,16,5,16,604483,1127,104661,3295,0.01043943828967357,0.7451379466304839
9495,0.9495,15,5,15,604488,1122,104676,3280,0.0103931231242358,0.745115856428896
9496,0.9496,12,5,12,604493,1117,104688,3268,0.010346807958798028,0.7452679589509692
9497,0.9497,13,2,13,604495,1115,104701,3255,0.01032828189262292,0.7448512585812357
9498,0.9498,12,5,12,604500,1110,104713,3243,0.010281966727185149,0.7450034458993797
9499,0.9499,9,2,9,604502,1108,104722,3234,0.01026344066101004,0.7448180561953017
9500,0.95,14,7,14,604509,1101,104736,3220,0.010198599429397161,0.7451978708632261
9501,0.9501,18,2,18,604511,1099,104754,3202,0.010180073363222053,0.7444780283654964
9502,0.9502,10,3,10,604514,1096,104764,3192,0.01015228426395939,0.7444029850746269
9503,0.9503,13,7,13,604521,1089,104777,3179,0.010087443032346512,0.7448453608247423
9504,0.9504,15,4,15,604525,1085,104792,3164,0.010050390899996296,0.7446457990115322
9505,0.9505,15,10,15,604535,1075,104807,3149,0.009957760569120754,0.7455018939393939
9506,0.9506,2,3,2,604538,1072,104809,3147,0.009929971469858091,0.7459113534012799
9507,0.9507,23,6,23,604544,1066,104832,3124,0.009874393271332766,0.7455847255369928
9508,0.9508,11,4,11,604548,1062,104843,3113,0.009837341138982549,0.74562874251497
9509,0.9509,15,7,15,604555,1055,104858,3098,0.00977249990736967,0.7459667710089092
9510,0.951,4,6,4,604561,1049,104862,3094,0.009716921708844344,0.7468018344195028
9511,0.9511,8,5,8,604566,1044,104870,3086,0.009670606543406573,0.7472154963680387
9512,0.9512,19,7,19,604573,1037,104889,3067,0.009605765311793694,0.7473196881091618
9513,0.9513,12,4,12,604577,1033,104901,3055,0.009568713179443477,0.7473091976516634
9514,0.9514,8,2,8,604579,1031,104909,3047,0.009550187113268369,0.7471799901912702
9515,0.9515,12,6,12,604585,1025,104921,3035,0.009494608914743043,0.7475369458128078
9516,0.9516,10,7,10,604592,1018,104931,3025,0.009429767683130164,0.7482067771456838
9517,0.9517,6,6,6,604598,1012,104937,3019,0.009374189484604839,0.7489456710493674
9518,0.9518,9,4,9,604602,1008,104946,3010,0.009337137352254622,0.7491289198606271
9519,0.9519,17,9,17,604611,999,104963,2993,0.009253770054466634,0.749749498997996
9520,0.952,11,4,11,604615,995,104974,2982,0.009216717922116417,0.7498114156399296
9521,0.9521,11,4,11,604619,991,104985,2971,0.0091796657897662,0.7498738011105502
9522,0.9522,13,4,13,604623,987,104998,2958,0.009142613657415984,0.749809885931559
9523,0.9523,8,8,8,604631,979,105006,2950,0.00906850939271555,0.750827182489183
9524,0.9524,13,8,13,604639,971,105019,2937,0.008994405128015118,0.7515353121801432
9525,0.9525,11,5,11,604644,966,105030,2926,0.008948089962577347,0.7517985611510791
9526,0.9526,14,4,14,604648,962,105044,2912,0.00891103783022713,0.7516778523489933
9527,0.9527,13,3,13,604651,959,105057,2899,0.008883248730964468,0.7514256091238984
9528,0.9528,13,5,13,604656,954,105070,2886,0.008836933565526697,0.7515625
9529,0.9529,15,5,15,604661,949,105085,2871,0.008790618400088926,0.7515706806282723
9530,0.953,14,5,14,604666,944,105099,2857,0.008744303234651155,0.751644304130492
9531,0.9531,18,2,18,604668,942,105117,2839,0.008725777168476046,0.7508595609627082
9532,0.9532,14,9,14,604677,933,105131,2825,0.008642409870688058,0.7517296434273549
9533,0.9533,13,8,13,604685,925,105144,2812,0.008568305605987625,0.7524752475247525
9534,0.9534,11,8,11,604693,917,105155,2801,0.008494201341287191,0.7533620225927918
9535,0.9535,19,7,19,604700,910,105174,2782,0.008429360109674312,0.7535211267605634
9536,0.9536,13,4,13,604704,906,105187,2769,0.008392307977324095,0.7534693877551021
9537,0.9537,9,6,9,604710,900,105196,2760,0.00833672977879877,0.7540983606557377
9538,0.9538,6,4,6,604714,896,105202,2754,0.008299677646448553,0.7545205479452055
9539,0.9539,15,7,15,604721,889,105217,2739,0.008234836414835673,0.7549614112458655
9540,0.954,13,8,13,604729,881,105230,2726,0.00816073215013524,0.7557527030773497
9541,0.9541,23,3,23,604732,878,105253,2703,0.008132943050872577,0.7548170901982686
9542,0.9542,9,7,9,604739,871,105262,2694,0.008068101819259698,0.755680224403927
9543,0.9543,14,1,14,604740,870,105276,2680,0.008058838786172143,0.7549295774647887
9544,0.9544,13,5,13,604745,865,105289,2667,0.008012523620734372,0.7550962627406569
9545,0.9545,14,8,14,604753,857,105303,2653,0.00793841935603394,0.7558404558404559
9546,0.9546,13,5,13,604758,852,105316,2640,0.00789210419059617,0.7560137457044673
9547,0.9547,14,7,14,604765,845,105330,2626,0.00782726295898329,0.7565543071161048
9548,0.9548,11,5,11,604770,840,105341,2615,0.007780947793545518,0.7568740955137482
9549,0.9549,12,0,12,604770,840,105353,2603,0.007780947793545518,0.7560267208829509
9550,0.955,15,5,15,604775,835,105368,2588,0.007734632628107747,0.7560619339760444
9551,0.9551,9,4,9,604779,831,105377,2579,0.007697580495757531,0.7563049853372434
9552,0.9552,10,3,10,604782,828,105387,2569,0.007669791396494869,0.7562555195760966
9553,0.9553,17,5,17,604787,823,105404,2552,0.007623476231057098,0.7561481481481481
9554,0.9554,16,7,16,604794,816,105420,2536,0.007558634999444218,0.7565632458233891
9555,0.9555,10,5,10,604799,811,105430,2526,0.007512319834006447,0.7569673359304765
9556,0.9556,14,3,14,604802,808,105444,2512,0.0074845307347437846,0.7566265060240964
9557,0.9557,10,7,10,604809,801,105454,2502,0.007419689503130905,0.7574931880108992
9558,0.9558,16,5,16,604814,796,105470,2486,0.007373374337693134,0.7574649603900061
9559,0.9559,14,3,14,604817,793,105484,2472,0.0073455852384304715,0.7571209800918837
9560,0.956,11,7,11,604824,786,105495,2461,0.007280744006817592,0.7579303972898059
9561,0.9561,11,7,11,604831,779,105506,2450,0.007215902775204713,0.7587488386497367
9562,0.9562,15,6,15,604837,773,105521,2435,0.007160324576679388,0.7590399002493765
9563,0.9563,11,3,11,604840,770,105532,2424,0.007132535477416726,0.7589229805886036
9564,0.9564,19,4,19,604844,766,105551,2405,0.007095483345066509,0.7584358246609902
9565,0.9565,23,5,23,604849,761,105574,2382,0.007049168179628738,0.7578746420617245
9566,0.9566,12,3,12,604852,758,105586,2370,0.007021379080366075,0.7576726342710998
9567,0.9567,20,1,20,604853,757,105606,2350,0.007012116047278521,0.7563566140971999
9568,0.9568,10,6,10,604859,751,105616,2340,0.006956537848753196,0.7570365577483015
9569,0.9569,7,4,7,604863,747,105623,2333,0.006919485716402979,0.7574675324675325
9570,0.957,11,4,11,604867,743,105634,2322,0.006882433584052762,0.7575856443719413
9571,0.9571,11,6,11,604873,737,105645,2311,0.006826855385527437,0.7582020997375328
9572,0.9572,8,9,8,604882,728,105653,2303,0.006743488087739449,0.7598152424942263
9573,0.9573,10,8,10,604890,720,105663,2293,0.0066693838230390155,0.7610355127779621
9574,0.9574,13,7,13,604897,713,105676,2280,0.006604542591426137,0.7617774807885065
9575,0.9575,11,6,11,604903,707,105687,2269,0.006548964392900812,0.7624327956989247
9576,0.9576,13,2,13,604905,705,105700,2256,0.006530438326725703,0.7619047619047619
9577,0.9577,16,2,16,604907,703,105716,2240,0.006511912260550595,0.7611281005776419
9578,0.9578,11,8,11,604915,695,105727,2229,0.006437807995850161,0.762311901504788
9579,0.9579,8,4,8,604919,691,105735,2221,0.0064007558634999445,0.7627060439560439
9580,0.958,10,4,10,604923,687,105745,2211,0.006363703731149728,0.7629399585921325
9581,0.9581,12,1,12,604924,686,105757,2199,0.006354440698062173,0.7622183708838821
9582,0.9582,8,9,8,604933,677,105765,2191,0.006271073400274186,0.7639470013947002
9583,0.9583,12,4,12,604937,673,105777,2179,0.006234021267923969,0.7640252454417953
9584,0.9584,7,3,7,604940,670,105784,2172,0.006206232168661306,0.7642505277973258
9585,0.9585,7,5,7,604945,665,105791,2165,0.006159917003223535,0.765017667844523
9586,0.9586,10,7,10,604952,658,105801,2155,0.006095075771610657,0.7660860291503733
9587,0.9587,11,3,11,604955,655,105812,2144,0.006067286672347994,0.765987852804573
9588,0.9588,9,4,9,604959,651,105821,2135,0.006030234539997777,0.7663316582914573
9589,0.9589,8,8,8,604967,643,105829,2127,0.0059561302752973435,0.7678700361010831
9590,0.959,10,6,10,604973,637,105839,2117,0.005900552076772018,0.7687000726216412
9591,0.9591,12,8,12,604981,629,105851,2105,0.005826447812071585,0.7699341623994148
9592,0.9592,13,6,13,604987,623,105864,2092,0.0057708696135462595,0.7705340699815838
9593,0.9593,8,7,8,604994,616,105872,2084,0.00570602838193338,0.7718518518518519
9594,0.9594,13,2,13,604996,614,105885,2071,0.005687502315758272,0.7713221601489758
9595,0.9595,17,3,17,604999,611,105902,2054,0.005659713216495609,0.7707317073170732
9596,0.9596,14,2,14,605001,609,105916,2040,0.005641187150320501,0.7701019252548131
9597,0.9597,13,3,13,605004,606,105929,2027,0.005613398051057838,0.7698442840865932
9598,0.9598,5,8,5,605012,598,105934,2022,0.005539293786357405,0.7717557251908397
9599,0.9599,8,4,8,605016,594,105942,2014,0.005502241654007188,0.772239263803681
9600,0.96,19,5,19,605021,589,105961,1995,0.005455926488569417,0.7720588235294118
9601,0.9601,5,1,5,605022,588,105966,1990,0.005446663455481863,0.7719162141194724
9602,0.9602,15,3,15,605025,585,105981,1975,0.005418874356219201,0.771484375
9603,0.9603,16,5,16,605030,580,105997,1959,0.0053725591907814296,0.7715636077195747
9604,0.9604,12,2,12,605032,578,106009,1947,0.005354033124606321,0.7710891089108911
9605,0.9605,7,3,7,605035,575,106016,1940,0.0053262440253436585,0.7713717693836978
9606,0.9606,14,5,14,605040,570,106030,1926,0.0052799288599058875,0.7716346153846154
9607,0.9607,11,5,11,605045,565,106041,1915,0.0052336136944681165,0.7721774193548387
9608,0.9608,12,7,12,605052,558,106053,1903,0.005168772462855237,0.7732629012596506
9609,0.9609,10,3,10,605055,555,106063,1893,0.0051409833635925745,0.7732843137254902
9610,0.961,19,4,19,605059,551,106082,1874,0.005103931231242358,0.7727835051546392
9611,0.9611,11,2,11,605061,549,106093,1863,0.005085405165067249,0.7723880597014925
9612,0.9612,10,3,10,605064,546,106103,1853,0.005057616065804587,0.7724051688203418
9613,0.9613,9,1,9,605065,545,106112,1844,0.005048353032717033,0.771871075763918
9614,0.9614,8,4,8,605069,541,106120,1836,0.0050113009003668165,0.7724021876314683
9615,0.9615,12,3,12,605072,538,106132,1824,0.004983511801104154,0.7722269263336156
9616,0.9616,19,3,19,605075,535,106151,1805,0.004955722701841491,0.7713675213675214
9617,0.9617,10,5,10,605080,530,106161,1795,0.00490940753640372,0.7720430107526882
9618,0.9618,14,6,14,605086,524,106175,1781,0.004853829337878395,0.7726681127982646
9619,0.9619,14,2,14,605088,522,106189,1767,0.004835303271703287,0.7719528178243774
9620,0.962,12,3,12,605091,519,106201,1755,0.004807514172440624,0.7717678100263852
9621,0.9621,17,5,17,605096,514,106218,1738,0.004761199007002853,0.7717584369449378
9622,0.9622,7,6,7,605102,508,106225,1731,0.004705620808477528,0.7731129968736042
9623,0.9623,12,1,12,605103,507,106237,1719,0.0046963577753899735,0.7722371967654986
9624,0.9624,10,4,10,605107,503,106247,1709,0.004659305643039757,0.7726039783001808
9625,0.9625,9,6,9,605113,497,106256,1700,0.0046037274445144315,0.7737824305871643
9626,0.9626,11,3,11,605116,494,106267,1689,0.004575938345251769,0.7737059092991296
9627,0.9627,13,1,13,605117,493,106280,1676,0.004566675312164215,0.772706316274781
9628,0.9628,9,3,9,605120,490,106289,1667,0.004538886212901552,0.7728326379230412
9629,0.9629,11,5,11,605125,485,106300,1656,0.004492571047463782,0.7734703409621672
9630,0.963,13,6,13,605131,479,106313,1643,0.004436992848938457,0.7742695570216777
9631,0.9631,9,2,9,605133,477,106322,1634,0.004418466782763348,0.7740407389862625
9632,0.9632,11,3,11,605136,474,106333,1623,0.004390677683500686,0.7739628040057225
9633,0.9633,16,1,16,605137,473,106349,1607,0.0043814146504131315,0.7725961538461539
9634,0.9634,6,3,6,605140,470,106355,1601,0.004353625551150469,0.773056494447127
9635,0.9635,15,5,15,605145,465,106370,1586,0.004307310385712698,0.7732813261823501
9636,0.9636,12,5,12,605150,460,106382,1574,0.004260995220274927,0.7738446411012783
9637,0.9637,6,1,6,605151,459,106388,1568,0.004251732187187373,0.7735569807597434
9638,0.9638,15,1,15,605152,458,106403,1553,0.004242469154099818,0.7722526106414719
9639,0.9639,9,0,9,605152,458,106412,1544,0.004242469154099818,0.7712287712287712
9640,0.964,11,2,11,605154,456,106423,1533,0.00422394308792471,0.770739064856712
9641,0.9641,11,1,11,605155,455,106434,1522,0.004214680054837156,0.7698533131006575
9642,0.9642,8,4,8,605159,451,106442,1514,0.004177627922486939,0.7704834605597964
9643,0.9643,17,6,17,605165,445,106459,1497,0.004122049723961614,0.770854788877446
9644,0.9644,11,2,11,605167,443,106470,1486,0.004103523657786505,0.7703473302229135
9645,0.9645,18,10,18,605177,433,106488,1468,0.004010893326910963,0.7722251446607049
9646,0.9646,9,7,9,605184,426,106497,1459,0.003946052095298085,0.7740053050397878
9647,0.9647,10,6,10,605190,420,106507,1449,0.003890473896772759,0.7752808988764045
9648,0.9648,7,3,7,605193,417,106514,1442,0.0038626847975100965,0.7756858526089295
9649,0.9649,8,3,8,605196,414,106522,1434,0.0038348956982474343,0.775974025974026
9650,0.965,8,5,8,605201,409,106530,1426,0.0037885805328096633,0.7771117166212534
9651,0.9651,12,5,12,605206,404,106542,1414,0.0037422653673718923,0.7777777777777778
9652,0.9652,12,5,12,605211,399,106554,1402,0.0036959502019341213,0.7784564131038312
9653,0.9653,10,5,10,605216,394,106564,1392,0.0036496350364963502,0.7793952967525196
9654,0.9654,12,2,12,605218,392,106576,1380,0.003631108970321242,0.7787810383747178
9655,0.9655,8,5,8,605223,387,106584,1372,0.0035847938048834713,0.7799886299033542
9656,0.9656,9,2,9,605225,385,106593,1363,0.003566267738708363,0.7797482837528604
9657,0.9657,8,2,8,605227,383,106601,1355,0.0035477416725332544,0.7796317606444189
9658,0.9658,5,3,5,605230,380,106606,1350,0.003519952573270592,0.7803468208092486
9659,0.9659,11,1,11,605231,379,106617,1339,0.0035106895401830376,0.7793946449359721
9660,0.966,13,1,13,605232,378,106630,1326,0.0035014265070954834,0.778169014084507
9661,0.9661,8,6,8,605238,372,106638,1318,0.003445848308570158,0.7798816568047338
9662,0.9662,10,6,10,605244,366,106648,1308,0.003390270110044833,0.7813620071684588
9663,0.9663,9,4,9,605248,362,106657,1299,0.003353217977694616,0.7820590006020469
9664,0.9664,7,4,7,605252,358,106664,1292,0.0033161658453443998,0.7830303030303031
9665,0.9665,13,4,13,605256,354,106677,1279,0.003279113712994183,0.7832210655235763
9666,0.9666,12,1,12,605257,353,106689,1267,0.0032698506799066288,0.7820987654320988
9667,0.9667,13,6,13,605263,347,106702,1254,0.0032142724813813035,0.783260462211118
9668,0.9668,15,1,15,605264,346,106717,1239,0.0032050094482937493,0.7817034700315457
9669,0.9669,9,5,9,605269,341,106726,1230,0.0031586942828559783,0.7829408020369192
9670,0.967,9,7,9,605276,334,106735,1221,0.003093853051243099,0.7852090032154341
9671,0.9671,14,4,14,605280,330,106749,1207,0.0030568009188928825,0.7852960312296682
9672,0.9672,2,2,2,605282,328,106751,1205,0.003038274852717774,0.7860404435746902
9673,0.9673,13,4,13,605286,324,106764,1192,0.0030012227203675573,0.7862796833773087
9674,0.9674,8,3,8,605289,321,106772,1184,0.0029734336211048947,0.7867109634551495
9675,0.9675,4,2,4,605291,319,106776,1180,0.0029549075549297863,0.7871914609739826
9676,0.9676,11,4,11,605295,315,106787,1169,0.0029178554225795694,0.7877358490566038
9677,0.9677,10,5,10,605300,310,106797,1159,0.0028715402571417984,0.7889720898570456
9678,0.9678,8,3,8,605303,307,106805,1151,0.002843751157879136,0.789437585733882
9679,0.9679,12,2,12,605305,305,106817,1139,0.0028252250917040274,0.788781163434903
9680,0.968,11,2,11,605307,303,106828,1128,0.002806699025528919,0.7882599580712788
9681,0.9681,10,5,10,605312,298,106838,1118,0.0027603838600911484,0.78954802259887
9682,0.9682,11,1,11,605313,297,106849,1107,0.002751120827003594,0.7884615384615384
9683,0.9683,6,4,6,605317,293,106855,1101,0.0027140686946533774,0.7898134863701578
9684,0.9684,13,1,13,605318,292,106868,1088,0.002704805661565823,0.7884057971014493
9685,0.9685,9,3,9,605321,289,106877,1079,0.0026770165623031606,0.7887426900584795
9686,0.9686,6,4,6,605325,285,106883,1073,0.0026399644299529438,0.7901325478645066
9687,0.9687,7,1,7,605326,284,106890,1066,0.0026307013968653896,0.7896296296296297
9688,0.9688,7,6,7,605332,278,106897,1059,0.0025751231983400643,0.7920718025430067
9689,0.9689,10,8,10,605340,270,106907,1049,0.002501018933639631,0.7952994692949203
9690,0.969,19,3,19,605343,267,106926,1030,0.0024732298343769685,0.7941403238242097
9691,0.9691,13,4,13,605347,263,106939,1017,0.0024361777020267517,0.79453125
9692,0.9692,8,2,8,605349,261,106947,1009,0.0024176516358516433,0.794488188976378
9693,0.9693,6,2,6,605351,259,106953,1003,0.002399125569676535,0.794770206022187
9694,0.9694,8,0,8,605351,259,106961,995,0.002399125569676535,0.7934609250398724
9695,0.9695,9,6,9,605357,253,106970,986,0.0023435473711512097,0.7958030669895076
9696,0.9696,8,1,8,605358,252,106978,978,0.0023342843380636555,0.7951219512195122
9697,0.9697,7,5,7,605363,247,106985,971,0.0022879691726258844,0.7972085385878489
9698,0.9698,5,5,5,605368,242,106990,966,0.002241654007188114,0.7996688741721855
9699,0.9699,8,2,8,605370,240,106998,958,0.0022231279410130055,0.7996661101836394
9700,0.97,9,1,9,605371,239,107007,949,0.0022138649079254513,0.7988215488215489
9701,0.9701,6,4,6,605375,235,107013,943,0.0021768127755752344,0.8005093378607809
9702,0.9702,12,5,12,605380,230,107025,931,0.0021304976101374634,0.801894918173988
9703,0.9703,6,3,6,605383,227,107031,925,0.002102708510874801,0.8029513888888888
9704,0.9704,12,1,12,605384,226,107043,913,0.0020934454777872466,0.8015803336259877
9705,0.9705,11,4,11,605388,222,107054,902,0.00205639334543703,0.802491103202847
9706,0.9706,9,3,9,605391,219,107063,893,0.002028604246174367,0.8030575539568345
9707,0.9707,12,7,12,605398,212,107075,881,0.001963763014561488,0.8060384263494969
9708,0.9708,9,5,9,605403,207,107084,872,0.0019174478491237172,0.8081556997219648
9709,0.9709,12,4,12,605407,203,107096,860,0.0018803957167735003,0.8090310442144873
9710,0.971,13,1,13,605408,202,107109,847,0.0018711326836859461,0.8074356530028599
9711,0.9711,8,1,8,605409,201,107117,839,0.001861869650598392,0.8067307692307693
9712,0.9712,8,2,8,605411,199,107125,831,0.0018433435844232835,0.8067961165048544
9713,0.9713,5,4,5,605415,195,107130,826,0.0018062914520730667,0.8090107737512243
9714,0.9714,8,1,8,605416,194,107138,818,0.0017970284189855125,0.808300395256917
9715,0.9715,13,4,13,605420,190,107151,805,0.001759976286635296,0.8090452261306532
9716,0.9716,15,1,15,605421,189,107166,790,0.0017507132535477417,0.8069458631256384
9717,0.9717,13,1,13,605422,188,107179,777,0.0017414502204601875,0.805181347150259
9718,0.9718,9,1,9,605423,187,107188,768,0.0017321871873726333,0.8041884816753927
9719,0.9719,11,2,11,605425,185,107199,757,0.001713661121197525,0.8036093418259024
9720,0.972,10,5,10,605430,180,107209,747,0.0016673459557597539,0.8058252427184466
9721,0.9721,11,4,11,605434,176,107220,736,0.0016302938234095373,0.8070175438596491
9722,0.9722,11,3,11,605437,173,107231,725,0.0016025047241468747,0.8073496659242761
9723,0.9723,9,2,9,605439,171,107240,716,0.0015839786579717663,0.8072153325817362
9724,0.9724,6,4,6,605443,167,107246,710,0.0015469265256215494,0.8095781071835804
9725,0.9725,4,1,4,605444,166,107250,706,0.0015376634925339952,0.8096330275229358
9726,0.9726,7,10,7,605454,156,107257,699,0.0014450331616584534,0.8175438596491228
9727,0.9727,14,0,14,605454,156,107271,685,0.0014450331616584534,0.8145065398335315
9728,0.9728,4,0,4,605454,156,107275,681,0.0014450331616584534,0.8136200716845878
9729,0.9729,8,6,8,605460,150,107283,673,0.0013894549631331284,0.8177399756986634
9730,0.973,9,1,9,605461,149,107292,664,0.0013801919300455742,0.8167281672816729
9731,0.9731,5,2,5,605463,147,107297,659,0.0013616658638704658,0.8176178660049628
9732,0.9732,7,3,7,605466,144,107304,652,0.0013338767646078032,0.8190954773869347
9733,0.9733,8,0,8,605466,144,107312,644,0.0013338767646078032,0.817258883248731
9734,0.9734,2,1,2,605467,143,107314,642,0.001324613731520249,0.8178343949044586
9735,0.9735,7,1,7,605468,142,107321,635,0.0013153506984326948,0.8172458172458172
9736,0.9736,13,3,13,605471,139,107334,622,0.0012875615991700322,0.8173455978975033
9737,0.9737,9,2,9,605473,137,107343,613,0.0012690355329949238,0.8173333333333334
9738,0.9738,9,1,9,605474,136,107352,604,0.0012597724999073698,0.8162162162162162
9739,0.9739,5,4,5,605478,132,107357,599,0.001222720367557153,0.8194254445964432
9740,0.974,5,0,5,605478,132,107362,594,0.001222720367557153,0.8181818181818182
9741,0.9741,3,1,3,605479,131,107365,591,0.0012134573344695988,0.8185595567867036
9742,0.9742,12,0,12,605479,131,107377,579,0.0012134573344695988,0.8154929577464789
9743,0.9743,12,0,12,605479,131,107389,567,0.0012134573344695988,0.8123209169054442
9744,0.9744,14,2,14,605481,129,107403,553,0.0011949312682944903,0.8108504398826979
9745,0.9745,7,6,7,605487,123,107410,546,0.0011393530697691651,0.8161434977578476
9746,0.9746,11,4,11,605491,119,107421,535,0.0011023009374189485,0.8180428134556575
9747,0.9747,6,1,6,605492,118,107427,529,0.0010930379043313943,0.8176197836166924
9748,0.9748,12,2,12,605494,116,107439,517,0.001074511838156286,0.8167456556082149
9749,0.9749,12,3,12,605497,113,107451,505,0.0010467227388936233,0.8171521035598706
9750,0.975,8,1,8,605498,112,107459,497,0.001037459705806069,0.8160919540229885
9751,0.9751,5,1,5,605499,111,107464,492,0.001028196672718515,0.8159203980099502
9752,0.9752,9,1,9,605500,110,107473,483,0.0010189336396309607,0.8145025295109612
9753,0.9753,10,5,10,605505,105,107483,473,0.0009726184741931898,0.8183391003460208
9754,0.9754,2,1,2,605506,104,107485,471,0.0009633554411056357,0.8191304347826087
9755,0.9755,7,0,7,605506,104,107492,464,0.0009633554411056357,0.8169014084507042
9756,0.9756,5,0,5,605506,104,107497,459,0.0009633554411056357,0.8152753108348135
9757,0.9757,8,0,8,605506,104,107505,451,0.0009633554411056357,0.8126126126126126
9758,0.9758,5,3,5,605509,101,107510,446,0.0009355663418429731,0.8153564899451554
9759,0.9759,5,4,5,605513,97,107515,441,0.0008985142094927563,0.8197026022304833
9760,0.976,6,0,6,605513,97,107521,435,0.0008985142094927563,0.8176691729323309
9761,0.9761,5,2,5,605515,95,107526,430,0.000879988143317648,0.819047619047619
9762,0.9762,2,3,2,605518,92,107528,428,0.0008521990440549853,0.823076923076923
9763,0.9763,2,2,2,605520,90,107530,426,0.0008336729778798769,0.8255813953488372
9764,0.9764,8,0,8,605520,90,107538,418,0.0008336729778798769,0.8228346456692913
9765,0.9765,4,0,4,605520,90,107542,414,0.0008336729778798769,0.8214285714285714
9766,0.9766,5,3,5,605523,87,107547,409,0.0008058838786172144,0.8245967741935484
9767,0.9767,9,2,9,605525,85,107556,400,0.000787357812442106,0.8247422680412371
9768,0.9768,3,1,3,605526,84,107559,397,0.0007780947793545518,0.8253638253638254
9769,0.9769,8,1,8,605527,83,107567,389,0.0007688317462669976,0.8241525423728814
9770,0.977,8,2,8,605529,81,107575,381,0.0007503056800918893,0.8246753246753247
9771,0.9771,4,1,4,605530,80,107579,377,0.0007410426470043351,0.824945295404814
9772,0.9772,1,2,1,605532,78,107580,376,0.0007225165808292267,0.8281938325991189
9773,0.9773,4,2,4,605534,76,107584,372,0.0007039905146541183,0.8303571428571429
9774,0.9774,6,1,6,605535,75,107590,366,0.0006947274815665642,0.8299319727891157
9775,0.9775,10,0,10,605535,75,107600,356,0.0006947274815665642,0.8259860788863109
9776,0.9776,5,1,5,605536,74,107605,351,0.00068546444847901,0.8258823529411765
9777,0.9777,5,1,5,605537,73,107610,346,0.0006762014153914558,0.8257756563245824
9778,0.9778,3,3,3,605540,70,107613,343,0.0006484123161287932,0.8305084745762712
9779,0.9779,7,1,7,605541,69,107620,336,0.000639149283041239,0.8296296296296296
9780,0.978,3,0,3,605541,69,107623,333,0.000639149283041239,0.8283582089552238
9781,0.9781,4,3,4,605544,66,107627,329,0.0006113601837785765,0.8329113924050633
9782,0.9782,2,0,2,605544,66,107629,327,0.0006113601837785765,0.8320610687022901
9783,0.9783,3,1,3,605545,65,107632,324,0.0006020971506910223,0.8329048843187661
9784,0.9784,4,2,4,605547,63,107636,320,0.0005835710845159139,0.835509138381201
9785,0.9785,6,2,6,605549,61,107642,314,0.0005650450183408056,0.8373333333333334
9786,0.9786,5,1,5,605550,60,107647,309,0.0005557819852532514,0.8373983739837398
9787,0.9787,8,2,8,605552,58,107655,301,0.000537255919078143,0.8384401114206128
9788,0.9788,4,2,4,605554,56,107659,297,0.0005187298529030345,0.8413597733711048
9789,0.9789,2,0,2,605554,56,107661,295,0.0005187298529030345,0.8404558404558404
9790,0.979,3,0,3,605554,56,107664,292,0.0005187298529030345,0.8390804597701149
9791,0.9791,6,1,6,605555,55,107670,286,0.0005094668198154803,0.8387096774193549
9792,0.9792,3,0,3,605555,55,107673,283,0.0005094668198154803,0.8372781065088757
9793,0.9793,9,0,9,605555,55,107682,274,0.0005094668198154803,0.8328267477203647
9794,0.9794,10,1,10,605556,54,107692,264,0.0005002037867279261,0.8301886792452831
9795,0.9795,1,3,1,605559,51,107693,263,0.00047241468746526364,0.8375796178343949
9796,0.9796,3,1,3,605560,50,107696,260,0.00046315165437770943,0.8387096774193549
9797,0.9797,2,0,2,605560,50,107698,258,0.00046315165437770943,0.8376623376623377
9798,0.9798,5,0,5,605560,50,107703,253,0.00046315165437770943,0.834983498349835
9799,0.9799,4,0,4,605560,50,107707,249,0.00046315165437770943,0.8327759197324415
9800,0.98,2,0,2,605560,50,107709,247,0.00046315165437770943,0.8316498316498316
9801,0.9801,4,0,4,605560,50,107713,243,0.00046315165437770943,0.8293515358361775
9802,0.9802,4,0,4,605560,50,107717,239,0.00046315165437770943,0.8269896193771626
9803,0.9803,3,2,3,605562,48,107720,236,0.0004446255882026011,0.8309859154929577
9804,0.9804,7,0,7,605562,48,107727,229,0.0004446255882026011,0.8267148014440433
9805,0.9805,5,0,5,605562,48,107732,224,0.0004446255882026011,0.8235294117647058
9806,0.9806,1,1,1,605563,47,107733,223,0.0004353625551150469,0.825925925925926
9807,0.9807,4,3,4,605566,44,107737,219,0.0004075734558523843,0.8326996197718631
9808,0.9808,5,0,5,605566,44,107742,214,0.0004075734558523843,0.8294573643410853
9809,0.9809,4,1,4,605567,43,107746,210,0.0003983104227648301,0.8300395256916996
9810,0.981,9,0,9,605567,43,107755,201,0.0003983104227648301,0.8237704918032787
9811,0.9811,5,0,5,605567,43,107760,196,0.0003983104227648301,0.8200836820083682
9812,0.9813,3,2,3,605569,41,107763,193,0.00037978435658972176,0.8247863247863247
9813,0.9814,5,0,5,605569,41,107768,188,0.00037978435658972176,0.8209606986899564
9814,0.9815,4,0,4,605569,41,107772,184,0.00037978435658972176,0.8177777777777778
9815,0.9816,4,1,4,605570,40,107776,180,0.00037052132350216756,0.8181818181818182
9816,0.9817,8,0,8,605570,40,107784,172,0.00037052132350216756,0.8113207547169812
9817,0.9818,4,1,4,605571,39,107788,168,0.00036125829041461335,0.8115942028985508
9818,0.9819,3,0,3,605571,39,107791,165,0.00036125829041461335,0.8088235294117647
9819,0.982,4,0,4,605571,39,107795,161,0.00036125829041461335,0.805
9820,0.9821,3,0,3,605571,39,107798,158,0.00036125829041461335,0.8020304568527918
9821,0.9822,5,1,5,605572,38,107803,153,0.00035199525732705915,0.8010471204188482
9822,0.9823,3,2,3,605574,36,107806,150,0.0003334691911519508,0.8064516129032258
9823,0.9824,4,2,4,605576,34,107810,146,0.00031494312497684244,0.8111111111111111
9824,0.9825,6,0,6,605576,34,107816,140,0.00031494312497684244,0.8045977011494253
9825,0.9826,1,0,1,605576,34,107817,139,0.00031494312497684244,0.8034682080924855
9826,0.9827,4,3,4,605579,31,107821,135,0.00028715402571417983,0.8132530120481928
9827,0.9828,1,0,1,605579,31,107822,134,0.00028715402571417983,0.8121212121212121
9828,0.9829,2,1,2,605580,30,107824,132,0.0002778909926266257,0.8148148148148148
9829,0.983,4,0,4,605580,30,107828,128,0.0002778909926266257,0.810126582278481
9830,0.9831,2,0,2,605580,30,107830,126,0.0002778909926266257,0.8076923076923077
9831,0.9832,5,2,5,605582,28,107835,121,0.0002593649264515173,0.8120805369127517
9832,0.9833,2,1,2,605583,27,107837,119,0.00025010189336396307,0.815068493150685
9833,0.9834,5,1,5,605584,26,107842,114,0.00024083886027640892,0.8142857142857143
9834,0.9835,3,0,3,605584,26,107845,111,0.00024083886027640892,0.8102189781021898
9835,0.9836,1,0,1,605584,26,107846,110,0.00024083886027640892,0.8088235294117647
9836,0.9837,3,0,3,605584,26,107849,107,0.00024083886027640892,0.8045112781954887
9837,0.9838,1,0,1,605584,26,107850,106,0.00024083886027640892,0.803030303030303
9838,0.9839,4,0,4,605584,26,107854,102,0.00024083886027640892,0.796875
9839,0.984,5,0,5,605584,26,107859,97,0.00024083886027640892,0.7886178861788617
9840,0.9842,1,3,1,605587,23,107860,96,0.00021304976101374634,0.8067226890756303
9841,0.9843,4,0,4,605587,23,107864,92,0.00021304976101374634,0.8
9842,0.9844,1,0,1,605587,23,107865,91,0.00021304976101374634,0.7982456140350878
9843,0.9845,1,1,1,605588,22,107866,90,0.00020378672792619216,0.8035714285714286
9844,0.9846,1,1,1,605589,21,107867,89,0.00019452369483863796,0.8090909090909091
9845,0.9847,2,0,2,605589,21,107869,87,0.00019452369483863796,0.8055555555555556
9846,0.9848,5,0,5,605589,21,107874,82,0.00019452369483863796,0.7961165048543689
9847,0.9849,2,0,2,605589,21,107876,80,0.00019452369483863796,0.7920792079207921
9848,0.985,1,0,1,605589,21,107877,79,0.00019452369483863796,0.79
9849,0.9851,0,1,0,605590,20,107877,79,0.00018526066175108378,0.797979797979798
9850,0.9852,4,0,4,605590,20,107881,75,0.00018526066175108378,0.7894736842105263
9851,0.9853,0,1,0,605591,19,107881,75,0.00017599762866352957,0.7978723404255319
9852,0.9854,2,0,2,605591,19,107883,73,0.00017599762866352957,0.7934782608695652
9853,0.9855,1,0,1,605591,19,107884,72,0.00017599762866352957,0.7912087912087912
9854,0.9856,1,1,1,605592,18,107885,71,0.0001667345955759754,0.797752808988764
9855,0.9857,1,0,1,605592,18,107886,70,0.0001667345955759754,0.7954545454545454
9856,0.9859,4,1,4,605593,17,107890,66,0.00015747156248842122,0.7951807228915663
9857,0.986,4,0,4,605593,17,107894,62,0.00015747156248842122,0.7848101265822784
9858,0.9861,2,1,2,605594,16,107896,60,0.00014820852940086702,0.7894736842105263
9859,0.9862,2,0,2,605594,16,107898,58,0.00014820852940086702,0.7837837837837838
9860,0.9863,1,2,1,605596,14,107899,57,0.00012968246322575864,0.8028169014084507
9861,0.9866,1,0,1,605596,14,107900,56,0.00012968246322575864,0.8
9862,0.9867,3,1,3,605597,13,107903,53,0.00012041943013820446,0.803030303030303
9863,0.9868,2,0,2,605597,13,107905,51,0.00012041943013820446,0.796875
9864,0.9869,4,0,4,605597,13,107909,47,0.00012041943013820446,0.7833333333333333
9865,0.987,2,3,2,605600,10,107911,45,9.263033087554189e-05,0.8181818181818182
9866,0.9871,1,1,1,605601,9,107912,44,8.33672977879877e-05,0.8301886792452831
9867,0.9872,1,1,1,605602,8,107913,43,7.410426470043351e-05,0.8431372549019608
9868,0.9873,3,2,3,605604,6,107916,40,5.5578198525325135e-05,0.8695652173913043
9869,0.9874,1,0,1,605604,6,107917,39,5.5578198525325135e-05,0.8666666666666667
9870,0.9875,4,1,4,605605,5,107921,35,4.6315165437770945e-05,0.875
9871,0.9876,2,0,2,605605,5,107923,33,4.6315165437770945e-05,0.868421052631579
9872,0.9877,3,0,3,605605,5,107926,30,4.6315165437770945e-05,0.8571428571428571
9873,0.9878,1,0,1,605605,5,107927,29,4.6315165437770945e-05,0.8529411764705882
9874,0.9879,1,0,1,605605,5,107928,28,4.6315165437770945e-05,0.8484848484848485
9875,0.988,1,0,1,605605,5,107929,27,4.6315165437770945e-05,0.84375
9876,0.9881,1,0,1,605605,5,107930,26,4.6315165437770945e-05,0.8387096774193549
9877,0.9883,1,0,1,605605,5,107931,25,4.6315165437770945e-05,0.8333333333333334
9878,0.9884,1,2,1,605607,3,107932,24,2.7789099262662567e-05,0.8888888888888888
9879,0.9886,1,0,1,605607,3,107933,23,2.7789099262662567e-05,0.8846153846153846
9880,0.9891,2,0,2,605607,3,107935,21,2.7789099262662567e-05,0.875
9881,0.9892,1,0,1,605607,3,107936,20,2.7789099262662567e-05,0.8695652173913043
9882,0.9893,2,0,2,605607,3,107938,18,2.7789099262662567e-05,0.8571428571428571
9883,0.9894,1,0,1,605607,3,107939,17,2.7789099262662567e-05,0.85
9884,0.9895,1,0,1,605607,3,107940,16,2.7789099262662567e-05,0.8421052631578947
9885,0.9899,0,1,0,605608,2,107940,16,1.8526066175108377e-05,0.8888888888888888
9886,0.9901,2,0,2,605608,2,107942,14,1.8526066175108377e-05,0.875
9887,0.9902,1,0,1,605608,2,107943,13,1.8526066175108377e-05,0.8666666666666667
9888,0.9903,2,0,2,605608,2,107945,11,1.8526066175108377e-05,0.8461538461538461
9889,0.9905,1,0,1,605608,2,107946,10,1.8526066175108377e-05,0.8333333333333334
9890,0.991,1,1,1,605609,1,107947,9,9.263033087554189e-06,0.9
9891,0.9911,0,1,0,605610,0,107947,9,0.0,1.0
9892,0.9912,2,0,2,605610,0,107949,7,0.0,1.0
9893,0.9913,2,0,2,605610,0,107951,5,0.0,1.0
9894,0.9914,1,0,1,605610,0,107952,4,0.0,1.0
9895,0.9917,1,0,1,605610,0,107953,3,0.0,1.0
9896,0.9922,2,0,2,605610,0,107955,1,0.0,1.0
9897,0.9935,1,0,1,605610,0,107956,0,0.0,
